date,state,fips,cases,newCases,deaths,newDeaths,tests,newTests,positive,newPositive,negative,newNegative
2020-08-14,US,00,5324784,59477,168341,1176,65717372,857475,5262107,57093,60455265,800382
2020-08-15,US,00,5375527,50743,169400,1059,66462619,745247,5317916,55809,61144703,689438
2020-08-16,US,00,5417664,42137,169914,514,67247018,784399,5360239,42323,61886779,742076
2020-08-17,US,00,5455187,37523,170449,535,67908615,661597,5397650,37411,62510965,624186
2020-08-18,US,00,5498420,43233,171798,1349,68563603,654988,5438142,40492,63125461,614496
2020-08-19,US,00,5541433,43013,173093,1295,69254293,690690,5483025,44883,63771268,645807
2020-08-20,US,00,5587462,46029,174136,1043,69927639,673346,5526748,43723,64400891,629623
2020-08-21,US,00,5636491,49029,175297,1161,70675249,747610,5572943,46195,65102306,701415
2020-08-22,US,00,5681517,45026,176247,950,71430753,755504,5618666,45723,65812087,709781
2020-08-23,US,00,5713850,32333,176693,446,72053917,623164,5655990,37324,66397927,585840
2020-08-24,US,00,5754254,40404,177197,504,72727866,673949,5690240,34250,67037626,639699
2020-08-25,US,00,5793437,39183,178410,1213,73393568,665702,5726828,36588,67666740,629114
2020-08-26,US,00,5838756,45319,179603,1193,74039515,645947,5770456,43628,68269059,602319
2020-08-27,US,00,5884366,45610,180729,1126,74782097,742582,5814370,43914,68967727,698668
2020-08-28,US,00,5930930,46564,181739,1010,75556270,774173,5860495,46125,69695775,728048
2020-08-29,US,00,5975540,44610,182610,871,76318247,761977,5904462,43967,70413785,718010
2020-08-30,US,00,6008970,33430,182984,374,77054923,736676,5943747,39285,71111176,697391
2020-08-31,US,00,6045455,36485,183472,488,77733283,678360,5975020,31273,71758263,647087
2020-09-01,US,00,6089504,44049,184563,1091,78430052,696769,6017446,42426,72412606,654343
2020-09-02,US,00,6121948,32444,185639,1076,79077376,647324,6047663,30217,73029713,617107
2020-09-03,US,00,6168342,46394,186717,1078,79802066,724690,6092279,44616,73709787,680074
2020-09-04,US,00,6220446,52104,187697,980,80703179,901113,6143787,51508,74559392,849605
2020-09-05,US,00,6262700,42254,188409,712,81509654,806475,6188531,44744,75321123,761731
2020-09-06,US,00,6292699,29999,188820,411,82242672,733018,6221452,32921,76021220,700097
2020-09-07,US,00,6317865,25166,189083,263,82829754,587082,6249595,28143,76580159,558939
2020-09-08,US,00,6346806,28941,189541,458,83335434,505680,6271732,22137,77063702,483543
2020-09-09,US,00,6380138,33332,190716,1175,83918872,583438,6302902,31170,77615970,552268
2020-09-10,US,00,6418198,38060,191631,915,84533135,614263,6340206,37304,78192929,576959
2020-09-11,US,00,6465766,47568,192858,1227,85301956,768821,6384889,44683,78917067,724138
2020-09-12,US,00,6504870,39104,193559,701,86153009,851053,6426755,41866,79726254,809187
2020-09-13,US,00,6538213,33343,193958,399,86799288,646279,6461066,34311,80338222,611968
2020-09-14,US,00,6575100,36887,194408,450,87199644,400356,6494687,33621,80704957,366735
2020-09-15,US,00,6614317,39217,195689,1281,87886241,686597,6529591,34904,81356650,651693
2020-09-16,US,00,6653585,39268,196686,997,88555012,668771,6569701,40110,81985311,628661
2020-09-17,US,00,6698895,45310,197535,849,89335835,780823,6612990,43289,82722845,737534
2020-09-18,US,00,6747782,48887,198484,949,90236174,900339,6660241,47251,83575933,853088
2020-09-19,US,00,6789593,41811,199154,670,91226796,990622,6705146,44905,84521650,945717
2020-09-20,US,00,6825949,36356,199367,213,92050962,824166,6740649,35503,85310313,788663
2020-09-21,US,00,6880899,54950,199797,430,92726904,675942,6779788,39139,85947116,636803
2020-09-22,US,00,6918290,37391,200738,941,93450173,723269,6829263,49475,86620910,673794
2020-09-23,US,00,6959841,41551,201828,1090,94292931,842758,6867883,38620,87425048,804138
2020-09-24,US,00,7005043,45202,202713,885,95139256,846325,6911229,43346,88228027,802979
2020-09-25,US,00,7059624,54581,203566,853,96071224,931968,6966418,55189,89104806,876779
2020-09-26,US,00,7102321,42697,204335,769,97005368,934144,7013821,47403,89991547,886741
2020-09-27,US,00,7139619,37298,204602,267,97709861,704493,7048808,34987,90661053,669506
2020-09-28,US,00,7176979,37360,204952,350,98658268,948407,7084691,35883,91573577,912524
2020-09-29,US,00,7220676,43697,205878,926,99405986,747718,7121132,36441,92284854,711277
2020-09-30,US,00,7262734,42058,206852,974,100126688,720702,7165479,44347,92961209,676355
2020-10-01,US,00,7309152,46418,207699,847,100935884,809196,7211084,45605,93724800,763591
2020-10-02,US,00,7362732,53580,208564,865,101960347,1024463,7260341,49257,94700006,975206
2020-10-03,US,00,7410511,47779,209273,709,102856269,895922,7311276,50935,95544993,844987
2020-10-04,US,00,7445574,35063,209606,333,103717408,861139,7349264,37988,96368144,823151
2020-10-05,US,00,7507956,62382,210035,429,104599413,882005,7387020,37756,97212393,844249
2020-10-06,US,00,7550841,42885,210756,721,105354387,754974,7425937,38917,97928450,716057
2020-10-07,US,00,7603856,53015,211752,996,106136533,782146,7476527,50590,98660006,731556
2020-10-08,US,00,7660231,56375,212680,928,107076368,939835,7531735,55208,99544633,884627
2020-10-09,US,00,7719190,58959,213595,915,108081334,1004966,7588537,56802,100492797,948164
2020-10-10,US,00,7770838,51648,214187,592,109100375,1019041,7645952,57415,101454423,961626
2020-10-11,US,00,7815621,44783,214606,419,109948731,848356,7692221,46269,102256510,802087
2020-10-12,US,00,7863637,48016,214957,351,110874377,925646,7734864,42643,103139513,883003
2020-10-13,US,00,7917996,54359,215783,826,111782078,907701,7783457,48593,103998621,859108
2020-10-14,US,00,7977889,59893,216792,1009,112459398,677320,7839574,56117,104619824,621203
2020-10-15,US,00,8043229,65340,217585,793,113374122,914724,7902966,63392,105471156,851332
2020-10-16,US,00,8113706,70477,218476,891,114412783,1038661,7971214,68248,106441569,970413
2020-10-17,US,00,8166467,52761,219154,678,115435304,1022521,8028544,57330,107406760,965191
2020-10-18,US,00,8214349,47882,219541,387,116251090,815786,8076828,48284,108174262,767502
2020-10-19,US,00,8279780,65431,220058,517,117330578,1079488,8133938,57110,109196640,1022378
2020-10-20,US,00,8340387,60607,220987,929,118147461,816883,8194485,60547,109952976,756336
2020-10-21,US,00,8404616,64229,222195,1208,118899179,751718,8255438,60953,110643741,690765
2020-10-22,US,00,8479704,75088,223023,828,119889924,990745,8328280,72842,111561644,917903
2020-10-23,US,00,8564816,85112,223948,925,121014949,1125025,8410612,82332,112604337,1042693
2020-10-24,US,00,8643572,78756,224821,873,122059714,1044765,8493898,83286,113565816,961479
2020-10-25,US,00,8703284,59712,225160,339,123025276,965562,8558791,64893,114466485,900669
2020-10-26,US,00,8777727,74443,225698,538,124071671,1046395,8621317,62526,115450354,983869
2020-10-27,US,00,8852180,74453,226681,983,124950448,878777,8693399,72082,116257049,806695
2020-10-28,US,00,8934082,81902,227697,1016,125832335,881887,8772147,78748,117060188,803139
2020-10-29,US,00,9024852,90770,228701,1004,126930527,1098192,8860875,88728,118069652,1009464
2020-10-30,US,00,9124654,99802,229672,971,128003227,1072700,8958108,97233,119045119,975467
2020-10-31,US,00,9208952,84298,230510,838,129137806,1134579,9048695,90587,120089111,1043992
2020-11-01,US,00,9283188,74236,230937,427,130025835,888029,9122544,73849,120903291,814180
2020-11-02,US,00,9376874,93686,231477,540,131178626,1152791,9204591,82047,121974035,1070744
2020-11-03,US,00,9469493,92619,232607,1130,132104827,926201,9291253,86662,122813574,839539
2020-11-04,US,00,9577421,107928,234223,1616,133077935,973108,9394557,103304,123683378,869804
2020-11-05,US,00,9698960,121539,235331,1108,134371738,1293803,9510998,116441,124860740,1177362
2020-11-06,US,00,9831814,132854,236577,1246,135638336,1266598,9636751,125753,126001585,1140845
2020-11-07,US,00,9957746,125932,237584,1007,136751749,1113413,9765966,129215,126985783,984198
2020-11-08,US,00,10061162,103416,238048,464,137783946,1032197,9876247,110281,127907699,921916
2020-11-09,US,00,10191549,130387,238793,745,139125896,1341950,9995679,119432,129130217,1222518
2020-11-10,US,00,10331303,139754,240258,1465,140199040,1073144,10126861,131182,130072179,941962
2020-11-11,US,00,10474163,142860,241689,1431,141363430,1164390,10271662,144801,131091768,1019589
2020-11-12,US,00,10637603,163440,242861,1172,142486170,1122740,10423665,152003,132062505,970737
2020-11-13,US,00,10819174,181571,244250,1389,143895606,1409436,10595771,172106,133299835,1237330
2020-11-14,US,00,10978295,159121,245460,1210,145233858,1338252,10759311,163540,134474547,1174712
2020-11-15,US,00,11113482,135187,246083,623,146540846,1306988,10903745,144434,135637101,1162554
2020-11-16,US,00,11280026,166544,246879,796,147793241,1252395,11052613,148868,136740628,1103527
2020-11-17,US,00,11441728,161702,248486,1607,149042425,1249184,11209335,156722,137833090,1092462
2020-11-18,US,00,11614076,172348,250411,1925,150280863,1238438,11373310,163975,138907553,1074463
2020-11-19,US,00,11801472,187396,252373,1962,151750069,1469206,11556142,182832,140193927,1286374
2020-08-14,Alabama,01,106309,752,1893,3,824984,22422,106309,752,718675,21670
2020-08-14,Alaska,02,4867,119,25,0,295929,1876,4078,100,291851,1776
2020-08-14,Arizona,04,191810,960,4426,41,1067575,9397,191721,927,875854,8470
2020-08-14,Arkansas,05,52392,626,587,5,588660,5180,52392,626,536268,4554
2020-08-14,California,06,613243,10031,11146,151,9556598,111105,601075,7934,8955523,103171
2020-08-14,Colorado,08,52587,345,1892,6,620325,6959,52538,319,567787,6640
2020-08-14,Connecticut,09,50897,115,4453,3,937690,10355,50897,115,886793,10240
2020-08-14,Delaware,10,16340,373,593,0,207475,1847,16340,373,191135,1474
2020-08-14,District of Columbia,11,13118,94,594,0,236305,6656,13118,94,223187,6562
2020-08-14,Florida,12,563277,6148,9140,228,4154617,40296,557337,7997,3597280,32299
2020-08-14,Georgia,13,215328,3319,4474,34,1970053,27443,231895,3227,1738158,24216
2020-08-14,Guam,66,1471,25,6,0,27096,416,502,25,26594,391
2020-08-14,Hawaii,15,4520,231,39,0,153617,3030,4312,0,149305,3030
2020-08-14,Idaho,16,27312,498,267,11,218221,3608,26631,498,191590,3110
2020-08-14,Illinois,17,204827,2250,7953,19,3286680,49573,204023,2296,3082657,47277
2020-08-14,Indiana,18,80507,1103,3113,8,886489,8519,78632,1067,807857,7452
2020-08-14,Iowa,19,51272,594,972,8,540237,5424,50932,596,489305,4828
2020-08-14,Kansas,20,34246,1159,404,1,343043,8480,33885,1338,309158,7142
2020-08-14,Kentucky,21,40012,706,822,5,700642,13022,38298,612,662344,12410
2020-08-14,Louisiana,22,136860,1298,4430,28,1637012,21032,136737,1298,1500275,19734
2020-08-14,Maine,23,4115,26,126,0,205043,2759,4115,26,200928,2733
2020-08-14,Maryland,24,99430,702,3631,11,1110273,15179,98875,715,1011398,14464
2020-08-14,Massachusetts,25,122728,305,8810,20,1411532,21552,122531,212,1289001,21340
2020-08-14,Michigan,26,100813,850,6567,11,2261151,38765,100724,868,2160427,37897
2020-08-14,Minnesota,27,63769,730,1739,8,973546,10450,63723,730,909823,9720
2020-08-14,Mississippi,28,70930,944,2043,32,511042,2616,70930,944,440112,1672
2020-08-14,Missouri,29,66305,1372,1425,8,824869,13512,65270,1473,759599,12039
2020-08-14,Montana,30,5564,134,82,1,199861,2041,5541,134,194320,1907
2020-08-14,Nebraska,31,29988,328,363,1,314224,4580,29660,416,284564,4164
2020-08-14,Nevada,32,59800,988,1045,15,538204,5060,59749,1099,478455,3961
2020-08-14,New Hampshire,33,6964,43,423,1,181616,0,6921,0,174695,0
2020-08-14,New Jersey,34,189003,570,15903,10,2429841,26151,187164,570,2242677,25581
2020-08-14,New Mexico,35,23160,173,703,6,659042,8551,23160,173,635882,8378
2020-08-14,New York,36,428879,724,32407,8,6901836,85455,424167,727,6477669,84728
2020-08-14,North Carolina,37,142544,1538,2344,31,1877402,26713,142170,1346,1735232,25367
2020-08-14,North Dakota,38,8326,151,125,1,176597,1564,8316,152,168281,1412
2020-08-14,Northern Mariana Islands,69,50,1,2,0,12302,1,50,1,12252,0
2020-08-14,Ohio,39,106557,1131,3784,29,1779409,26102,106557,1131,1672852,24971
2020-08-14,Oklahoma,40,46893,792,644,6,743242,11970,46897,794,696345,11176
2020-08-14,Oregon,41,22614,299,388,1,473107,5844,22613,313,450494,5531
2020-08-14,Pennsylvania,42,127774,824,7513,39,1427689,16695,122950,829,1304739,15866
2020-08-14,Puerto Rico,72,25128,682,317,11,316702,451,10730,451,305972,0
2020-08-14,Rhode Island,44,20335,95,1021,2,229865,1391,20335,95,209530,1296
2020-08-14,South Carolina,45,104841,932,2204,18,851784,45756,104841,932,746943,44824
2020-08-14,South Dakota,46,10024,127,150,2,126014,1244,10024,127,115990,1117
2020-08-14,Tennessee,47,127465,1978,1312,12,1812043,24322,130458,1947,1681585,22375
2020-08-14,Texas,48,547670,8865,10195,316,4282041,51278,520593,7018,3761448,44260
2020-08-14,Utah,49,46048,511,362,4,590636,4212,45976,552,544660,3660
2020-08-14,Vermont,50,1501,17,58,0,107417,1510,1501,17,105916,1493
2020-08-14,Virgin Islands,78,734,30,9,0,11999,349,704,22,11295,327
2020-08-14,Virginia,51,104838,1216,2370,7,1320272,14169,104838,1216,1215434,12953
2020-08-14,Washington,53,68581,486,1825,3,1284141,14510,68234,623,1215907,13887
2020-08-14,West Virginia,54,8274,123,157,4,344700,5185,8274,123,336426,5062
2020-08-14,Wisconsin,55,68761,980,1035,6,1113294,10477,68681,1059,1044613,9418
2020-08-14,Wyoming,56,3183,64,30,1,59992,421,3183,64,56809,357
2020-08-15,Alabama,01,107580,1271,1896,3,837017,12033,107580,1271,729437,10762
2020-08-15,Alaska,02,4952,85,26,1,296677,748,4162,84,292515,664
2020-08-15,Arizona,04,192670,860,4497,71,1077191,9616,192654,933,884537,8683
2020-08-15,Arkansas,05,51992,-400,600,13,588260,-400,51992,-400,536268,0
2020-08-15,California,06,621981,8738,11229,83,9681111,124513,613689,12614,9067422,111899
2020-08-15,Colorado,08,52868,281,1897,5,626305,5980,52838,300,573467,5680
2020-08-15,Connecticut,09,50897,0,4453,0,937690,0,50897,0,886793,0
2020-08-15,Delaware,10,16396,56,593,0,208761,1286,16396,56,192365,1230
2020-08-15,District of Columbia,11,13159,41,597,3,239216,2911,13159,41,226057,2870
2020-08-15,Florida,12,569629,6352,9344,204,4196716,42099,563628,6291,3633088,35808
2020-08-15,Georgia,13,218344,3016,4568,94,1988066,18013,235168,3273,1752898,14740
2020-08-15,Guam,66,1471,0,6,0,27096,0,502,0,26594,0
2020-08-15,Hawaii,15,4802,282,39,0,156266,2649,4543,231,151723,2418
2020-08-15,Idaho,16,27620,308,269,2,221012,2791,27173,542,193839,2249
2020-08-15,Illinois,17,206505,1678,7959,6,3331094,44414,205851,1828,3125243,42586
2020-08-15,Indiana,18,81561,1054,3128,15,897615,11126,79676,1044,817939,10082
2020-08-15,Iowa,19,52065,793,975,3,546074,5837,51793,861,494281,4976
2020-08-15,Kansas,20,34294,48,406,2,343043,0,33885,0,309158,0
2020-08-15,Kentucky,21,40677,665,829,7,711976,11334,38930,632,673046,10702
2020-08-15,Louisiana,22,136860,0,4430,0,1637012,0,136737,0,1500275,0
2020-08-15,Maine,23,4144,29,127,1,207354,2311,4144,29,203210,2282
2020-08-15,Maryland,24,100237,807,3636,5,1127652,17379,99693,818,1027959,16561
2020-08-15,Massachusetts,25,123199,471,8826,16,1434501,22969,122897,366,1311604,22603
2020-08-15,Michigan,26,101831,1018,6586,19,2291779,30628,101782,1058,2189997,29570
2020-08-15,Minnesota,27,64459,690,1745,6,984473,10927,64413,690,920060,10237
2020-08-15,Mississippi,28,71755,825,2080,37,519765,8723,71755,825,448010,7898
2020-08-15,Missouri,29,67442,1137,1431,6,835441,10572,66397,1127,769044,9445
2020-08-15,Montana,30,5663,99,82,0,200936,1075,5659,118,195277,957
2020-08-15,Nebraska,31,30241,253,363,0,317683,3459,29988,328,287695,3131
2020-08-15,Nevada,32,60648,848,1070,25,542850,4646,60608,859,482242,3787
2020-08-15,New Hampshire,33,6980,16,423,0,183377,1761,6980,59,176397,1702
2020-08-15,New Jersey,34,189281,278,15910,7,2461383,31542,187442,278,2273941,31264
2020-08-15,New Mexico,35,23302,142,711,8,665291,6249,23302,142,641989,6107
2020-08-15,New York,36,429617,738,32414,7,6990504,88668,424901,734,6565603,87934
2020-08-15,North Carolina,37,143956,1412,2370,26,1903401,25999,143706,1536,1759695,24463
2020-08-15,North Dakota,38,8448,122,125,0,178140,1543,8439,123,169701,1420
2020-08-15,Northern Mariana Islands,69,50,0,2,0,12302,0,50,0,12252,0
2020-08-15,Ohio,39,107674,1117,3824,40,1802350,22941,107674,1117,1694676,21824
2020-08-15,Oklahoma,40,47798,905,657,13,754417,11175,47798,901,706619,10274
2020-08-15,Oregon,41,23018,404,389,1,484879,11772,23018,405,461861,11367
2020-08-15,Pennsylvania,42,128531,757,7525,12,1443684,15995,123800,850,1319884,15145
2020-08-15,Puerto Rico,72,25695,567,329,12,317041,339,11069,339,305972,0
2020-08-15,Rhode Island,44,20335,0,1021,0,231766,1901,20439,104,211327,1797
2020-08-15,South Carolina,45,105882,1041,2260,56,860400,8616,105882,1041,754518,7575
2020-08-15,South Dakota,46,10118,94,152,2,127449,1435,10118,94,117331,1341
2020-08-15,Tennessee,47,128771,1306,1331,19,1829758,17715,131747,1289,1698011,16426
2020-08-15,Texas,48,555343,7673,10379,184,4321676,39635,528838,8245,3792838,31390
2020-08-15,Utah,49,46413,365,364,2,595078,4442,46321,345,548757,4097
2020-08-15,Vermont,50,1509,8,58,0,110297,2880,1509,8,108788,2872
2020-08-15,Virgin Islands,78,734,0,9,0,12117,118,734,30,11383,88
2020-08-15,Virginia,51,105750,912,2381,11,1337240,16968,105750,912,1231490,16056
2020-08-15,Washington,53,69136,555,1842,17,1292977,8836,68579,345,1224398,8491
2020-08-15,West Virginia,54,8457,183,160,3,350244,5544,8457,183,341787,5361
2020-08-15,Wisconsin,55,69560,799,1047,12,1124666,11372,69547,866,1055119,10506
2020-08-15,Wyoming,56,3227,44,30,0,60036,44,3227,44,56809,0
2020-08-16,Alabama,01,108433,853,1898,2,846424,9407,108433,853,737991,8554
2020-08-16,Alaska,02,5058,106,26,0,301515,4838,4263,101,297252,4737
2020-08-16,Arizona,04,193554,884,4509,12,1091974,14783,193537,883,898437,13900
2020-08-16,Arkansas,05,52665,673,599,-1,622050,33790,52665,673,569385,33117
2020-08-16,California,06,628508,6527,11245,16,9798135,117024,621562,7873,9176573,109151
2020-08-16,Colorado,08,53188,320,1897,0,634573,8268,53176,338,581397,7930
2020-08-16,Connecticut,09,50897,0,4453,0,937690,0,50897,0,886793,0
2020-08-16,Delaware,10,16451,55,593,0,210385,1624,16451,55,193934,1569
2020-08-16,District of Columbia,11,13220,61,597,0,242852,3636,13220,61,229632,3575
2020-08-16,Florida,12,573408,3779,9451,107,4226587,29871,567375,3747,3659212,26124
2020-08-16,Georgia,13,220165,1821,4600,32,2005273,17207,237030,1862,1768243,15345
2020-08-16,Guam,66,1471,0,6,0,27773,677,516,14,27257,663
2020-08-16,Hawaii,15,5019,217,39,0,159299,3033,4825,282,154474,2751
2020-08-16,Idaho,16,27794,174,269,0,223222,2210,27477,304,195745,1906
2020-08-16,Illinois,17,208068,1563,7973,14,3368183,37089,207413,1562,3160770,35527
2020-08-16,Indiana,18,82304,743,3133,5,906851,9236,80415,739,826436,8497
2020-08-16,Iowa,19,52447,382,975,0,551193,5119,52428,635,498765,4484
2020-08-16,Kansas,20,34495,201,406,0,343043,0,33885,0,309158,0
2020-08-16,Kentucky,21,40883,206,832,3,712361,385,39315,385,673046,0
2020-08-16,Louisiana,22,138041,1181,4507,77,1658087,21075,137918,1181,1520169,19894
2020-08-16,Maine,23,4168,24,127,0,210223,2869,4168,24,206055,2845
2020-08-16,Maryland,24,100772,535,3639,3,1142410,14758,100212,519,1042198,14239
2020-08-16,Massachusetts,25,123593,394,8838,12,1449968,15467,123200,303,1326768,15164
2020-08-16,Michigan,26,102323,492,6592,6,2321050,29271,102259,477,2218791,28794
2020-08-16,Minnesota,27,65198,739,1752,7,994054,9581,65152,739,928902,8842
2020-08-16,Mississippi,28,72136,381,2084,4,520146,381,72136,381,448010,0
2020-08-16,Missouri,29,68493,1051,1436,5,845618,10177,67475,1078,778143,9099
2020-08-16,Montana,30,5751,88,82,0,201924,988,5750,91,196174,897
2020-08-16,Nebraska,31,30372,131,363,0,320876,3193,30241,253,290635,2940
2020-08-16,Nevada,32,61374,726,1074,4,547463,4613,61305,697,486158,3916
2020-08-16,New Hampshire,33,6988,8,423,0,184929,1552,6988,8,177941,1544
2020-08-16,New Jersey,34,189294,13,15912,2,2490186,28803,187455,13,2302731,28790
2020-08-16,New Mexico,35,23408,106,714,3,670573,5282,23408,106,647165,5176
2020-08-16,New York,36,430226,609,32424,10,7068196,77692,425508,607,6642688,77085
2020-08-16,North Carolina,37,145111,1155,2372,2,1924646,21245,144952,1246,1779694,19999
2020-08-16,North Dakota,38,8591,143,129,4,179795,1655,8582,143,171213,1512
2020-08-16,Northern Mariana Islands,69,50,0,2,0,12302,0,50,0,12252,0
2020-08-16,Ohio,39,108287,613,3826,2,1829645,27295,108287,613,1721358,26682
2020-08-16,Oklahoma,40,48342,544,661,4,754961,544,48342,544,706619,0
2020-08-16,Oregon,41,23262,244,388,-1,488797,3918,23262,244,465535,3674
2020-08-16,Pennsylvania,42,129075,544,7532,7,1456863,13179,124460,660,1332403,12519
2020-08-16,Puerto Rico,72,26006,311,335,6,317223,182,11251,182,305972,0
2020-08-16,Rhode Island,44,20335,0,1021,0,233078,1312,20514,75,212564,1237
2020-08-16,South Carolina,45,106497,615,2269,9,867601,7201,106497,615,761104,6586
2020-08-16,South Dakota,46,10274,156,153,1,128774,1325,10274,156,118500,1169
2020-08-16,Tennessee,47,130620,1849,1349,18,1857340,27582,133708,1961,1723632,25621
2020-08-16,Texas,48,563464,8121,10498,119,4439041,117365,535582,6744,3903459,110621
2020-08-16,Utah,49,46652,239,364,0,598857,3779,46652,331,552205,3448
2020-08-16,Vermont,50,1515,6,58,0,111335,1038,1515,6,109820,1032
2020-08-16,Virgin Islands,78,741,7,9,0,12171,54,741,7,11430,47
2020-08-16,Virginia,51,106687,937,2381,0,1353848,16608,106687,937,1247161,15671
2020-08-16,Washington,53,69894,758,1861,19,1297928,4951,68729,150,1229199,4801
2020-08-16,West Virginia,54,8564,107,160,0,355339,5095,8564,107,346775,4988
2020-08-16,Wisconsin,55,70246,686,1048,1,1130779,6113,70246,699,1060533,5414
2020-08-16,Wyoming,56,3286,59,30,0,60095,59,3286,59,56809,0
2020-08-17,Alabama,01,109004,571,1925,27,852923,6499,109004,571,743919,5928
2020-08-17,Alaska,02,5108,50,26,0,305648,4133,4313,50,301335,4083
2020-08-17,Arizona,04,194027,473,4509,0,1098388,6414,194005,468,904383,5946
2020-08-17,Arkansas,05,53077,412,603,4,622462,412,53077,412,569385,0
2020-08-17,California,06,634991,6483,11334,89,9933780,135645,628031,6469,9305749,129176
2020-08-17,Colorado,08,53391,203,1903,6,639650,5077,53370,194,586280,4883
2020-08-17,Connecticut,09,51267,370,4456,3,981968,44278,51267,370,930701,43908
2020-08-17,Delaware,10,16536,85,593,0,212638,2253,16536,85,196102,2168
2020-08-17,District of Columbia,11,13273,53,597,0,245655,2803,13273,53,232382,2750
2020-08-17,Florida,12,576086,2678,9538,87,4246806,20219,570024,2649,3676782,17570
2020-08-17,Georgia,13,221841,1676,4624,24,2027417,22144,238861,1831,1788556,20313
2020-08-17,Guam,66,1527,56,6,0,28773,1000,558,42,28215,958
2020-08-17,Hawaii,15,5192,173,39,0,161948,2649,5042,217,156906,2432
2020-08-17,Idaho,16,28113,319,275,6,224487,1265,27660,183,196827,1082
2020-08-17,Illinois,17,209942,1874,7990,17,3406429,38246,209186,1773,3197243,36473
2020-08-17,Indiana,18,82909,605,3135,2,914633,7782,81006,591,833627,7191
2020-08-17,Iowa,19,52829,382,987,12,553984,2791,52722,294,501262,2497
2020-08-17,Kansas,20,35544,1049,410,4,354262,11219,35167,1282,319095,9937
2020-08-17,Kentucky,21,41610,727,839,7,716816,4455,39691,376,677125,4079
2020-08-17,Louisiana,22,138608,567,4526,19,1674289,16202,138485,567,1535804,15635
2020-08-17,Maine,23,4197,29,127,0,212554,2331,4197,29,208357,2302
2020-08-17,Maryland,24,101276,504,3641,2,1157612,15202,100715,503,1056897,14699
2020-08-17,Massachusetts,25,123841,248,8842,4,1464914,14946,123413,213,1341501,14733
2020-08-17,Michigan,26,102872,549,6592,0,2340207,19157,102749,490,2237458,18667
2020-08-17,Minnesota,27,65762,564,1758,6,1000023,5969,65716,564,934307,5405
2020-08-17,Mississippi,28,72412,276,2095,11,524589,4443,72412,276,452177,4167
2020-08-17,Missouri,29,69888,1395,1468,32,858617,12999,68623,1148,789994,11851
2020-08-17,Montana,30,5810,59,82,0,204725,2801,5792,42,198933,2759
2020-08-17,Nebraska,31,30563,191,363,0,322991,2115,30372,131,292619,1984
2020-08-17,Nevada,32,62022,648,1077,3,551423,3960,61967,662,489456,3298
2020-08-17,New Hampshire,33,7004,16,423,0,185971,1042,7004,16,178967,1026
2020-08-17,New Jersey,34,189606,312,15916,4,2511070,20884,187767,312,2323303,20572
2020-08-17,New Mexico,35,23500,92,718,4,677150,6577,23500,92,653650,6485
2020-08-17,New York,36,430636,410,32435,11,7125087,56891,425916,408,6699171,56483
2020-08-17,North Carolina,37,145942,831,2384,12,1935472,10826,145516,564,1789956,10262
2020-08-17,North Dakota,38,8651,60,130,1,180413,618,8641,59,171772,559
2020-08-17,Northern Mariana Islands,69,53,3,2,0,12920,618,53,3,12867,615
2020-08-17,Ohio,39,109062,775,3832,6,1849016,19371,109062,775,1739954,18596
2020-08-17,Oklahoma,40,48711,369,665,4,755330,369,48711,369,706619,0
2020-08-17,Oregon,41,23461,199,391,3,491217,2420,23451,189,467766,2231
2020-08-17,Pennsylvania,42,129686,611,7535,3,1467319,10456,124844,384,1342475,10072
2020-08-17,Puerto Rico,72,26760,754,335,0,317695,472,11723,472,305972,0
2020-08-17,Rhode Island,44,20572,237,1023,2,233822,744,20572,58,213250,686
2020-08-17,South Carolina,45,106953,456,2288,19,873547,5946,106953,456,766594,5490
2020-08-17,South Dakota,46,10360,86,153,0,129293,519,10360,86,118933,433
2020-08-17,Tennessee,47,131742,1122,1370,21,1871108,13768,134744,1036,1736364,12732
2020-08-17,Texas,48,569058,5594,10559,61,4476167,37126,542950,7368,3933217,29758
2020-08-17,Utah,49,46936,284,366,2,602203,3346,46894,242,555309,3104
2020-08-17,Vermont,50,1527,12,58,0,113223,1888,1527,12,111696,1876
2020-08-17,Virgin Islands,78,760,19,9,0,12418,247,760,19,11658,228
2020-08-17,Virginia,51,107421,734,2385,4,1373442,19594,107421,734,1266021,18860
2020-08-17,Washington,53,70509,615,1869,8,1314115,16187,69369,640,1244746,15547
2020-08-17,West Virginia,54,8632,68,160,0,360839,5500,8632,68,352207,5432
2020-08-17,Wisconsin,55,70796,550,1050,2,1136755,5976,70715,469,1066040,5507
2020-08-17,Wyoming,56,3331,45,33,3,60898,803,3331,45,57567,758
2020-08-18,Alabama,01,110361,1357,1936,11,868259,15336,110361,1357,757898,13979
2020-08-18,Alaska,02,5175,67,27,1,310009,4361,4379,66,305630,4295
2020-08-18,Arizona,04,194931,904,4535,26,1103997,5609,194920,915,909077,4694
2020-08-18,Arkansas,05,53487,410,619,16,633062,10600,53487,410,579575,10190
2020-08-18,California,06,640499,5508,11523,189,10049039,115259,632667,4636,9416372,110623
2020-08-18,Colorado,08,53674,283,1906,3,643831,4181,53631,261,590200,3920
2020-08-18,Connecticut,09,51255,-12,4456,0,992731,10763,51255,-12,941476,10775
2020-08-18,Delaware,10,16593,57,593,0,213845,1207,16593,57,197252,1150
2020-08-18,District of Columbia,11,13325,52,599,2,249478,3823,13325,52,236153,3771
2020-08-18,Florida,12,579924,3838,9757,219,4272919,26113,573811,3787,3699108,22326
2020-08-18,Georgia,13,224681,2840,4691,67,2060319,32902,241677,2816,1818642,30086
2020-08-18,Guam,66,1546,19,6,0,29226,453,577,19,28649,434
2020-08-18,Hawaii,15,5326,134,40,1,164199,2251,5215,173,158984,2078
2020-08-18,Idaho,16,28486,373,283,8,226869,2382,27942,282,198927,2100
2020-08-18,Illinois,17,211806,1864,8017,27,3440604,34175,210926,1740,3229678,32435
2020-08-18,Indiana,18,83799,890,3165,30,928614,13981,81847,841,846767,13140
2020-08-18,Iowa,19,53201,372,1002,15,557098,3114,52951,229,504147,2885
2020-08-18,Kansas,20,35632,88,415,5,354262,0,35167,0,319095,0
2020-08-18,Kentucky,21,42270,660,858,19,726900,10084,40299,608,686601,9476
2020-08-18,Louisiana,22,139248,640,4554,28,1689991,15702,139125,640,1550866,15062
2020-08-18,Maine,23,4213,16,127,0,214326,1772,4213,16,210113,1756
2020-08-18,Maryland,24,101780,504,3650,9,1167305,9693,101235,520,1066070,9173
2020-08-18,Massachusetts,25,124063,222,8848,6,1476567,11653,123588,175,1352979,11478
2020-08-18,Michigan,26,103527,655,6607,15,2362525,22318,103403,654,2259122,21664
2020-08-18,Minnesota,27,66107,345,1767,9,1003306,3283,66061,345,937245,2938
2020-08-18,Mississippi,28,73207,795,2128,33,525384,795,73207,795,452177,0
2020-08-18,Missouri,29,70759,871,1477,9,867481,8864,69417,794,798064,8070
2020-08-18,Montana,30,5867,57,84,2,205512,787,5846,54,199666,733
2020-08-18,Nebraska,31,30825,262,370,7,325487,2496,30563,191,294924,2305
2020-08-18,Nevada,32,62752,730,1102,25,553928,2505,62639,672,491289,1833
2020-08-18,New Hampshire,33,7017,13,424,1,186907,936,7017,13,179890,923
2020-08-18,New Jersey,34,189937,331,15925,9,2532745,21675,188098,331,2344647,21344
2020-08-18,New Mexico,35,23579,79,723,5,683053,5903,23579,79,659474,5824
2020-08-18,New York,36,431298,662,32446,11,7191978,66891,426571,655,6765407,66236
2020-08-18,North Carolina,37,147141,1199,2425,41,1951120,15648,146779,1263,1804341,14385
2020-08-18,North Dakota,38,8786,135,132,2,180921,508,8775,134,172146,374
2020-08-18,Northern Mariana Islands,69,54,1,2,0,12920,0,54,1,12866,-1
2020-08-18,Ohio,39,109923,861,3871,39,1868998,19982,109923,861,1759075,19121
2020-08-18,Oklahoma,40,49326,615,682,17,775000,19670,49326,615,725674,19055
2020-08-18,Oregon,41,23685,224,399,8,496338,5121,23676,225,472662,4896
2020-08-18,Pennsylvania,42,130286,600,7561,26,1479566,12247,125579,735,1353987,11512
2020-08-18,Puerto Rico,72,27713,953,346,11,318343,648,12371,648,305972,0
2020-08-18,Rhode Island,44,20692,120,1024,1,236163,2341,20692,120,215471,2221
2020-08-18,South Carolina,45,107672,719,2343,55,878481,4934,107672,719,770809,4215
2020-08-18,South Dakota,46,10443,83,154,1,130013,720,10443,83,119570,637
2020-08-18,Tennessee,47,132796,1054,1410,40,1894372,23264,135778,1034,1758594,22230
2020-08-18,Texas,48,577220,8162,10798,239,4500645,24478,550232,7282,3950413,17196
2020-08-18,Utah,49,47285,349,372,6,606184,3981,47157,263,559027,3718
2020-08-18,Vermont,50,1530,3,58,0,114097,874,1530,3,112567,871
2020-08-18,Virgin Islands,78,796,36,9,0,12664,246,796,36,11868,210
2020-08-18,Virginia,51,108282,861,2396,11,1390305,16863,108282,861,1282023,16002
2020-08-18,Washington,53,71032,523,1895,26,1329216,15101,69967,598,1259249,14503
2020-08-18,West Virginia,54,8731,99,164,4,365725,4886,8731,99,356994,4787
2020-08-18,Wisconsin,55,71517,721,1063,13,1146821,10066,71424,709,1075397,9357
2020-08-18,Wyoming,56,3360,29,34,1,62441,1543,3363,32,59078,1511
2020-08-19,Alabama,01,111478,1117,1944,8,885346,17087,111478,1117,773868,15970
2020-08-19,Alaska,02,5245,70,27,0,310849,840,4452,73,306397,767
2020-08-19,Arizona,04,195568,637,4643,108,1111239,7242,195557,637,915682,6605
2020-08-19,Arkansas,05,54216,729,631,12,641280,8218,54216,729,587064,7489
2020-08-19,California,06,646742,6243,11686,163,10140683,91644,638831,6164,9501852,85480
2020-08-19,Colorado,08,53943,269,1906,0,648758,4927,53901,270,594857,4657
2020-08-19,Connecticut,09,51314,59,4457,1,1002420,9689,51314,59,951106,9630
2020-08-19,Delaware,10,16643,50,595,2,214869,1024,16643,50,198226,974
2020-08-19,District of Columbia,11,13354,29,600,1,251659,2181,13354,29,238305,2152
2020-08-19,Florida,12,584039,4115,9931,174,4300083,27164,577891,4080,3722192,23084
2020-08-19,Georgia,13,227255,2574,4744,53,2075697,15378,243982,2305,1831715,13073
2020-08-19,Guam,66,1568,22,6,0,29750,524,599,22,29151,502
2020-08-19,Hawaii,15,5586,260,41,1,166113,1914,5609,394,160504,1520
2020-08-19,Idaho,16,28829,343,292,9,229123,2254,28326,384,200797,1870
2020-08-19,Illinois,17,213888,2082,8037,20,3490903,50299,213221,2295,3277682,48004
2020-08-19,Indiana,18,84308,509,3180,15,934033,5419,82336,489,851697,4930
2020-08-19,Iowa,19,53541,340,1011,9,562322,5224,53288,337,509034,4887
2020-08-19,Kansas,20,36333,701,420,5,359840,5578,35890,723,323950,4855
2020-08-19,Kentucky,21,42958,688,866,8,730820,3920,40926,627,689894,3293
2020-08-19,Louisiana,22,140044,796,4609,55,1704974,14983,139903,778,1565071,14205
2020-08-19,Maine,23,4234,21,127,0,217242,2916,4234,21,213008,2895
2020-08-19,Maryland,24,102215,435,3661,11,1175768,8463,101649,414,1074119,8049
2020-08-19,Massachusetts,25,124415,352,8876,28,1496640,20073,124415,827,1372225,19246
2020-08-19,Michigan,26,104235,708,6619,12,2395188,32663,104091,688,2291097,31975
2020-08-19,Minnesota,27,66664,557,1784,17,1020926,17620,66618,557,954308,17063
2020-08-19,Mississippi,28,74555,1348,2163,35,526732,1348,74555,1348,452177,0
2020-08-19,Missouri,29,71802,1043,1490,13,874795,7314,70675,1258,804120,6056
2020-08-19,Montana,30,5976,109,84,0,206533,1021,5956,110,200577,911
2020-08-19,Nebraska,31,31040,215,373,3,328378,2891,30825,262,297553,2629
2020-08-19,Nevada,32,63127,375,1135,33,556526,2598,63028,389,493498,2209
2020-08-19,New Hampshire,33,7036,19,427,3,188009,1102,7036,19,180973,1083
2020-08-19,New Jersey,34,190256,319,15926,1,2557712,24967,188427,329,2369285,24638
2020-08-19,New Mexico,35,23749,170,729,6,688495,5442,23749,170,664746,5272
2020-08-19,New York,36,431924,626,32451,5,7272403,80425,427202,631,6845201,79794
2020-08-19,North Carolina,37,148491,1350,2464,39,1978094,26974,147932,1153,1830162,25821
2020-08-19,North Dakota,38,8972,186,134,2,182521,1600,8963,188,173558,1412
2020-08-19,Northern Mariana Islands,69,54,0,2,0,12920,0,54,0,12866,0
2020-08-19,Ohio,39,110881,958,3907,36,1888470,19472,110881,958,1777589,18514
2020-08-19,Oklahoma,40,49923,597,699,17,782740,7740,49923,597,732817,7143
2020-08-19,Oregon,41,23887,202,408,9,501156,4818,23870,194,477286,4624
2020-08-19,Pennsylvania,42,130950,664,7593,32,1494467,14901,126149,570,1368318,14331
2020-08-19,Puerto Rico,72,27934,221,356,10,318424,81,12452,81,305972,0
2020-08-19,Rhode Island,44,20795,103,1027,3,258314,22151,20795,103,237519,22048
2020-08-19,South Carolina,45,108411,739,2360,17,884128,5647,108411,739,775717,4908
2020-08-19,South Dakota,46,10566,123,155,1,131047,1034,10566,123,120481,911
2020-08-19,Tennessee,47,134810,2014,1437,27,1928954,34582,137800,2022,1791154,32560
2020-08-19,Texas,48,582623,5403,11043,245,4517189,16544,557256,7024,3959933,9520
2020-08-19,Utah,49,47647,362,379,7,610832,4648,47521,364,563311,4284
2020-08-19,Vermont,50,1533,3,58,0,113897,-200,1533,3,112364,-203
2020-08-19,Virgin Islands,78,828,32,9,0,13345,681,828,32,12517,649
2020-08-19,Virginia,51,109019,737,2410,14,1407015,16710,109019,737,1297996,15973
2020-08-19,Washington,53,71594,562,1910,15,1344043,14827,70530,563,1273513,14264
2020-08-19,West Virginia,54,8801,70,166,2,369724,3999,8801,70,360923,3929
2020-08-19,Wisconsin,55,72204,687,1071,8,1156297,9476,72134,710,1084163,8766
2020-08-19,Wyoming,56,3430,70,34,0,63094,653,3430,67,59664,586
2020-08-20,Alabama,01,112449,971,1974,30,896779,11433,112449,971,784330,10462
2020-08-20,Alaska,02,5330,85,27,0,312647,1798,4535,83,308112,1715
2020-08-20,Arizona,04,196305,737,4688,45,1118443,7204,196280,723,922163,6481
2020-08-20,Arkansas,05,54765,549,641,10,648509,7229,54765,549,593744,6680
2020-08-20,California,06,653401,6659,11801,115,10227966,87283,644751,5920,9583215,81363
2020-08-20,Colorado,08,54285,342,1909,3,649087,329,54230,329,594857,0
2020-08-20,Connecticut,09,51432,118,4458,1,1014840,12420,51432,118,963408,12302
2020-08-20,Delaware,10,16718,75,595,0,216956,2087,16718,75,200238,2012
2020-08-20,District of Columbia,11,13409,55,601,1,253985,2326,13409,55,240576,2271
2020-08-20,Florida,12,588594,4555,10048,117,4329557,29474,582407,4516,3747150,24958
2020-08-20,Georgia,13,230288,3033,4797,53,2096835,21138,246741,2759,1850094,18379
2020-08-20,Guam,66,1673,105,7,1,30692,942,704,105,29988,837
2020-08-20,Hawaii,15,5821,235,44,3,168672,2559,5844,235,162828,2324
2020-08-20,Idaho,16,29252,423,299,7,231147,2024,28696,370,202451,1654
2020-08-20,Illinois,17,215889,2001,8064,27,3542515,51612,215053,1832,3327462,49780
2020-08-20,Indiana,18,85257,949,3191,11,945471,11438,83277,941,862194,10497
2020-08-20,Iowa,19,54533,992,1016,5,568191,5869,54015,727,514176,5142
2020-08-20,Kansas,20,36445,112,423,3,359840,0,35890,0,323950,0
2020-08-20,Kentucky,21,43700,742,881,15,739718,8898,41626,700,698092,8198
2020-08-20,Louisiana,22,140962,918,4637,28,1719034,14060,140821,918,1578213,13142
2020-08-20,Maine,23,4252,18,128,1,220185,2943,4253,19,215932,2924
2020-08-20,Maryland,24,102783,568,3669,8,1187676,11908,102229,580,1085447,11328
2020-08-20,Massachusetts,25,124728,313,8888,12,1518522,21882,124728,313,1393794,21569
2020-08-20,Michigan,26,104771,536,6636,17,2425702,30514,104618,527,2321084,29987
2020-08-20,Minnesota,27,67354,690,1791,7,1030093,9167,67308,690,962785,8477
2020-08-20,Mississippi,28,75449,894,2190,27,527626,894,75449,894,452177,0
2020-08-20,Missouri,29,72912,1110,1508,18,885874,11079,71733,1058,814141,10021
2020-08-20,Montana,30,6095,119,89,5,207560,1027,6072,116,201488,911
2020-08-20,Nebraska,31,31348,308,377,4,330408,2030,31040,215,299368,1815
2020-08-20,Nevada,32,63699,572,1175,40,560963,4437,63584,556,497379,3881
2020-08-20,New Hampshire,33,7050,14,428,1,189682,1673,7050,14,182632,1659
2020-08-20,New Jersey,34,190356,100,15932,6,2585207,27495,188527,100,2396680,27395
2020-08-20,New Mexico,35,23951,202,734,5,694824,6329,23951,202,670873,6127
2020-08-20,New York,36,432523,599,32451,0,7353387,80984,427803,601,6925584,80383
2020-08-20,North Carolina,37,150422,1931,2496,32,2003307,25213,149904,1972,1853403,23241
2020-08-20,North Dakota,38,9246,274,134,0,184782,2261,9237,274,175545,1987
2020-08-20,Northern Mariana Islands,69,54,0,2,0,12921,1,54,0,12867,1
2020-08-20,Ohio,39,112003,1122,3929,22,1911359,22889,112003,1122,1799356,21767
2020-08-20,Oklahoma,40,50669,746,709,10,790894,8154,50669,746,740225,7408
2020-08-20,Oregon,41,24176,289,412,4,506367,5211,24165,295,482202,4916
2020-08-20,Pennsylvania,42,131736,786,7606,13,1513011,18544,126940,791,1386071,17753
2020-08-20,Puerto Rico,72,28143,209,367,11,318548,124,12576,124,305972,0
2020-08-20,Rhode Island,44,20871,76,1028,1,239763,-18551,20871,76,218892,-18627
2020-08-20,South Carolina,45,109320,909,2401,41,892800,8672,109320,909,783480,7763
2020-08-20,South Dakota,46,10691,125,157,2,132108,1061,10691,125,121417,936
2020-08-20,Tennessee,47,136260,1450,1470,33,1952103,23149,139175,1375,1812928,21774
2020-08-20,Texas,48,587900,5277,11248,205,4547069,29880,562559,5303,3984510,24577
2020-08-20,Utah,49,48103,456,384,5,615619,4787,47982,461,567637,4326
2020-08-20,Vermont,50,1537,4,58,0,115459,1562,1537,4,113922,1558
2020-08-20,Virgin Islands,78,869,41,10,1,13542,197,869,41,12673,156
2020-08-20,Virginia,51,109882,863,2427,17,1422928,15913,109882,863,1313046,15050
2020-08-20,Washington,53,72284,690,1924,14,1356868,12825,70973,443,1285895,12382
2020-08-20,West Virginia,54,8982,181,166,0,377713,7989,8982,181,368731,7808
2020-08-20,Wisconsin,55,73067,863,1077,6,1166197,9900,72903,769,1093294,9131
2020-08-20,Wyoming,56,3468,38,34,0,64174,1080,3468,38,60706,1042
2020-08-21,Alabama,01,113632,1183,1996,22,897100,321,112770,321,784330,0
2020-08-21,Alaska,02,5401,71,28,1,321535,8888,4604,69,316931,8819
2020-08-21,Arizona,04,196925,620,4698,10,1127988,9545,196899,619,931089,8926
2020-08-21,Arkansas,05,55652,887,663,22,658591,10082,55652,887,602939,9195
2020-08-21,California,06,659991,6590,11984,183,10329372,101406,650336,5585,9679036,95821
2020-08-21,Colorado,08,54658,373,1915,6,649443,356,54586,356,594857,0
2020-08-21,Connecticut,09,51519,87,4460,2,1022370,7530,51519,87,970851,7443
2020-08-21,Delaware,10,16770,52,600,5,218008,1052,16770,52,201238,1000
2020-08-21,District of Columbia,11,13469,60,602,1,259058,5073,13469,60,245589,5013
2020-08-21,Florida,12,593278,4684,10167,119,4360949,31392,587023,4616,3773926,26776
2020-08-21,Georgia,13,233169,2881,4889,92,2120102,23267,249630,2889,1870472,20378
2020-08-21,Guam,66,1736,63,7,0,31516,824,767,63,30749,761
2020-08-21,Hawaii,15,6049,228,45,1,168672,0,5844,0,162828,0
2020-08-21,Idaho,16,29510,258,305,6,233780,2633,29120,424,204660,2209
2020-08-21,Illinois,17,218111,2222,8086,22,3594336,51821,217346,2293,3376990,49528
2020-08-21,Indiana,18,86312,1055,3208,17,958432,12961,84317,1040,874115,11921
2020-08-21,Iowa,19,55331,798,1030,14,573139,4948,55006,991,518133,3957
2020-08-21,Kansas,20,37411,966,430,7,366315,6475,36856,966,329459,5509
2020-08-21,Kentucky,21,44432,732,887,6,748467,8749,42265,639,706202,8110
2020-08-21,Louisiana,22,141861,899,4687,50,1738807,19773,141720,899,1597087,18874
2020-08-21,Maine,23,4285,33,129,1,223865,3680,4285,32,219580,3648
2020-08-21,Maryland,24,103461,678,3674,5,1204267,16591,102899,670,1101368,15921
2020-08-21,Massachusetts,25,125216,488,8901,13,1545337,26815,125216,488,1420121,26327
2020-08-21,Michigan,26,104829,58,6637,1,2425702,0,104618,0,2321084,0
2020-08-21,Minnesota,27,68179,825,1799,8,1041537,11444,68133,825,973404,10619
2020-08-21,Mississippi,28,76323,874,2214,24,529802,2176,76323,874,453479,1302
2020-08-21,Missouri,29,74221,1309,1511,3,896106,10232,72964,1231,823142,9001
2020-08-21,Montana,30,6239,144,90,1,208627,1067,6216,144,202411,923
2020-08-21,Nebraska,31,31626,278,381,4,333767,3359,31348,308,302419,3051
2020-08-21,Nevada,32,64573,874,1185,10,566311,5348,64433,849,501878,4499
2020-08-21,New Hampshire,33,7071,21,428,0,189682,0,7050,0,182632,0
2020-08-21,New Jersey,34,190646,290,15941,9,2615692,30485,188817,290,2426875,30195
2020-08-21,New Mexico,35,24095,144,739,5,704955,10131,24095,144,680860,9987
2020-08-21,New York,36,433230,707,32456,5,7452267,98880,428512,709,7023755,98171
2020-08-21,North Carolina,37,152344,1922,2522,26,2030885,27578,151912,2008,1878973,25570
2020-08-21,North Dakota,38,9478,232,136,2,187006,2224,9468,231,177538,1993
2020-08-21,Northern Mariana Islands,69,54,0,2,0,12921,0,54,0,12867,0
2020-08-21,Ohio,39,113046,1043,3955,26,1936895,25536,113046,1043,1823849,24493
2020-08-21,Oklahoma,40,51746,1077,715,6,800902,10008,51746,1077,749156,8931
2020-08-21,Oregon,41,24435,259,421,9,511321,4954,24421,256,486900,4698
2020-08-21,Pennsylvania,42,132461,725,7629,23,1527142,14131,127633,693,1399509,13438
2020-08-21,Puerto Rico,72,28846,703,374,7,318986,438,13014,438,305972,0
2020-08-21,Rhode Island,44,21022,151,1030,2,245854,6091,21022,151,224832,5940
2020-08-21,South Carolina,45,110378,1058,2459,58,903181,10381,110378,1058,792803,9323
2020-08-21,South Dakota,46,10884,193,159,2,133775,1667,10884,193,122891,1474
2020-08-21,Tennessee,47,137932,1672,1528,58,1981238,29135,140844,1669,1840394,27466
2020-08-21,Texas,48,593405,5505,11483,235,4580026,32957,567580,5021,4012446,27936
2020-08-21,Utah,49,48616,513,385,1,619711,4092,48445,463,571266,3629
2020-08-21,Vermont,50,1541,4,58,0,116998,1539,1541,4,115457,1535
2020-08-21,Virgin Islands,78,960,91,10,0,13827,285,932,63,12895,222
2020-08-21,Virginia,51,110860,978,2436,9,1441961,19033,110860,978,1331101,18055
2020-08-21,Washington,53,72787,503,1937,13,1369264,12396,71414,441,1297850,11955
2020-08-21,West Virginia,54,9066,84,170,4,384319,6606,9066,84,375253,6522
2020-08-21,Wisconsin,55,73895,828,1079,2,1176789,10592,73751,848,1103038,9744
2020-08-21,Wyoming,56,3524,56,37,3,64837,663,3524,56,61313,607
2020-08-22,Alabama,01,114532,900,2011,15,916282,19182,114532,1762,801750,17420
2020-08-22,Alaska,02,5492,91,29,1,326287,4752,4692,88,321595,4664
2020-08-22,Arizona,04,197909,984,4760,62,1144134,16146,197895,996,946239,15150
2020-08-22,Arkansas,05,56199,547,674,11,659138,547,56199,547,602939,0
2020-08-22,California,06,665325,5334,12137,153,10436352,106980,656892,6556,9779460,100424
2020-08-22,Colorado,08,54939,281,1923,8,649740,297,54883,297,594857,0
2020-08-22,Connecticut,09,51519,0,4460,0,1022370,0,51519,0,970851,0
2020-08-22,Delaware,10,16828,58,600,0,219876,1868,16828,58,203048,1810
2020-08-22,District of Columbia,11,13534,65,604,2,262440,3382,13534,65,248906,3317
2020-08-22,Florida,12,597589,4311,10273,106,4395533,34584,591283,4260,3804250,30324
2020-08-22,Georgia,13,235783,2614,4982,93,2149170,29068,252222,2592,1896948,26476
2020-08-22,Guam,66,1736,0,7,0,31516,0,767,0,30749,0
2020-08-22,Hawaii,15,6333,284,46,1,173550,4878,6072,228,167478,4650
2020-08-22,Idaho,16,29808,298,307,2,235853,2073,29369,249,206484,1824
2020-08-22,Illinois,17,220459,2348,8107,21,3651102,56766,219702,2356,3431400,54410
2020-08-22,Indiana,18,87325,1013,3218,10,969646,11214,85317,1000,884329,10214
2020-08-22,Iowa,19,55996,665,1033,3,578355,5216,55735,729,522620,4487
2020-08-22,Kansas,20,37544,133,431,1,366315,0,36856,0,329459,0
2020-08-22,Kentucky,21,45225,793,899,12,748467,0,42265,0,706202,0
2020-08-22,Louisiana,22,141861,0,4687,0,1738807,0,141720,0,1597087,0
2020-08-22,Maine,23,4317,32,130,1,227751,3886,4317,32,223434,3854
2020-08-22,Maryland,24,104040,579,3685,11,1220441,16174,103523,624,1116918,15550
2020-08-22,Massachusetts,25,125360,144,8921,20,1553673,8336,125360,144,1428313,8192
2020-08-22,Michigan,26,106141,1312,6657,20,2459039,33337,106044,1426,2352995,31911
2020-08-22,Minnesota,27,68913,734,1807,8,1051256,9719,68867,734,982389,8985
2020-08-22,Mississippi,28,77268,945,2237,23,533622,3820,77268,945,456354,2875
2020-08-22,Missouri,29,75468,1247,1519,8,904694,8588,74257,1293,830437,7295
2020-08-22,Montana,30,6392,153,90,0,209716,1089,6376,160,203340,929
2020-08-22,Nebraska,31,31780,154,382,1,336582,2815,31626,278,304956,2537
2020-08-22,Nevada,32,65150,577,1197,12,570126,3815,65069,636,505057,3179
2020-08-22,New Hampshire,33,7092,21,429,1,194675,4993,7092,42,187583,4951
2020-08-22,New Jersey,34,191175,529,15943,2,2648740,33048,189236,419,2459504,32629
2020-08-22,New Mexico,35,24302,207,743,4,712321,7366,24302,207,688019,7159
2020-08-22,New York,36,433881,651,32464,8,7547116,94849,429165,653,7117951,94196
2020-08-22,North Carolina,37,153966,1622,2546,24,2052118,21233,153641,1729,1898477,19504
2020-08-22,North Dakota,38,9740,262,139,3,189026,2020,9724,256,179302,1764
2020-08-22,Northern Mariana Islands,69,54,0,2,0,12921,0,54,0,12867,0
2020-08-22,Ohio,39,114165,1119,3975,20,1960628,23733,114165,1119,1846463,22614
2020-08-22,Oklahoma,40,52599,853,725,10,811934,11032,52599,853,759335,10179
2020-08-22,Oregon,41,24711,276,422,1,516464,5143,24710,289,491754,4854
2020-08-22,Pennsylvania,42,133160,699,7643,14,1540553,13411,128429,796,1412124,12615
2020-08-22,Puerto Rico,72,29577,731,381,7,319254,268,13282,268,305972,0
2020-08-22,Rhode Island,44,21022,0,1030,0,250126,4272,21175,153,228951,4119
2020-08-22,South Carolina,45,111295,917,2493,34,912132,8951,111295,917,800837,8034
2020-08-22,South Dakota,46,11135,251,160,1,135630,1855,11135,251,124495,1604
2020-08-22,Tennessee,47,139366,1434,1542,14,2007760,26522,142083,1239,1865677,25283
2020-08-22,Texas,48,599156,5751,11650,167,4640860,60834,573139,5559,4067721,55275
2020-08-22,Utah,49,48950,334,387,2,624990,5279,48814,369,576176,4910
2020-08-22,Vermont,50,1553,12,58,0,118604,1606,1553,12,117051,1594
2020-08-22,Virgin Islands,78,960,0,10,0,14318,491,960,28,13358,463
2020-08-22,Virginia,51,112072,1212,2443,7,1458475,16514,112072,1212,1346403,15302
2020-08-22,Washington,53,73353,566,1944,7,1376533,7269,71598,184,1304935,7085
2020-08-22,West Virginia,54,9185,119,176,6,391858,7539,9185,119,382673,7420
2020-08-22,Wisconsin,55,74740,845,1092,13,1185514,8725,74726,975,1110788,7750
2020-08-22,Wyoming,56,3543,19,37,0,64856,19,3543,19,61313,0
2020-08-23,Alabama,01,115060,528,2013,2,921669,5387,115060,528,806609,4859
2020-08-23,Alaska,02,5556,64,30,1,327440,1153,4758,66,322682,1087
2020-08-23,Arizona,04,198117,208,4775,15,1150869,6735,198103,208,952766,6527
2020-08-23,Arkansas,05,56574,375,687,13,665700,6562,56574,375,609126,6187
2020-08-23,California,06,669944,4619,12152,15,10541031,104679,663669,6777,9877362,97902
2020-08-23,Colorado,08,55441,502,1925,2,650000,260,55143,260,594857,0
2020-08-23,Connecticut,09,51519,0,4460,0,1022370,0,51519,0,970851,0
2020-08-23,Delaware,10,16895,67,600,0,221845,1969,16895,67,204950,1902
2020-08-23,District of Columbia,11,13590,56,604,0,266046,3606,13590,56,252456,3550
2020-08-23,Florida,12,600563,2974,10324,51,4422349,26816,594287,3004,3828062,23812
2020-08-23,Georgia,13,237402,1619,5021,39,2171884,22714,253949,1727,1917935,20987
2020-08-23,Guam,66,1736,0,7,0,32591,1075,820,53,31771,1022
2020-08-23,Hawaii,15,6577,244,46,0,176184,2634,6356,284,169828,2350
2020-08-23,Idaho,16,29973,165,308,1,237280,1427,29662,293,207618,1134
2020-08-23,Illinois,17,222292,1833,8114,7,3705453,54351,221595,1893,3483858,52458
2020-08-23,Indiana,18,87942,617,3220,2,977802,8156,85932,615,891870,7541
2020-08-23,Iowa,19,56441,445,1037,4,581976,3621,56275,540,525701,3081
2020-08-23,Kansas,20,37726,182,431,0,366315,0,36856,0,329459,0
2020-08-23,Kentucky,21,45401,176,901,2,749731,1264,43529,1264,706202,0
2020-08-23,Louisiana,22,143084,1223,4746,59,1763838,25031,142943,1223,1620895,23808
2020-08-23,Maine,23,4335,18,131,1,231701,3950,4335,18,227366,3932
2020-08-23,Maryland,24,104618,578,3691,6,1232896,12455,104102,579,1128794,11876
2020-08-23,Massachusetts,25,125360,0,8921,0,1553673,0,125360,0,1428313,0
2020-08-23,Michigan,26,106875,734,6661,4,2533472,74433,106808,764,2426664,73669
2020-08-23,Minnesota,27,69630,717,1813,6,1060320,9064,69584,717,990736,8347
2020-08-23,Mississippi,28,77894,626,2240,3,534248,626,77894,626,456354,0
2020-08-23,Missouri,29,76339,871,1519,0,914833,10139,75075,818,839758,9321
2020-08-23,Montana,30,6444,52,90,0,210749,1033,6429,53,204320,980
2020-08-23,Nebraska,31,31889,109,384,2,338361,1779,31780,154,306581,1625
2020-08-23,Nevada,32,65678,528,1199,2,574229,4103,65601,532,508628,3571
2020-08-23,New Hampshire,33,7107,15,429,0,196064,1389,7107,15,188957,1374
2020-08-23,New Jersey,34,191323,148,15946,3,2648998,258,189494,258,2459504,0
2020-08-23,New Mexico,35,24396,94,745,2,719300,6979,24396,94,694904,6885
2020-08-23,New York,36,434462,581,32482,18,7621159,74043,429737,572,7191422,73471
2020-08-23,North Carolina,37,155390,1424,2560,14,2078472,26354,155113,1472,1923359,24882
2020-08-23,North Dakota,38,9880,140,140,1,190872,1846,9863,139,181009,1707
2020-08-23,Northern Mariana Islands,69,54,0,2,0,12921,0,54,0,12867,0
2020-08-23,Ohio,39,114802,637,3978,3,1983889,23261,114802,637,1869087,22624
2020-08-23,Oklahoma,40,53165,566,726,1,812500,566,53165,566,759335,0
2020-08-23,Oregon,41,24938,227,422,0,519820,3356,24937,227,494883,3129
2020-08-23,Pennsylvania,42,133679,519,7643,0,1553020,12467,129048,619,1423972,11848
2020-08-23,Puerto Rico,72,29896,319,390,9,319449,195,13477,195,305972,0
2020-08-23,Rhode Island,44,21022,0,1030,0,252571,2445,21263,88,231308,2357
2020-08-23,South Carolina,45,111988,693,2504,11,892336,-19796,111988,693,780348,-20489
2020-08-23,South Dakota,46,11276,141,161,1,136760,1130,11276,141,125484,989
2020-08-23,Tennessee,47,141000,1634,1547,5,2045193,37433,143937,1854,1901256,35579
2020-08-23,Texas,48,602144,2988,11760,110,4668028,27168,577537,4398,4090491,22770
2020-08-23,Utah,49,49125,175,387,0,628473,3483,49115,301,579358,3182
2020-08-23,Vermont,50,1557,4,58,0,120043,1439,1557,4,118486,1435
2020-08-23,Virgin Islands,78,984,24,11,1,14318,0,960,0,13358,0
2020-08-23,Virginia,51,112966,894,2467,24,1470887,12412,112966,894,1357921,11518
2020-08-23,Washington,53,73745,392,1948,4,1379036,2503,71659,61,1307377,2442
2020-08-23,West Virginia,54,9272,87,178,2,396193,4335,9272,87,386921,4248
2020-08-23,Wisconsin,55,75205,465,1092,0,1190354,4840,75205,479,1115149,4361
2020-08-23,Wyoming,56,3579,36,37,0,64892,36,3579,36,61313,0
2020-08-24,Alabama,01,116710,1650,2024,11,923319,1650,116710,1650,806609,0
2020-08-24,Alaska,02,5626,70,30,0,330503,3063,4829,71,325674,2992
2020-08-24,Arizona,04,198421,304,4775,0,1157222,6353,198414,311,958808,6042
2020-08-24,Arkansas,05,56894,320,696,9,673704,8004,56894,320,616810,7684
2020-08-24,California,06,676236,6292,12250,98,10652487,111456,668615,4946,9983872,106510
2020-08-24,Colorado,08,55700,259,1926,1,650198,198,55341,198,594857,0
2020-08-24,Connecticut,09,52011,492,4460,0,1077716,55346,52011,492,1025705,54854
2020-08-24,Delaware,10,16942,47,604,4,223501,1656,16942,47,206559,1609
2020-08-24,District of Columbia,11,13639,49,604,0,269401,3355,13639,49,255762,3306
2020-08-24,Florida,12,602821,2258,10396,72,4440838,18489,596511,2224,3844327,16265
2020-08-24,Georgia,13,239612,2210,5045,24,2205181,33297,256253,2304,1948928,30993
2020-08-24,Guam,66,1876,140,8,1,33471,880,907,87,32564,793
2020-08-24,Hawaii,15,6746,169,48,2,178824,2640,6600,244,172224,2396
2020-08-24,Idaho,16,30260,287,315,7,238585,1305,29853,191,208732,1114
2020-08-24,Illinois,17,224056,1764,8123,9,3741608,36155,223207,1612,3518401,34543
2020-08-24,Indiana,18,89602,1660,3225,5,1002038,24236,87592,1660,914446,22576
2020-08-24,Iowa,19,56941,500,1047,10,584098,2122,56633,358,527465,1764
2020-08-24,Kansas,20,39008,1282,432,1,386957,20642,38401,1545,348556,19097
2020-08-24,Kentucky,21,46057,656,909,8,767464,17733,43899,370,723565,17363
2020-08-24,Louisiana,22,143707,623,4764,18,1772481,8643,143566,623,1628915,8020
2020-08-24,Maine,23,4356,21,131,0,234856,3155,4356,21,230500,3134
2020-08-24,Maryland,24,105168,550,3694,3,1247593,14697,104669,567,1142924,14130
2020-08-24,Massachusetts,25,126022,662,8949,28,1591579,37906,126022,662,1465557,37244
2020-08-24,Michigan,26,107816,941,6665,4,2554894,21422,107686,878,2447208,20544
2020-08-24,Minnesota,27,70344,714,1817,4,1067810,7490,70298,714,997512,6776
2020-08-24,Mississippi,28,78405,511,2248,8,542662,8414,78405,511,464257,7903
2020-08-24,Missouri,29,77254,915,1533,14,919712,4879,75944,869,843768,4010
2020-08-24,Montana,30,6510,66,91,1,233673,22924,6489,60,227184,22864
2020-08-24,Nebraska,31,32047,158,384,0,339600,1239,31889,109,307711,1130
2020-08-24,Nevada,32,66073,395,1200,1,576677,2448,66010,409,510667,2039
2020-08-24,New Hampshire,33,7134,27,429,0,198229,2165,7134,27,191095,2138
2020-08-24,New Jersey,34,191548,225,15946,0,2676812,27814,189719,225,2487093,27589
2020-08-24,New Mexico,35,24469,73,747,2,723801,4501,24469,73,699332,4428
2020-08-24,New York,36,434866,404,32489,7,7683190,62031,430145,408,7253045,61623
2020-08-24,North Carolina,37,156927,1537,2567,7,2087695,9223,156396,1283,1931299,7940
2020-08-24,North Dakota,38,10004,124,141,1,192007,1135,9989,126,182018,1009
2020-08-24,Northern Mariana Islands,69,54,0,2,0,12921,0,54,0,12867,0
2020-08-24,Ohio,39,115651,849,3986,8,2004200,20311,115651,849,1888549,19462
2020-08-24,Oklahoma,40,53522,357,730,4,812857,357,53522,357,759335,0
2020-08-24,Oregon,41,25174,236,432,10,523337,3517,25155,218,498182,3299
2020-08-24,Pennsylvania,42,134246,567,7642,-1,1562838,9818,129474,426,1433364,9392
2020-08-24,Puerto Rico,72,30618,722,390,0,319894,445,13922,445,305972,0
2020-08-24,Rhode Island,44,21302,280,1035,5,254674,2103,21302,39,233372,2064
2020-08-24,South Carolina,45,112551,563,2511,7,896477,4141,112551,563,783926,3578
2020-08-24,South Dakota,46,11425,149,161,0,137463,703,11425,149,126038,554
2020-08-24,Tennessee,47,141675,675,1578,31,2059354,14161,144604,667,1914750,13494
2020-08-24,Texas,48,607621,5477,11824,64,4670875,2847,580384,2847,4090491,0
2020-08-24,Utah,49,49451,326,391,4,631297,2824,49364,249,581933,2575
2020-08-24,Vermont,50,1566,9,58,0,121390,1347,1566,9,119824,1338
2020-08-24,Virgin Islands,78,998,14,12,1,14442,124,984,24,13458,100
2020-08-24,Virginia,51,113630,664,2471,4,1483980,13093,113630,664,1370350,12429
2020-08-24,Washington,53,74292,547,1953,5,1380050,1014,71681,22,1308369,992
2020-08-24,West Virginia,54,9312,40,179,1,398654,2461,9312,40,389342,2421
2020-08-24,Wisconsin,55,75755,550,1093,1,1195241,4887,75619,414,1119622,4473
2020-08-24,Wyoming,56,3603,24,37,0,66022,1130,3603,24,62419,1106
2020-08-25,Alabama,01,117242,532,2037,13,927277,3958,117242,532,810035,3426
2020-08-25,Alaska,02,5621,-5,33,3,333831,3328,4862,33,328969,3295
2020-08-25,Arizona,04,199293,872,4796,21,1162204,4982,199273,859,962931,4123
2020-08-25,Arkansas,05,57374,480,711,15,674184,480,57374,480,616810,0
2020-08-25,California,06,682320,6084,12409,159,10762506,110019,673095,4480,10089411,105539
2020-08-25,Colorado,08,56176,476,1932,6,682061,31863,55800,459,626261,31404
2020-08-25,Connecticut,09,52040,29,4463,3,1082706,4990,52040,29,1030666,4961
2020-08-25,Delaware,10,16962,20,603,-1,225328,1827,16962,20,208366,1807
2020-08-25,District of Columbia,11,13684,45,604,0,271622,2221,13684,45,257938,2176
2020-08-25,Florida,12,605494,2673,10579,183,4460198,19360,599176,2665,3861022,16695
2020-08-25,Georgia,13,241865,2253,5147,102,2230850,25669,258354,2101,1972496,23568
2020-08-25,Guam,66,1953,77,8,0,34402,931,984,77,33418,854
2020-08-25,Hawaii,15,6961,215,48,0,180850,2026,6984,384,173866,1642
2020-08-25,Idaho,16,30648,388,328,13,240095,1510,30070,217,210025,1293
2020-08-25,Illinois,17,225812,1756,8155,32,3782467,40859,224887,1680,3557580,39179
2020-08-25,Indiana,18,90460,858,3241,16,1010981,8943,88421,829,922560,8114
2020-08-25,Iowa,19,57606,665,1059,12,587743,3645,57294,661,530449,2984
2020-08-25,Kansas,20,39089,81,433,1,386957,0,38401,0,348556,0
2020-08-25,Kentucky,21,46798,741,918,9,775468,8004,44568,669,730900,7335
2020-08-25,Louisiana,22,144257,550,4797,33,1794062,21581,144116,550,1649946,21031
2020-08-25,Maine,23,4368,12,131,0,237374,2518,4368,12,233006,2506
2020-08-25,Maryland,24,105554,386,3707,13,1255565,7972,105046,377,1150519,7595
2020-08-25,Massachusetts,25,126420,398,8961,12,1614402,22823,126420,398,1487982,22425
2020-08-25,Michigan,26,108742,926,6687,22,2579175,24281,108637,951,2470538,23330
2020-08-25,Minnesota,27,70753,409,1825,8,1072526,4716,70707,409,1001819,4307
2020-08-25,Mississippi,28,79206,801,2315,67,547261,4599,79206,801,468055,3798
2020-08-25,Missouri,29,78246,992,1553,20,924078,4366,76636,692,847442,3674
2020-08-25,Montana,30,6649,139,97,6,236507,2834,6624,135,229883,2699
2020-08-25,Nebraska,31,32379,332,386,2,340481,881,32047,158,308434,723
2020-08-25,Nevada,32,66515,442,1230,30,579282,2605,66413,403,512869,2202
2020-08-25,New Hampshire,33,7150,16,429,0,199871,1642,7150,16,192721,1626
2020-08-25,New Jersey,34,191850,302,15953,7,2697895,21083,190021,302,2507874,20781
2020-08-25,New Mexico,35,24535,66,750,3,728627,4826,24535,66,704092,4760
2020-08-25,New York,36,435495,629,32495,6,7750445,67255,430774,629,7319671,66626
2020-08-25,North Carolina,37,158185,1258,2607,40,2102359,14664,157741,1345,1944618,13319
2020-08-25,North Dakota,38,10233,229,142,1,193593,1586,10223,234,183370,1352
2020-08-25,Northern Mariana Islands,69,54,0,2,0,12921,0,54,0,12867,0
2020-08-25,Ohio,39,116495,844,3996,10,2027874,23674,116495,844,1911379,22830
2020-08-25,Oklahoma,40,54172,650,744,14,830831,17974,54172,650,776659,17324
2020-08-25,Oregon,41,25408,234,436,4,528009,4672,25391,236,502618,4436
2020-08-25,Pennsylvania,42,134803,557,7666,24,1575205,12367,130035,561,1445170,11806
2020-08-25,Puerto Rico,72,30720,102,395,5,319964,70,13992,70,305972,0
2020-08-25,Rhode Island,44,21372,70,1039,4,257789,3115,21372,70,236417,3045
2020-08-25,South Carolina,45,113488,937,2529,18,906107,9630,113488,937,792619,8693
2020-08-25,South Dakota,46,11559,134,161,0,137733,270,11559,134,126174,136
2020-08-25,Tennessee,47,142501,826,1605,27,2074612,15258,145417,813,1929195,14445
2020-08-25,Texas,48,613707,6086,12012,188,4724559,53684,586730,6346,4137829,47338
2020-08-25,Utah,49,49870,419,398,7,635133,3836,49767,403,585366,3433
2020-08-25,Vermont,50,1572,6,58,0,122078,688,1572,6,120506,682
2020-08-25,Virgin Islands,78,1030,32,14,2,14611,169,998,14,13613,155
2020-08-25,Virginia,51,114635,1005,2494,23,1499970,15990,114635,1005,1385335,14985
2020-08-25,Washington,53,74634,342,1962,9,1380050,0,71681,0,1308369,0
2020-08-25,West Virginia,54,9395,83,187,8,403570,4916,9395,83,394175,4833
2020-08-25,Wisconsin,55,76453,698,1106,13,1205277,10036,76306,687,1128971,9349
2020-08-25,Wyoming,56,3634,31,37,0,70528,4506,3634,31,66894,4475
2020-08-26,Alabama,01,119254,2012,2045,8,943685,16408,119254,2012,824431,14396
2020-08-26,Alaska,02,5671,50,34,1,334804,973,4914,52,329890,921
2020-08-26,Arizona,04,199495,202,4899,103,1166910,4706,199459,186,967451,4520
2020-08-26,Arkansas,05,58023,649,732,21,683273,9089,58023,649,625250,8440
2020-08-26,California,06,687612,5292,12547,138,10832757,70251,679099,6004,10153658,64247
2020-08-26,Colorado,08,56346,170,1933,1,686103,4042,55993,193,630110,3849
2020-08-26,Connecticut,09,52220,180,4463,0,1098035,15329,52220,180,1045815,15149
2020-08-26,Delaware,10,16986,24,604,1,227095,1767,16986,24,210109,1743
2020-08-26,District of Columbia,11,13722,38,605,1,273748,2126,13722,38,260026,2088
2020-08-26,Florida,12,608714,3220,10732,153,4486209,26011,602113,2937,3884096,23074
2020-08-26,Georgia,13,244494,2629,5195,48,2248901,18051,260590,2236,1988311,15815
2020-08-26,Guam,66,2089,136,10,2,35354,952,1120,136,34234,816
2020-08-26,Hawaii,15,7236,275,50,2,183157,2307,6984,0,176173,2307
2020-08-26,Idaho,16,30968,320,337,9,244862,4767,30475,405,214387,4362
2020-08-26,Illinois,17,227872,2060,8186,31,3832829,50362,227044,2157,3605785,48205
2020-08-26,Indiana,18,91403,943,3259,18,1022537,11556,89359,938,933178,10618
2020-08-26,Iowa,19,58864,1258,1077,18,593808,6065,58235,941,535573,5124
2020-08-26,Kansas,20,40564,1475,445,12,395097,8140,39937,1536,355160,6604
2020-08-26,Kentucky,21,47542,744,927,9,783389,7921,45230,662,738159,7259
2020-08-26,Louisiana,22,145661,1404,4851,54,1808868,14806,145661,1545,1663207,13261
2020-08-26,Maine,23,4389,21,132,1,241996,4622,4389,21,237607,4601
2020-08-26,Maryland,24,105996,442,3717,10,1263171,7606,105486,440,1157685,7166
2020-08-26,Massachusetts,25,126756,336,8987,26,1634167,19765,126756,336,1507411,19429
2020-08-26,Michigan,26,109645,903,6692,5,2620352,41177,109480,843,2510872,40334
2020-08-26,Minnesota,27,71285,532,1842,17,1079047,6521,71236,529,1007811,5992
2020-08-26,Mississippi,28,80110,904,2373,58,551790,4529,80110,904,471680,3625
2020-08-26,Missouri,29,79588,1342,1566,13,932140,8062,78062,1426,854078,6636
2020-08-26,Montana,30,6807,158,98,1,238260,1753,6785,161,231475,1592
2020-08-26,Nebraska,31,32727,348,390,4,344760,4279,32348,301,312412,3978
2020-08-26,Nevada,32,66732,217,1250,20,581155,1873,66666,253,514489,1620
2020-08-26,New Hampshire,33,7159,9,430,1,201835,1964,7159,9,194676,1955
2020-08-26,New Jersey,34,192086,236,15914,-39,2721584,23689,190306,285,2531278,23404
2020-08-26,New Mexico,35,24732,197,755,5,734220,5593,24732,197,709488,5396
2020-08-26,New York,36,436063,568,32499,4,7821634,71189,431340,566,7390294,70623
2020-08-26,North Carolina,37,159708,1523,2634,27,2121001,18642,158985,1244,1962016,17398
2020-08-26,North Dakota,38,10471,238,142,0,195108,1515,10457,234,184651,1281
2020-08-26,Northern Mariana Islands,69,54,0,2,0,12921,0,54,0,12867,0
2020-08-26,Ohio,39,117584,1089,4044,48,2047906,20032,117584,1089,1930322,18943
2020-08-26,Oklahoma,40,54838,666,763,19,837384,6553,54838,666,782546,5887
2020-08-26,Oregon,41,25575,167,438,2,532738,4729,25571,180,507167,4549
2020-08-26,Pennsylvania,42,135323,520,7691,25,1588178,12973,130536,501,1457642,12472
2020-08-26,Puerto Rico,72,30744,24,404,9,319982,18,14010,18,305972,0
2020-08-26,Rhode Island,44,21454,82,1041,2,259630,1841,21454,82,238176,1759
2020-08-26,South Carolina,45,114093,605,2573,44,910079,3972,114093,605,795986,3367
2020-08-26,South Dakota,46,11851,292,162,1,138045,312,11851,292,126194,20
2020-08-26,Tennessee,47,144400,1899,1623,18,2102121,27509,147353,1936,1954768,25573
2020-08-26,Texas,48,619836,6129,12212,200,4764640,40081,592137,5407,4172503,34674
2020-08-26,Utah,49,50298,428,404,6,639428,4295,50174,407,589254,3888
2020-08-26,Vermont,50,1577,5,58,0,122841,763,1577,5,121264,758
2020-08-26,Virgin Islands,78,1030,0,14,0,14965,354,1030,32,13935,322
2020-08-26,Virginia,51,115458,823,2515,21,1507542,7572,115458,823,1392084,6749
2020-08-26,Washington,53,75207,573,1968,6,1380104,54,71705,24,1308399,30
2020-08-26,West Virginia,54,9540,145,190,3,409605,6035,9540,145,400065,5890
2020-08-26,Wisconsin,55,77220,767,1112,6,1215673,10396,77092,786,1138581,9610
2020-08-26,Wyoming,56,3684,50,37,0,70578,50,3684,50,66894,0
2020-08-27,Alabama,01,121023,1769,2076,31,956809,13124,121023,1769,835786,11355
2020-08-27,Alaska,02,5752,81,34,0,336220,1416,4998,84,331222,1332
2020-08-27,Arizona,04,200172,677,4932,33,1174928,8018,200139,680,974789,7338
2020-08-27,Arkansas,05,58745,722,739,7,690028,6755,58745,722,631283,6033
2020-08-27,California,06,692962,5350,12696,149,10918415,85658,683529,4430,10234886,81228
2020-08-27,Colorado,08,56706,360,1937,4,691311,5208,56343,350,634968,4858
2020-08-27,Connecticut,09,52350,130,4465,2,1113496,15461,52350,130,1061146,15331
2020-08-27,Delaware,10,16976,-10,604,0,228059,964,16976,-10,211083,974
2020-08-27,District of Columbia,11,13794,72,605,0,276704,2956,13794,72,262910,2884
2020-08-27,Florida,12,611983,3269,10867,135,4510715,24506,605342,3229,3905373,21277
2020-08-27,Georgia,13,247017,2523,5275,80,2268837,19936,263074,2484,2005763,17452
2020-08-27,Guam,66,2201,112,10,0,36356,1002,1232,112,35124,890
2020-08-27,Hawaii,15,7542,306,54,4,185675,2518,7260,276,178415,2242
2020-08-27,Idaho,16,31326,358,343,6,246671,1809,30780,305,215891,1504
2020-08-27,Illinois,17,229598,1726,8206,20,3877339,44510,228751,1707,3648588,42803
2020-08-27,Indiana,18,92566,1163,3266,7,1034746,12209,90504,1145,944242,11064
2020-08-27,Iowa,19,61484,2620,1091,14,601643,7835,59786,1551,541857,6284
2020-08-27,Kansas,20,40702,138,446,1,395097,0,39937,0,355160,0
2020-08-27,Kentucky,21,48322,780,937,10,792885,9496,45978,748,746907,8748
2020-08-27,Louisiana,22,146338,677,4874,23,1818904,10036,146338,677,1672566,9359
2020-08-27,Maine,23,4414,25,132,0,245927,3931,4414,25,241513,3906
2020-08-27,Maryland,24,106558,562,3722,5,1275082,11911,106063,577,1169019,11334
2020-08-27,Massachusetts,25,127124,368,9008,21,1659510,25343,127124,368,1532386,24975
2020-08-27,Michigan,26,110491,846,6708,16,2650831,30479,110343,863,2540488,29616
2020-08-27,Minnesota,27,72439,1154,1855,13,1093490,14443,72390,1154,1021100,13289
2020-08-27,Mississippi,28,80695,585,2399,26,556638,4848,80695,585,475943,4263
2020-08-27,Missouri,29,80913,1325,1583,17,943023,10883,79574,1512,863449,9371
2020-08-27,Montana,30,6960,153,98,0,240659,2399,6929,144,233730,2255
2020-08-27,Nebraska,31,33101,374,394,4,348575,3815,32727,379,315848,3436
2020-08-27,Nevada,32,67324,592,1274,24,584232,3077,67220,554,517012,2523
2020-08-27,New Hampshire,33,7194,35,431,1,204017,2182,7194,35,196823,2147
2020-08-27,New Jersey,34,192393,307,15921,7,2748836,27252,190613,307,2558223,26945
2020-08-27,New Mexico,35,24920,188,764,9,740366,6146,24920,188,715446,5958
2020-08-27,New York,36,436852,789,32507,8,7905071,83437,432131,791,7472940,82646
2020-08-27,North Carolina,37,161715,2007,2654,20,2152725,31724,161076,2091,1991649,29633
2020-08-27,North Dakota,38,10804,333,143,1,196549,1441,10790,333,185759,1108
2020-08-27,Northern Mariana Islands,69,54,0,2,0,13540,619,54,0,13486,619
2020-08-27,Ohio,39,118828,1244,4076,32,2116289,68383,118828,1244,1997461,67139
2020-08-27,Oklahoma,40,55550,712,778,15,845849,8465,55550,712,790299,7753
2020-08-27,Oregon,41,25775,200,444,6,538716,5978,25761,190,512955,5788
2020-08-27,Pennsylvania,42,135958,635,7702,11,1602921,14743,131156,620,1471765,14123
2020-08-27,Puerto Rico,72,31383,639,412,8,320441,459,14469,459,305972,0
2020-08-27,Rhode Island,44,21589,135,1044,3,263413,3783,21589,135,241824,3648
2020-08-27,South Carolina,45,114598,505,2628,55,918019,7940,114598,505,803421,7435
2020-08-27,South Dakota,46,12194,343,162,0,141283,3238,12194,343,129089,2895
2020-08-27,Tennessee,47,146183,1783,1650,27,2128229,26108,149179,1826,1979050,24282
2020-08-27,Texas,48,623647,3811,12444,232,4793914,29274,597737,5600,4196177,23674
2020-08-27,Utah,49,50668,370,404,0,643883,4455,50557,383,593326,4072
2020-08-27,Vermont,50,1586,9,58,0,124831,1990,1586,9,123245,1981
2020-08-27,Virgin Islands,78,1075,45,14,0,15196,231,1052,22,14144,209
2020-08-27,Virginia,51,116579,1121,2527,12,1507542,0,115458,0,1392084,0
2020-08-27,Washington,53,75752,545,1977,9,1391309,11205,72161,456,1319148,10749
2020-08-27,West Virginia,54,9633,93,199,9,413809,4204,9633,93,404176,4111
2020-08-27,Wisconsin,55,78136,916,1121,9,1226498,10825,78004,912,1148494,9913
2020-08-27,Wyoming,56,3722,38,37,0,74532,3954,3722,38,70810,3916
2020-08-28,Alabama,01,122185,1162,2107,31,964863,8054,122185,1162,842678,6892
2020-08-28,Alaska,02,5874,122,34,0,339538,3318,5114,116,334424,3202
2020-08-28,Arizona,04,200694,522,4980,48,1184077,9149,200658,519,983419,8630
2020-08-28,Arkansas,05,59583,838,756,17,698055,8027,59583,838,638472,7189
2020-08-28,California,06,698389,5427,12836,140,11010637,92222,688858,5329,10321779,86893
2020-08-28,Colorado,08,57158,452,1945,8,699384,8073,56773,430,642611,7643
2020-08-28,Connecticut,09,52495,145,4465,0,1127506,14010,52495,145,1075011,13865
2020-08-28,Delaware,10,17083,107,604,0,231041,2982,17083,107,213958,2875
2020-08-28,District of Columbia,11,13851,57,605,0,281549,4845,13851,57,267698,4788
2020-08-28,Florida,12,615798,3815,10956,89,4540945,30230,609074,3732,3931871,26498
2020-08-28,Georgia,13,249317,2300,5352,77,2286984,18147,265372,2298,2021612,15849
2020-08-28,Guam,66,2256,55,11,1,36926,570,1287,55,35639,515
2020-08-28,Hawaii,15,7806,264,58,4,188153,2478,7566,306,180587,2172
2020-08-28,Idaho,16,31643,317,357,14,249187,2516,31122,342,218065,2174
2020-08-28,Illinois,17,232052,2454,8229,23,3926007,48668,231185,2434,3694822,46234
2020-08-28,Indiana,18,93387,821,3277,11,1044049,9303,91313,809,952736,8494
2020-08-28,Iowa,19,62828,1344,1108,17,607159,5516,60971,1185,546188,4331
2020-08-28,Kansas,20,41808,1106,448,2,403147,8050,41048,1111,362099,6939
2020-08-28,Kentucky,21,48937,615,945,8,804650,11765,46757,779,757893,10986
2020-08-28,Louisiana,22,146944,606,4904,30,1829179,10275,146944,606,1682235,9669
2020-08-28,Maine,23,4436,22,132,0,251173,5246,4436,22,246737,5224
2020-08-28,Maryland,24,107146,588,3736,14,1291270,16188,106664,601,1184606,15587
2020-08-28,Massachusetts,25,127584,460,9024,16,1683248,23738,127584,460,1555664,23278
2020-08-28,Michigan,26,111303,812,6714,6,2683874,33043,111136,793,2572738,32250
2020-08-28,Minnesota,27,73289,850,1859,4,1101710,8220,73240,850,1028470,7370
2020-08-28,Mississippi,28,81294,599,2413,14,562882,6244,81294,599,481588,5645
2020-08-28,Missouri,29,82449,1536,1599,16,954633,11610,80992,1418,873641,10192
2020-08-28,Montana,30,7086,126,100,2,242875,2216,7063,134,235812,2082
2020-08-28,Nebraska,31,33436,335,399,5,352419,3844,33101,374,319318,3470
2020-08-28,Nevada,32,67984,660,1287,13,588551,4319,67852,632,520699,3687
2020-08-28,New Hampshire,33,7216,22,432,1,206157,2140,7216,22,198941,2118
2020-08-28,New Jersey,34,192751,358,15930,9,2749194,358,190971,358,2558223,0
2020-08-28,New Mexico,35,25042,122,767,3,747277,6911,25042,122,722235,6789
2020-08-28,New York,36,437487,635,32515,8,8002897,97826,432767,636,7570130,97190
2020-08-28,North Carolina,37,163154,1439,2676,22,2182891,30166,162491,1415,2020400,28751
2020-08-28,North Dakota,38,11114,310,143,0,197988,1439,11102,312,186886,1127
2020-08-28,Northern Mariana Islands,69,54,0,2,0,13540,0,54,0,13486,0
2020-08-28,Ohio,39,120124,1296,4105,29,2141055,24766,120124,1296,2020931,23470
2020-08-28,Oklahoma,40,56260,710,786,8,855780,9931,56260,710,799520,9221
2020-08-28,Oregon,41,26069,294,457,13,543867,5151,26054,293,517813,4858
2020-08-28,Pennsylvania,42,136824,866,7722,20,1620826,17905,131991,835,1488835,17070
2020-08-28,Puerto Rico,72,31988,605,424,12,320698,257,14726,257,305972,0
2020-08-28,Rhode Island,44,21683,94,1046,2,266791,3378,21683,94,245108,3284
2020-08-28,South Carolina,45,115951,1353,2655,27,926509,8490,115951,1353,810558,7137
2020-08-28,South Dakota,46,12517,323,165,3,142940,1657,12517,323,130423,1334
2020-08-28,Tennessee,47,147814,1631,1675,25,2155504,27275,150815,1636,2004689,25639
2020-08-28,Texas,48,628492,4845,12615,171,4842362,48448,601768,4031,4240594,44417
2020-08-28,Utah,49,51071,403,408,4,647583,3700,50948,391,596635,3309
2020-08-28,Vermont,50,1589,3,58,0,126755,1924,1589,3,125166,1921
2020-08-28,Virgin Islands,78,1075,0,14,0,15379,183,1075,23,14304,160
2020-08-28,Virginia,51,117592,1013,2550,23,1544436,36894,117592,2134,1426844,34760
2020-08-28,Washington,53,76397,645,1992,15,1408164,16855,72703,542,1335461,16313
2020-08-28,West Virginia,54,9824,191,202,3,419581,5772,9824,191,409757,5581
2020-08-28,Wisconsin,55,78984,848,1123,2,1235675,9177,78868,864,1156807,8313
2020-08-28,Wyoming,56,3763,41,37,0,75236,704,3763,41,71473,663
2020-08-29,Alabama,01,123889,1704,2152,45,975818,10955,123889,1704,851929,9251
2020-08-29,Alaska,02,5985,111,34,0,345695,6157,5207,93,340488,6064
2020-08-29,Arizona,04,201317,623,5010,30,1192376,8299,201287,629,991089,7670
2020-08-29,Arkansas,05,60378,795,772,16,706970,8915,60378,795,646592,8120
2020-08-29,California,06,702499,4110,12906,70,11109630,98993,693839,4981,10415791,94012
2020-08-29,Colorado,08,57326,168,1946,1,705209,5825,57041,268,648168,5557
2020-08-29,Connecticut,09,52495,0,4465,0,1127506,0,52495,0,1075011,0
2020-08-29,Delaware,10,17349,266,604,0,232884,1843,17349,266,215535,1577
2020-08-29,District of Columbia,11,13925,74,605,0,285756,4207,13925,74,271831,4133
2020-08-29,Florida,12,618995,3197,11104,148,4568414,27469,612206,3132,3956208,24337
2020-08-29,Georgia,13,251676,2359,5451,99,2312179,25195,267758,2386,2044421,22809
2020-08-29,Guam,66,2256,0,11,0,37460,534,1347,60,36113,474
2020-08-29,Hawaii,15,8115,309,61,3,190910,2757,7830,264,183080,2493
2020-08-29,Idaho,16,31874,231,359,2,251050,1863,31384,262,219666,1601
2020-08-29,Illinois,17,233806,1754,8236,7,3974791,48784,233065,1880,3741726,46904
2020-08-29,Indiana,18,94512,1125,3285,8,1055793,11744,92434,1121,963359,10623
2020-08-29,Iowa,19,63836,1008,1110,2,612579,5420,61749,778,550830,4642
2020-08-29,Kansas,20,41909,101,449,1,403147,0,41048,0,362099,0
2020-08-29,Kentucky,21,49914,977,951,6,815659,11009,47577,820,768082,10189
2020-08-29,Louisiana,22,146944,0,4904,0,1829179,0,146944,0,1682235,0
2020-08-29,Maine,23,4489,53,132,0,255358,4185,4489,53,250869,4132
2020-08-29,Maryland,24,107790,644,3746,10,1304483,13213,107294,630,1197189,12583
2020-08-29,Massachusetts,25,128030,446,9036,12,1707155,23907,128030,446,1579125,23461
2020-08-29,Michigan,26,112104,801,6747,33,2683874,0,111136,0,2572738,0
2020-08-29,Minnesota,27,74306,1017,1863,4,1111137,9427,74257,1017,1036880,8410
2020-08-29,Mississippi,28,82029,735,2427,14,568517,5635,82029,735,486488,4900
2020-08-29,Missouri,29,83973,1524,1613,14,965326,10693,82190,1198,883136,9495
2020-08-29,Montana,30,7256,170,104,4,245381,2506,7251,188,238130,2318
2020-08-29,Nebraska,31,33753,317,400,1,355218,2799,33436,335,321782,2464
2020-08-29,Nevada,32,68576,592,1303,16,592521,3970,68461,609,524060,3361
2020-08-29,New Hampshire,33,7246,30,432,0,207340,1183,7246,30,200094,1153
2020-08-29,New Jersey,34,193100,349,15933,3,2807747,58553,191320,349,2616427,58204
2020-08-29,New Mexico,35,25178,136,769,2,752522,5245,25178,136,727344,5109
2020-08-29,New York,36,438122,635,32522,7,8096770,93873,433402,635,7663368,93238
2020-08-29,North Carolina,37,165533,2379,2708,32,2218149,35258,165076,2585,2053073,32673
2020-08-29,North Dakota,38,11488,374,145,2,199738,1750,11475,373,188263,1377
2020-08-29,Northern Mariana Islands,69,56,2,2,0,13542,2,56,2,13486,0
2020-08-29,Ohio,39,121340,1216,4126,21,2171126,30071,121340,1216,2049786,28855
2020-08-29,Oklahoma,40,57353,1093,797,11,863898,8118,57353,1093,806545,7025
2020-08-29,Oregon,41,26293,224,460,3,548850,4983,26293,239,522557,4744
2020-08-29,Pennsylvania,42,137576,752,7740,18,1636942,16116,132834,843,1504108,15273
2020-08-29,Puerto Rico,72,32550,562,428,4,320958,260,14986,260,305972,0
2020-08-29,Rhode Island,44,21683,0,1046,0,270211,3420,21857,174,248354,3246
2020-08-29,South Carolina,45,117249,1298,2698,43,935623,9114,117249,1298,818374,7816
2020-08-29,South Dakota,46,12942,425,167,2,144506,1566,12942,425,131564,1141
2020-08-29,Tennessee,47,149310,1496,1700,25,2177005,21501,152280,1465,2024725,20036
2020-08-29,Texas,48,633834,5342,12733,118,4900972,58610,606530,4762,4294442,53848
2020-08-29,Utah,49,51486,415,408,0,652419,4836,51406,458,601013,4378
2020-08-29,Vermont,50,1605,16,58,0,130180,3425,1605,16,128575,3409
2020-08-29,Virgin Islands,78,1129,54,14,0,15832,453,1118,43,14714,410
2020-08-29,Virginia,51,118809,1217,2568,18,1560673,16237,118809,1217,1441864,15020
2020-08-29,Washington,53,76834,437,1992,0,1423771,15607,73301,598,1350470,15009
2020-08-29,West Virginia,54,9967,143,212,10,426257,6676,9967,143,416290,6533
2020-08-29,Wisconsin,55,79767,783,1129,6,1244470,8795,79730,862,1164740,7933
2020-08-29,Wyoming,56,3784,21,37,0,75257,21,3784,21,71473,0
2020-08-30,Alabama,01,125235,1346,2162,10,981062,5244,125235,1346,855827,3898
2020-08-30,Alaska,02,6036,51,34,0,346839,1144,5250,43,341589,1101
2020-08-30,Arizona,04,201695,378,5033,23,1199441,7065,201661,374,997780,6691
2020-08-30,Arkansas,05,60856,478,784,12,712687,5717,60856,478,651831,5239
2020-08-30,California,06,706589,4090,12939,33,11231829,122199,699909,6070,10531920,116129
2020-08-30,Colorado,08,57515,189,1945,-1,709896,4687,57223,182,652673,4505
2020-08-30,Connecticut,09,52495,0,4465,0,1127506,0,52495,0,1075011,0
2020-08-30,Delaware,10,17343,-6,604,0,234661,1777,17343,-6,217318,1783
2020-08-30,District of Columbia,11,13959,34,606,1,288089,2333,13959,34,274130,2299
2020-08-30,Florida,12,621578,2583,11118,14,4592775,24361,614753,2547,3978022,21814
2020-08-30,Georgia,13,252813,1137,5478,27,2327490,15311,268973,1215,2058517,14096
2020-08-30,Guam,66,2256,0,11,0,37460,0,1347,0,36113,0
2020-08-30,Hawaii,15,8315,200,62,1,193935,3025,8139,309,185796,2716
2020-08-30,Idaho,16,32034,160,360,1,254325,3275,31677,293,222648,2982
2020-08-30,Illinois,17,235779,1973,8248,12,4018484,43693,235057,1992,3783427,41701
2020-08-30,Indiana,18,95394,882,3291,6,1065356,9563,93313,879,972043,8684
2020-08-30,Iowa,19,64599,763,1113,3,617095,4516,62720,971,554375,3545
2020-08-30,Kansas,20,42011,102,450,1,403147,0,41048,0,362099,0
2020-08-30,Kentucky,21,50170,256,955,4,816114,455,48032,455,768082,0
2020-08-30,Louisiana,22,148568,1624,4931,27,1869451,40272,148568,1624,1720883,38648
2020-08-30,Maine,23,4512,23,132,0,259661,4303,4512,23,255149,4280
2020-08-30,Maryland,24,108286,496,3752,6,1319238,14755,107791,497,1211447,14258
2020-08-30,Massachusetts,25,128229,199,9049,13,1723774,16619,128229,199,1595545,16420
2020-08-30,Michigan,26,112598,494,6750,3,2744794,60920,112526,1390,2632268,59530
2020-08-30,Minnesota,27,75238,932,1865,2,1122071,10934,75189,932,1046882,10002
2020-08-30,Mississippi,28,82676,647,2441,14,569164,647,82676,647,486488,0
2020-08-30,Missouri,29,85133,1160,1615,2,974237,8911,83655,1465,890582,7446
2020-08-30,Montana,30,7340,84,104,0,246661,1280,7340,89,239321,1191
2020-08-30,Nebraska,31,34046,293,400,0,357945,2727,33753,317,324192,2410
2020-08-30,Nevada,32,68981,405,1305,2,595685,3164,68908,447,526777,2717
2020-08-30,New Hampshire,33,7254,8,432,0,209295,1955,7254,8,202041,1947
2020-08-30,New Jersey,34,193391,291,15937,4,2836334,28587,191611,291,2644723,28296
2020-08-30,New Mexico,35,25283,105,770,1,756933,4411,25283,105,731650,4306
2020-08-30,New York,36,438831,709,32534,12,8196792,100022,434100,698,7762692,99324
2020-08-30,North Carolina,37,166510,977,2721,13,2243273,25124,166127,1051,2077146,24073
2020-08-30,North Dakota,38,11706,218,146,1,199959,221,11696,221,188263,0
2020-08-30,Northern Mariana Islands,69,56,0,2,0,13540,-2,56,0,13484,-2
2020-08-30,Ohio,39,122262,922,4128,2,2196860,25734,122262,922,2074598,24812
2020-08-30,Oklahoma,40,58020,667,799,2,864565,667,58020,667,806545,0
2020-08-30,Oregon,41,26554,261,463,3,553345,4495,26554,261,526791,4234
2020-08-30,Pennsylvania,42,138137,561,7742,2,1649403,12461,133504,670,1515899,11791
2020-08-30,Puerto Rico,72,32848,298,434,6,321201,243,15229,243,305972,0
2020-08-30,Rhode Island,44,21683,0,1046,0,272016,1805,21903,46,250113,1759
2020-08-30,South Carolina,45,118324,1075,2709,11,942873,7250,118324,1075,824549,6175
2020-08-30,South Dakota,46,13322,380,167,0,145651,1145,13322,380,132329,765
2020-08-30,Tennessee,47,150249,939,1722,22,2189010,12005,153115,835,2035895,11170
2020-08-30,Texas,48,636547,2713,12807,74,4924712,23740,610354,3824,4314358,19916
2020-08-30,Utah,49,51854,368,408,0,656596,4177,51854,448,604742,3729
2020-08-30,Vermont,50,1616,11,58,0,133275,3095,1616,11,131659,3084
2020-08-30,Virgin Islands,78,1134,5,14,0,16106,274,1129,11,14977,263
2020-08-30,Virginia,51,119747,938,2569,1,1573427,12754,119747,938,1453680,11816
2020-08-30,Washington,53,77122,288,1992,0,1461354,37583,74320,1019,1387034,36564
2020-08-30,West Virginia,54,10110,143,213,1,431122,4865,10110,143,421012,4722
2020-08-30,Wisconsin,55,80311,544,1132,3,1249602,5132,80300,570,1169302,4562
2020-08-30,Wyoming,56,3820,36,37,0,75293,36,3820,36,71473,0
2020-08-31,Alabama,01,126058,823,2182,20,985287,4225,126058,823,859229,3402
2020-08-31,Alaska,02,6075,39,34,0,348630,1791,5286,36,343344,1755
2020-08-31,Arizona,04,201866,171,5031,-2,1204429,4988,201835,174,1002594,4814
2020-08-31,Arkansas,05,61224,368,797,13,727035,14348,61224,368,665811,13980
2020-08-31,California,06,712541,5952,13020,81,11373305,141476,704085,4176,10669220,137300
2020-08-31,Colorado,08,57797,282,1952,7,714768,4872,57424,201,657344,4671
2020-08-31,Connecticut,09,52879,384,4465,0,1173096,45590,52879,384,1120217,45206
2020-08-31,Delaware,10,17429,86,605,1,236849,2188,17429,86,219420,2102
2020-08-31,District of Columbia,11,13992,33,607,1,290682,2593,13992,33,276690,2560
2020-08-31,Florida,12,623463,1885,11186,68,4608697,15922,616629,1876,3992068,14046
2020-08-31,Georgia,13,254238,1425,5506,28,2343634,16144,270471,1498,2073163,14646
2020-08-31,Guam,66,2364,108,11,0,37884,424,1395,48,36489,376
2020-08-31,Hawaii,15,8447,132,69,7,196719,2784,8339,200,188380,2584
2020-08-31,Idaho,16,32256,222,364,4,256013,1688,31867,190,224146,1498
2020-08-31,Illinois,17,237682,1903,8258,10,4065863,47379,236725,1668,3829138,45711
2020-08-31,Indiana,18,96277,883,3296,5,1076947,11591,94196,883,982751,10708
2020-08-31,Iowa,19,65252,653,1120,7,620872,3777,63328,608,557544,3169
2020-08-31,Kansas,20,43407,1396,451,1,413249,10102,42612,1564,370637,8538
2020-08-31,Kentucky,21,50884,714,965,10,821320,5206,48396,364,772924,4842
2020-08-31,Louisiana,22,148894,326,4950,19,1873490,4039,148894,326,1724596,3713
2020-08-31,Maine,23,4526,14,132,0,262935,3274,4526,14,258409,3260
2020-08-31,Maryland,24,108742,456,3755,3,1330853,11615,108249,458,1222604,11157
2020-08-31,Massachusetts,25,128533,304,9060,11,1742517,18743,128533,304,1613984,18439
2020-08-31,Michigan,26,113163,565,6756,6,2764431,19637,113025,499,2651406,19138
2020-08-31,Minnesota,27,75913,675,1866,1,1128023,5952,75864,675,1052159,5277
2020-08-31,Mississippi,28,82950,274,2473,32,573865,4701,82950,274,490915,4427
2020-08-31,Missouri,29,86328,1195,1623,8,982955,8718,84697,1042,898258,7676
2020-08-31,Montana,30,7440,100,104,0,250238,3577,7421,81,242817,3496
2020-08-31,Nebraska,31,34287,241,402,2,361351,3406,34046,293,327305,3113
2020-08-31,Nevada,32,69318,337,1305,0,597921,2236,69228,320,528693,1916
2020-08-31,New Hampshire,33,7275,21,432,0,210916,1621,7275,21,203641,1600
2020-08-31,New Jersey,34,193740,349,15945,8,2857918,21584,191960,349,2665958,21235
2020-08-31,New Mexico,35,25352,69,779,9,760874,3941,25352,69,735522,3872
2020-08-31,New York,36,439480,649,32541,7,8263033,66241,434756,656,7828277,65585
2020-08-31,North Carolina,37,167989,1479,2733,12,2256172,12899,167313,1186,2088859,11713
2020-08-31,North Dakota,38,11820,114,147,1,201755,1796,11810,114,189945,1682
2020-08-31,Northern Mariana Islands,69,56,0,2,0,13540,0,56,0,13484,0
2020-08-31,Ohio,39,123157,895,4138,10,2244104,47244,123157,895,2120947,46349
2020-08-31,Oklahoma,40,58733,713,800,1,865278,713,58733,713,806545,0
2020-08-31,Oregon,41,26723,169,467,4,557228,3883,26713,159,530515,3724
2020-08-31,Pennsylvania,42,138840,703,7743,1,1658220,8817,134025,521,1524195,8296
2020-08-31,Puerto Rico,72,33199,351,434,0,321448,247,15476,247,305972,0
2020-08-31,Rhode Island,44,21949,266,1048,2,273897,1881,21949,46,251948,1835
2020-08-31,South Carolina,45,118992,668,2720,11,949548,6675,118992,668,830556,6007
2020-08-31,South Dakota,46,13509,187,167,0,146529,878,13509,187,133020,691
2020-08-31,Tennessee,47,152033,1784,1727,5,2200999,11989,154933,1818,2046066,10171
2020-08-31,Texas,48,640317,3770,12857,50,4961553,36841,612969,2615,4348584,34226
2020-08-31,Utah,49,52166,312,409,1,659297,2701,52107,253,607190,2448
2020-08-31,Vermont,50,1624,8,58,0,135721,2446,1624,8,134097,2438
2020-08-31,Virgin Islands,78,1139,5,15,1,16234,128,1134,5,15100,123
2020-08-31,Virginia,51,120594,847,2580,11,1586551,13124,120594,847,1465957,12277
2020-08-31,Washington,53,77718,596,2002,10,1461354,0,74320,0,1387034,0
2020-08-31,West Virginia,54,10250,140,214,1,436047,4925,10250,140,425797,4785
2020-08-31,Wisconsin,55,80733,422,1132,0,1253422,3820,80568,268,1172854,3552
2020-08-31,Wyoming,56,3842,22,37,0,76273,980,3842,22,72431,958
2020-09-01,Alabama,01,127616,1558,2200,18,958920,-26367,127616,1558,831304,-27925
2020-09-01,Alaska,02,6109,34,36,2,374255,25625,5321,35,368934,25590
2020-09-01,Arizona,04,202375,509,5048,17,1208990,4561,202342,507,1006648,4054
2020-09-01,Arkansas,05,61497,273,814,17,731025,3990,61497,273,669528,3717
2020-09-01,California,06,716628,4087,13149,129,11470696,97391,707797,3712,10762899,93679
2020-09-01,Colorado,08,58118,321,1953,1,718398,3630,57775,351,660623,3279
2020-09-01,Connecticut,09,53006,127,4466,1,1192338,19242,53006,127,1139332,19115
2020-09-01,Delaware,10,17535,106,605,0,238423,1574,17535,106,220888,1468
2020-09-01,District of Columbia,11,14049,57,607,0,292844,2162,14049,57,278795,2105
2020-09-01,Florida,12,631032,7569,11373,187,4668942,60245,624116,7487,4044826,52758
2020-09-01,Georgia,13,256544,2306,5604,98,2368498,24864,272697,2226,2095801,22638
2020-09-01,Guam,66,2416,52,14,3,38322,438,1447,52,36875,386
2020-09-01,Hawaii,15,8628,181,73,4,198182,1463,8472,133,189710,1330
2020-09-01,Idaho,16,32703,447,370,6,257689,1676,32088,221,225601,1455
2020-09-01,Illinois,17,239115,1433,8299,41,4088824,22961,238217,1492,3850607,21469
2020-09-01,Indiana,18,96988,711,3312,16,1083765,6818,94891,695,988874,6123
2020-09-01,Iowa,19,65846,594,1125,5,623547,2675,63919,591,559628,2084
2020-09-01,Kansas,20,43491,84,454,3,413249,0,42612,0,370637,0
2020-09-01,Kentucky,21,51762,878,983,18,830421,9101,49185,789,781236,8312
2020-09-01,Louisiana,22,149583,689,4984,34,1890526,17036,149583,689,1740943,16347
2020-09-01,Maine,23,4548,22,132,0,268735,5800,4548,22,264187,5778
2020-09-01,Maryland,24,109353,611,3761,6,1338917,8064,108863,614,1230054,7450
2020-09-01,Massachusetts,25,128888,355,9064,4,1764172,21655,128888,355,1635284,21300
2020-09-01,Michigan,26,113969,806,6770,14,2789407,24976,113820,795,2675587,24181
2020-09-01,Minnesota,27,76404,491,1872,6,1132922,4899,76355,491,1056567,4408
2020-09-01,Mississippi,28,83584,634,2493,20,577517,3652,83584,634,493933,3018
2020-09-01,Missouri,29,87414,1086,1651,28,991244,8289,85755,1058,905489,7231
2020-09-01,Montana,30,7526,86,105,1,252296,2058,7509,88,244787,1970
2020-09-01,Nebraska,31,34574,287,405,3,363075,1724,34287,241,328788,1483
2020-09-01,Nevada,32,69708,390,1313,8,600349,2428,69633,405,530716,2023
2020-09-01,New Hampshire,33,7297,22,432,0,211281,365,7297,22,203984,343
2020-09-01,New Jersey,34,194070,330,15950,5,2859048,1130,192290,330,2666758,800
2020-09-01,New Mexico,35,25460,108,787,8,765399,4525,25460,108,739939,4417
2020-09-01,New York,36,440237,757,32551,10,8340030,76997,435510,754,7904520,76243
2020-09-01,North Carolina,37,169966,1977,2769,36,2295698,39526,169424,2111,2126274,37415
2020-09-01,North Dakota,38,12004,184,149,2,202422,667,12004,194,190418,473
2020-09-01,Northern Mariana Islands,69,57,1,2,0,13541,1,57,1,13484,0
2020-09-01,Ohio,39,124610,1453,4165,27,2269669,25565,124610,1453,2145059,24112
2020-09-01,Oklahoma,40,59399,666,809,9,886912,21634,59399,666,827513,20968
2020-09-01,Oregon,41,26958,235,467,0,561800,4572,26946,233,534854,4339
2020-09-01,Pennsylvania,42,139591,751,7764,21,1674764,16544,134795,770,1539969,15774
2020-09-01,Puerto Rico,72,33421,222,435,1,321556,108,15584,108,305972,0
2020-09-01,Rhode Island,44,22002,53,1050,2,276482,2585,22002,53,254480,2532
2020-09-01,South Carolina,45,119846,854,2757,37,954402,4854,119846,854,834556,4000
2020-09-01,South Dakota,46,13749,240,167,0,147595,1066,13749,240,133846,826
2020-09-01,Tennessee,47,153274,1241,1753,26,2217751,16752,156329,1396,2061422,15356
2020-09-01,Texas,48,645534,5217,13004,147,5033554,72001,617333,4364,4416221,67637
2020-09-01,Utah,49,52505,339,410,1,663050,3753,52403,296,610647,3457
2020-09-01,Vermont,50,1635,11,58,0,138446,2725,1635,11,136811,2714
2020-09-01,Virgin Islands,78,1143,4,15,0,16387,153,1139,5,15248,148
2020-09-01,Virginia,51,121615,1021,2612,32,1598689,12138,121615,1021,1477074,11117
2020-09-01,Washington,53,78061,343,2018,16,1473245,11891,74635,315,1398610,11576
2020-09-01,West Virginia,54,10507,257,222,8,438441,2394,10507,257,427934,2137
2020-09-01,Wisconsin,55,81688,955,1141,9,1265321,11899,81604,1036,1183717,10863
2020-09-01,Wyoming,56,3866,24,41,4,76567,294,3866,24,72701,270
2020-09-02,Alabama,01,128239,623,2217,17,964233,5313,128239,623,835994,4690
2020-09-02,Alaska,02,6181,72,36,0,376884,2629,5387,66,371497,2563
2020-09-02,Arizona,04,202898,523,5070,22,1213927,4937,202861,519,1011066,4418
2020-09-02,Arkansas,05,62112,615,841,27,737449,6424,62112,615,675337,5809
2020-09-02,California,06,722035,5407,13330,181,11580370,109674,712052,4255,10868318,105419
2020-09-02,Colorado,08,58392,274,1960,7,723058,4660,58019,244,665039,4416
2020-09-02,Connecticut,09,53108,102,4467,1,1203979,11641,53108,102,1150871,11539
2020-09-02,Delaware,10,17549,14,606,1,240530,2107,17549,14,222981,2093
2020-09-02,District of Columbia,11,14077,28,608,1,294797,1953,14077,28,280720,1925
2020-09-02,Florida,12,633434,2402,11500,127,4686786,17844,626426,2310,4060360,15534
2020-09-02,Georgia,13,258482,1938,5665,61,2381637,13139,274613,1916,2107024,11223
2020-09-02,Guam,66,2463,47,14,0,38771,449,1494,47,37277,402
2020-09-02,Hawaii,15,8966,338,74,1,202186,4004,8653,181,193533,3823
2020-09-02,Idaho,16,33059,356,374,4,259096,1407,32368,280,226728,1127
2020-09-02,Illinois,17,241282,2167,8322,23,4121575,32751,240345,2128,3881230,30623
2020-09-02,Indiana,18,97853,865,3325,13,1092596,8831,95750,859,996846,7972
2020-09-02,Iowa,19,66463,617,1134,9,629654,6107,64645,726,565009,5381
2020-09-02,Kansas,20,44529,1038,458,4,419247,5998,43940,1328,375307,4670
2020-09-02,Kentucky,21,52704,942,1008,25,837211,6790,49991,806,787220,5984
2020-09-02,Louisiana,22,150734,1151,5004,20,1904779,14253,150734,1151,1754045,13102
2020-09-02,Maine,23,4567,19,133,1,273032,4297,4567,19,268465,4278
2020-09-02,Maryland,24,109808,455,3766,5,1345646,6729,109319,456,1236327,6273
2020-09-02,Massachusetts,25,121131,-7757,9060,-4,1771706,7534,121131,-7757,1650575,15291
2020-09-02,Michigan,26,114603,634,6783,13,2816816,27409,114468,648,2702348,26761
2020-09-02,Minnesota,27,77137,733,1882,10,1150854,17932,77085,730,1073769,17202
2020-09-02,Mississippi,28,84365,781,2526,33,581586,4069,84365,781,497221,3288
2020-09-02,Missouri,29,88974,1560,1669,18,998097,6853,87213,1458,910884,5395
2020-09-02,Montana,30,7715,189,109,4,253873,1577,7691,182,246182,1395
2020-09-02,Nebraska,31,34995,421,408,3,365641,2566,34574,287,331067,2279
2020-09-02,Nevada,32,69927,219,1338,25,602308,1959,69872,239,532436,1720
2020-09-02,New Hampshire,33,7309,12,432,0,211281,0,7297,0,203984,0
2020-09-02,New Jersey,34,194378,308,15964,14,2902267,43219,192595,305,2709672,42914
2020-09-02,New Mexico,35,25612,152,790,3,770959,5560,25612,152,745347,5408
2020-09-02,New York,36,440947,710,32559,8,8428477,88447,436218,708,7992259,87739
2020-09-02,North Carolina,37,171140,1174,2806,37,2315310,19612,170553,1129,2144757,18483
2020-09-02,North Dakota,38,12271,267,152,3,204100,1678,12270,266,191830,1412
2020-09-02,Northern Mariana Islands,69,57,0,2,0,13541,0,57,0,13484,0
2020-09-02,Ohio,39,125767,1157,4176,11,2292748,23079,125767,1157,2166981,21922
2020-09-02,Oklahoma,40,60118,719,821,12,893242,6330,60118,719,833124,5611
2020-09-02,Oregon,41,27085,127,473,6,566382,4582,27075,129,539307,4453
2020-09-02,Pennsylvania,42,140577,986,7792,28,1687696,12932,135611,816,1552085,12116
2020-09-02,Puerto Rico,72,34003,582,443,8,321914,358,15942,358,305972,0
2020-09-02,Rhode Island,44,22078,76,1051,1,278641,2159,22078,76,256563,2083
2020-09-02,South Carolina,45,120503,657,2794,37,959032,4630,120503,657,838529,3973
2020-09-02,South Dakota,46,14003,254,169,2,148925,1330,14003,254,134922,1076
2020-09-02,Tennessee,47,154833,1559,1768,15,2238231,20480,157831,1502,2080400,18978
2020-09-02,Texas,48,649844,4310,13185,181,5068862,35308,621667,4334,4447195,30974
2020-09-02,Utah,49,52950,445,414,4,667493,4443,52822,419,614671,4024
2020-09-02,Vermont,50,1637,2,58,0,139096,650,1637,2,137459,648
2020-09-02,Virgin Islands,78,1144,1,15,0,16486,99,1143,4,15343,95
2020-09-02,Virginia,51,122542,927,2641,29,1610691,12002,122542,927,1488149,11075
2020-09-02,Washington,53,78554,493,2025,7,1480039,6794,74939,304,1405100,6490
2020-09-02,West Virginia,54,10642,135,230,8,441585,3144,10642,135,430943,3009
2020-09-02,Wisconsin,55,82261,573,1151,10,1273730,8409,82182,578,1191548,7831
2020-09-02,Wyoming,56,3911,45,41,0,76810,243,3911,45,72899,198
2020-09-03,Alabama,01,129285,1046,2233,16,965974,1741,129285,1046,836689,695
2020-09-03,Alaska,02,6287,106,37,1,377936,1052,5475,88,372461,964
2020-09-03,Arizona,04,203964,1066,5133,63,1222859,8932,203953,1092,1018906,7840
2020-09-03,Arkansas,05,63504,1392,861,20,738841,1392,63504,1392,675337,0
2020-09-03,California,06,727398,5363,13497,167,11663924,83554,717177,5125,10946747,78429
2020-09-03,Colorado,08,58680,288,1963,3,729015,5957,58287,268,670728,5689
2020-09-03,Connecticut,09,53209,101,4468,1,1218216,14237,53209,101,1165007,14136
2020-09-03,Delaware,10,17653,104,606,0,244548,4018,17653,104,226895,3914
2020-09-03,District of Columbia,11,14135,58,609,1,298759,3962,14135,58,284624,3904
2020-09-03,Florida,12,637005,3571,11649,149,4710596,23810,629913,3487,4080683,20323
2020-09-03,Georgia,13,261056,2574,5735,70,2410665,29028,277288,2675,2133377,26353
2020-09-03,Guam,66,2529,66,14,0,39490,719,1560,66,37930,653
2020-09-03,Hawaii,15,9177,211,78,4,207431,5245,8991,338,198440,4907
2020-09-03,Idaho,16,33361,302,375,1,261400,2304,32664,296,228736,2008
2020-09-03,Illinois,17,242715,1433,8347,25,4162370,40795,241705,1360,3920665,39435
2020-09-03,Indiana,18,98971,1118,3332,7,1103038,10442,96854,1104,1006184,9338
2020-09-03,Iowa,19,67693,1230,1137,3,634758,5104,65523,878,569235,4226
2020-09-03,Kansas,20,44755,226,475,17,419247,0,43940,0,375307,0
2020-09-03,Kentucky,21,54067,1363,1021,13,844424,7213,50885,894,793539,6319
2020-09-03,Louisiana,22,151547,813,5021,17,1917099,12320,151547,813,1765552,11507
2020-09-03,Maine,23,4617,50,133,0,281053,8021,4617,50,276436,7971
2020-09-03,Maryland,24,110504,696,3778,12,1357605,11959,110012,693,1247593,11266
2020-09-03,Massachusetts,25,121546,415,9077,17,1803312,31606,121546,415,1681766,31191
2020-09-03,Michigan,26,115393,790,6794,11,2849451,32635,115242,774,2734209,31861
2020-09-03,Minnesota,27,78175,1038,1889,7,1158388,7534,78123,1038,1080265,6496
2020-09-03,Mississippi,28,85116,751,2536,10,586581,4995,85116,751,501465,4244
2020-09-03,Missouri,29,90392,1418,1680,11,1008078,9981,88610,1397,919468,8584
2020-09-03,Montana,30,7903,188,111,2,255660,1787,7871,180,247789,1607
2020-09-03,Nebraska,31,35469,474,410,2,368965,3324,34995,421,333970,2903
2020-09-03,Nevada,32,70319,392,1366,28,605268,2960,70223,351,535045,2609
2020-09-03,New Hampshire,33,7347,38,432,0,215875,4594,7347,50,208528,4544
2020-09-03,New Jersey,34,194756,378,15971,7,2930015,27748,192973,378,2737042,27370
2020-09-03,New Mexico,35,25812,200,791,1,776796,5837,25812,200,750984,5637
2020-09-03,New York,36,441835,888,32567,8,8517458,88981,437107,889,8080351,88092
2020-09-03,North Carolina,37,172791,1651,2829,23,2347837,32527,172209,1656,2175628,30871
2020-09-03,North Dakota,38,12633,362,154,2,205899,1799,12629,359,193270,1440
2020-09-03,Northern Mariana Islands,69,57,0,2,0,13541,0,57,0,13484,0
2020-09-03,Ohio,39,127112,1345,4226,50,2319528,26780,127112,1345,2192416,25435
2020-09-03,Oklahoma,40,61027,909,835,14,903046,9804,61027,909,842019,8895
2020-09-03,Oregon,41,27356,271,475,2,571125,4743,27336,261,543789,4482
2020-09-03,Pennsylvania,42,141578,1001,7805,13,1702214,14518,136771,1160,1565443,13358
2020-09-03,Puerto Rico,72,34198,195,448,5,322041,127,16069,127,305972,0
2020-09-03,Rhode Island,44,22143,65,1055,4,281633,2992,22143,65,259490,2927
2020-09-03,South Carolina,45,121696,1193,2807,13,969425,10393,121696,1193,847729,9200
2020-09-03,South Dakota,46,14337,334,169,0,150537,1612,14337,334,136200,1278
2020-09-03,Tennessee,47,157028,2195,1791,23,2265003,26772,159546,1715,2105457,25057
2020-09-03,Texas,48,653321,3477,13387,202,5107503,38641,625347,3680,4482156,34961
2020-09-03,Utah,49,53412,462,416,2,672051,4558,53326,504,618725,4054
2020-09-03,Vermont,50,1637,0,58,0,140881,1785,1637,0,139244,1785
2020-09-03,Virgin Islands,78,1150,6,16,1,16793,307,1144,1,15649,306
2020-09-03,Virginia,51,123668,1126,2652,11,1624531,13840,123668,1126,1500863,12714
2020-09-03,Washington,53,79120,566,2033,8,1496353,16314,75377,438,1420976,15876
2020-09-03,West Virginia,54,10845,203,237,7,445094,3509,10845,203,434249,3306
2020-09-03,Wisconsin,55,83119,858,1155,4,1282921,9191,82922,740,1199999,8451
2020-09-03,Wyoming,56,3939,28,41,0,77501,691,3939,28,73562,663
2020-09-04,Alabama,01,130393,1108,2266,33,970413,4439,130393,1108,840020,3331
2020-09-04,Alaska,02,6416,129,37,0,381937,4001,5594,119,376343,3882
2020-09-04,Arizona,04,204686,722,5174,41,1236928,14069,204681,728,1032247,13341
2020-09-04,Arkansas,05,64678,1174,873,12,748914,10073,64678,1174,684236,8899
2020-09-04,California,06,732691,5293,13644,147,11796970,133046,722283,5106,11074687,127940
2020-09-04,Colorado,08,59021,341,1973,10,735968,6953,58655,368,677313,6585
2020-09-04,Connecticut,09,53365,156,4468,0,1237658,19442,53365,156,1184293,19286
2020-09-04,Delaware,10,17752,99,606,0,246642,2094,17752,99,228890,1995
2020-09-04,District of Columbia,11,14186,51,611,2,303351,4592,14186,51,289165,4541
2020-09-04,Florida,12,640203,3198,11749,100,4732856,22260,633060,3147,4099796,19113
2020-09-04,Georgia,13,263047,1991,5797,62,2432125,21460,279354,2066,2152771,19394
2020-09-04,Guam,66,2588,59,15,1,40112,622,1619,59,38493,563
2020-09-04,Hawaii,15,9448,271,80,2,213722,6291,9202,211,204520,6080
2020-09-04,Idaho,16,33628,267,386,11,263727,2327,32927,263,230800,2064
2020-09-04,Illinois,17,248253,5538,8386,39,4311869,149499,247299,5594,4064570,143905
2020-09-04,Indiana,18,100011,1040,3350,18,1117427,14389,97884,1030,1019543,13359
2020-09-04,Iowa,19,68757,1064,1158,21,642335,7577,66614,1091,575721,6486
2020-09-04,Kansas,20,46049,1294,481,6,427205,7958,45220,1280,381985,6678
2020-09-04,Kentucky,21,55500,1433,1028,7,852440,8016,51677,792,800763,7224
2020-09-04,Louisiana,22,152369,822,5035,14,1932644,15545,152369,822,1780275,14723
2020-09-04,Maine,23,4632,15,134,1,286603,5550,4632,15,281971,5535
2020-09-04,Maryland,24,111332,828,3789,11,1371465,13860,110831,819,1260634,13041
2020-09-04,Massachusetts,25,121758,212,9100,23,1820864,17552,121758,212,1699106,17340
2020-09-04,Michigan,26,116470,1077,6802,8,2877981,28530,116295,1053,2761686,27477
2020-09-04,Minnesota,27,79018,843,1899,10,1168307,9919,78966,843,1089341,9076
2020-09-04,Mississippi,28,85939,823,2558,22,587404,823,85939,823,501465,0
2020-09-04,Missouri,29,91994,1602,1698,18,1021730,13652,90215,1605,931515,12047
2020-09-04,Montana,30,8046,143,114,3,259988,4328,8019,148,251969,4180
2020-09-04,Nebraska,31,35661,192,411,1,373592,4627,35469,474,338123,4153
2020-09-04,Nevada,32,70783,464,1376,10,608815,3547,70712,489,538103,3058
2020-09-04,New Hampshire,33,7368,21,432,0,217263,1388,7368,21,209895,1367
2020-09-04,New Jersey,34,195205,449,15978,7,2964722,34707,193422,449,2771300,34258
2020-09-04,New Mexico,35,25902,90,794,3,782044,5248,25902,90,756142,5158
2020-09-04,New York,36,442698,863,32573,6,8610853,93395,437971,864,8172882,92531
2020-09-04,North Carolina,37,174848,2057,2868,39,2389096,41259,174254,2045,2214842,39214
2020-09-04,North Dakota,38,12977,344,154,0,207754,1855,12971,342,194783,1513
2020-09-04,Northern Mariana Islands,69,57,0,2,0,13541,0,57,0,13484,0
2020-09-04,Ohio,39,128444,1332,4248,22,2349585,30057,128444,1332,2221141,28725
2020-09-04,Oklahoma,40,62040,1013,846,11,914395,11349,62040,1013,852355,10336
2020-09-04,Oregon,41,27605,249,481,6,576929,5804,27601,265,549328,5539
2020-09-04,Pennsylvania,42,142537,959,7821,16,1714541,12327,137662,891,1576879,11436
2020-09-04,Puerto Rico,72,34241,43,455,7,322073,32,16101,32,305972,0
2020-09-04,Rhode Island,44,22243,100,1055,0,284006,2373,22243,100,261763,2273
2020-09-04,South Carolina,45,123325,1629,2846,39,981984,12559,123325,1629,858659,10930
2020-09-04,South Dakota,46,14596,259,170,1,152293,1756,14596,259,137697,1497
2020-09-04,Tennessee,47,158120,1092,1813,22,2283234,18231,160597,1051,2122637,17180
2020-09-04,Texas,48,658789,5468,13516,129,5119753,12250,630829,5482,4488924,6768
2020-09-04,Utah,49,53940,528,420,4,676673,4622,53839,513,622834,4109
2020-09-04,Vermont,50,1642,5,58,0,142198,1317,1642,5,140556,1312
2020-09-04,Virgin Islands,78,1150,0,16,0,16940,147,1150,6,15790,141
2020-09-04,Virginia,51,124779,1111,2662,10,1639828,15297,124779,1111,1515049,14186
2020-09-04,Washington,53,79721,601,2042,9,1518089,21736,75856,479,1442233,21257
2020-09-04,West Virginia,54,11037,192,243,6,448911,3817,11037,192,437874,3625
2020-09-04,Wisconsin,55,84519,1400,1164,9,1294667,11746,84464,1542,1210203,10204
2020-09-04,Wyoming,56,3989,50,42,1,78301,800,3989,50,74312,750
2020-09-05,Alabama,01,131803,1410,2275,9,977973,7560,131803,1410,846170,6150
2020-09-05,Alaska,02,6514,98,39,2,385002,3065,5681,87,379321,2978
2020-09-05,Arizona,04,205518,832,5207,33,1252775,15847,205516,835,1047259,15012
2020-09-05,Arkansas,05,65226,548,882,9,765947,17033,65226,548,700721,16485
2020-09-05,California,06,737073,4382,13708,64,11916323,119353,727239,4956,11189084,114397
2020-09-05,Colorado,08,59362,341,1978,5,742572,6604,58989,334,683583,6270
2020-09-05,Connecticut,09,53365,0,4468,0,1237658,0,53365,0,1184293,0
2020-09-05,Delaware,10,17892,140,608,2,248632,1990,17892,140,230740,1850
2020-09-05,District of Columbia,11,14238,52,611,0,307864,4513,14238,52,293626,4461
2020-09-05,Florida,12,643859,3656,11810,61,4756593,23737,636653,3593,4119940,20144
2020-09-05,Georgia,13,265215,2168,5842,45,2460729,28604,281548,2194,2179181,26410
2020-09-05,Guam,66,2640,52,16,1,40741,629,1671,52,39070,577
2020-09-05,Hawaii,15,9667,219,83,3,221391,7669,9473,271,211918,7398
2020-09-05,Idaho,16,33884,256,386,0,265645,1918,33196,269,232449,1649
2020-09-05,Illinois,17,250882,2629,8405,19,4373804,61935,250105,2806,4123699,59129
2020-09-05,Indiana,18,101094,1083,3362,12,1129078,11651,98961,1077,1030117,10574
2020-09-05,Iowa,19,69690,933,1165,7,648511,6176,67642,1028,580869,5148
2020-09-05,Kansas,20,46051,2,482,1,427205,0,45220,0,381985,0
2020-09-05,Kentucky,21,56016,516,1033,5,871819,19379,52464,787,819355,18592
2020-09-05,Louisiana,22,152369,0,5035,0,1932644,0,152369,0,1780275,0
2020-09-05,Maine,23,4667,35,134,0,291975,5372,4667,35,287308,5337
2020-09-05,Maryland,24,112104,772,3796,7,1384455,12990,111607,776,1272848,12214
2020-09-05,Massachusetts,25,122196,438,9116,16,1841675,20811,122196,438,1719479,20373
2020-09-05,Michigan,26,117267,797,6809,7,2919002,41021,117191,896,2801811,40125
2020-09-05,Minnesota,27,79932,914,1903,4,1177800,9493,79880,914,1097920,8579
2020-09-05,Mississippi,28,86478,539,2569,11,597399,9995,86478,539,510921,9456
2020-09-05,Missouri,29,93713,1719,1728,30,1038301,16571,92202,1987,946099,14584
2020-09-05,Montana,30,8178,132,116,2,261050,1062,8164,145,252886,917
2020-09-05,Nebraska,31,35805,144,415,4,375524,1932,35661,192,339863,1740
2020-09-05,Nevada,32,71184,401,1390,14,613004,4189,71102,390,541902,3799
2020-09-05,New Hampshire,33,7424,56,432,0,218745,1482,7424,56,211321,1426
2020-09-05,New Jersey,34,195530,325,15985,7,2965047,325,193747,325,2771300,0
2020-09-05,New Mexico,35,26048,146,800,6,787811,5767,26048,146,761763,5621
2020-09-05,New York,36,443497,799,32579,6,8710614,99761,438772,801,8271842,98960
2020-09-05,North Carolina,37,176124,1276,2913,45,2410871,21775,175815,1561,2235056,20214
2020-09-05,North Dakota,38,13338,361,159,5,209492,1738,13327,356,196165,1382
2020-09-05,Northern Mariana Islands,69,58,1,2,0,13542,1,58,1,13484,0
2020-09-05,Ohio,39,129785,1341,4256,8,2377910,28325,129785,1341,2248125,26984
2020-09-05,Oklahoma,40,63187,1147,850,4,923273,8878,63187,1147,860086,7731
2020-09-05,Oregon,41,27857,252,482,1,580107,3178,27856,255,552251,2923
2020-09-05,Pennsylvania,42,143301,764,7837,16,1727706,13165,138625,963,1589081,12202
2020-09-05,Puerto Rico,72,34492,251,464,9,322215,142,16243,142,305972,0
2020-09-05,Rhode Island,44,22243,0,1055,0,287687,3681,22484,241,265203,3440
2020-09-05,South Carolina,45,124289,964,2877,31,993927,11943,124289,964,869638,10979
2020-09-05,South Dakota,46,14889,293,173,3,153907,1614,14889,293,139018,1321
2020-09-05,Tennessee,47,159893,1773,1838,25,2310324,27090,162362,1765,2147962,25325
2020-09-05,Texas,48,663246,4457,13660,144,5183948,64195,635315,4486,4548633,59709
2020-09-05,Utah,49,54364,424,421,1,681438,4765,54272,433,627166,4332
2020-09-05,Vermont,50,1647,5,58,0,143088,890,1647,5,141441,885
2020-09-05,Virgin Islands,78,1167,17,16,0,17211,271,1167,17,16044,254
2020-09-05,Virginia,51,125727,948,2677,15,1657556,17728,125727,948,1531829,16780
2020-09-05,Washington,53,79900,179,2042,0,1534090,16001,76335,479,1457755,15522
2020-09-05,West Virginia,54,11289,252,243,0,453481,4570,11289,252,442192,4318
2020-09-05,Wisconsin,55,85517,998,1177,13,1302741,8074,85463,999,1217278,7075
2020-09-05,Wyoming,56,4006,17,42,0,78318,17,4006,17,74312,0
2020-09-06,Alabama,01,132314,511,2276,1,984308,6335,132314,511,851994,5824
2020-09-06,Alaska,02,6603,89,39,0,387057,2055,5776,95,381281,1960
2020-09-06,Arizona,04,205772,254,5221,14,1259018,6243,205766,250,1053252,5993
2020-09-06,Arkansas,05,65924,698,894,12,765947,0,65226,0,700721,0
2020-09-06,California,06,740233,3160,13730,22,12047191,130868,732144,4905,11315047,125963
2020-09-06,Colorado,08,59626,264,1980,2,748461,5889,59274,285,689187,5604
2020-09-06,Connecticut,09,53365,0,4468,0,1237658,0,53365,0,1184293,0
2020-09-06,Delaware,10,18043,151,609,1,250783,2151,18043,151,232740,2000
2020-09-06,District of Columbia,11,14279,41,611,0,311510,3646,14279,41,297231,3605
2020-09-06,Florida,12,646423,2564,11848,38,4777505,20912,639166,2513,4138339,18399
2020-09-06,Georgia,13,266707,1492,5900,58,2479568,18839,283199,1651,2196369,17188
2020-09-06,Guam,66,2588,-52,17,1,40741,0,1671,0,39070,0
2020-09-06,Hawaii,15,9829,162,84,1,229796,8405,9693,220,220103,8185
2020-09-06,Idaho,16,34053,169,387,1,267172,1527,33477,281,233695,1246
2020-09-06,Illinois,17,252306,1424,8409,4,4420300,46496,251508,1403,4168792,45093
2020-09-06,Indiana,18,101937,843,3364,2,1138868,9790,99804,843,1039064,8947
2020-09-06,Iowa,19,70210,520,1167,2,652937,4426,68291,649,584646,3777
2020-09-06,Kansas,20,46151,100,483,1,427205,0,45220,0,381985,0
2020-09-06,Kentucky,21,56172,156,1035,2,872129,310,52774,310,819355,0
2020-09-06,Louisiana,22,153764,1395,5093,58,1959244,26600,153764,1395,1805480,25205
2020-09-06,Maine,23,4682,15,134,0,296854,4879,4682,15,292172,4864
2020-09-06,Maryland,24,112557,453,3799,3,1393324,8869,112119,512,1281205,8357
2020-09-06,Massachusetts,25,122562,366,9125,9,1859402,17727,122562,366,1736840,17361
2020-09-06,Michigan,26,117310,43,6809,0,2919002,0,117191,0,2801811,0
2020-09-06,Minnesota,27,80639,707,1909,6,1188293,10493,80587,707,1107706,9786
2020-09-06,Mississippi,28,86888,410,2584,15,597809,410,86888,410,510921,0
2020-09-06,Missouri,29,94923,1210,1739,11,1045843,7542,93434,1232,952409,6310
2020-09-06,Montana,30,8272,94,117,1,262026,976,8264,100,253762,876
2020-09-06,Nebraska,31,35891,86,415,0,376828,1304,35805,144,341023,1160
2020-09-06,Nevada,32,71711,527,1394,4,619482,6478,71610,508,547872,5970
2020-09-06,New Hampshire,33,7447,23,433,1,220662,1917,7447,23,213215,1894
2020-09-06,New Jersey,34,195841,311,15989,4,3002307,37260,194058,311,2808249,36949
2020-09-06,New Mexico,35,26107,59,803,3,791836,4025,26107,59,765729,3966
2020-09-06,New York,36,444226,729,32585,6,8796244,85630,439501,729,8356743,84901
2020-09-06,North Carolina,37,177141,1017,2920,7,2442950,32079,176901,1086,2266049,30993
2020-09-06,North Dakota,38,13635,297,160,1,210994,1502,13626,299,197368,1203
2020-09-06,Northern Mariana Islands,69,58,0,2,0,13542,0,58,0,13484,0
2020-09-06,Ohio,39,130558,773,4259,3,2404235,26325,130558,773,2273677,25552
2020-09-06,Oklahoma,40,63607,420,853,3,923693,420,63607,420,860086,0
2020-09-06,Oregon,41,28045,188,483,1,585425,5318,28044,188,557381,5130
2020-09-06,Pennsylvania,42,143902,601,7837,0,1738615,10909,139316,691,1599299,10218
2020-09-06,Puerto Rico,72,34533,41,477,13,322241,26,16269,26,305972,0
2020-09-06,Rhode Island,44,22243,0,1055,0,289208,1521,22519,35,266689,1486
2020-09-06,South Carolina,45,124952,663,2887,10,1001225,7298,124952,663,876273,6635
2020-09-06,South Dakota,46,15109,220,173,0,155101,1194,15109,220,139992,974
2020-09-06,Tennessee,47,161589,1696,1841,3,2331199,20875,164126,1764,2167073,19111
2020-09-06,Texas,48,665338,2092,13739,79,5282579,98631,638310,2995,4644269,95636
2020-09-06,Utah,49,54660,296,423,2,685923,4485,54660,388,631263,4097
2020-09-06,Vermont,50,1648,1,58,0,144063,975,1648,1,142415,974
2020-09-06,Virgin Islands,78,1181,14,17,1,17325,114,1181,14,16144,100
2020-09-06,Virginia,51,126926,1199,2678,1,1670084,12528,126926,1199,1543158,11329
2020-09-06,Washington,53,80369,469,2043,1,1550477,16387,76836,501,1473641,15886
2020-09-06,West Virginia,54,11412,123,246,3,458378,4897,11412,123,446966,4774
2020-09-06,Wisconsin,55,86406,889,1177,0,1308247,5506,86353,890,1221894,4616
2020-09-06,Wyoming,56,4032,26,42,0,78344,26,4032,26,74312,0
2020-09-07,Alabama,01,132973,659,2276,0,987995,3687,132973,659,855022,3028
2020-09-07,Alaska,02,6637,34,39,0,388621,1564,5810,34,382811,1530
2020-09-07,Arizona,04,205971,199,5219,-2,1263397,4379,205964,198,1057433,4181
2020-09-07,Arkansas,05,66280,356,908,14,772813,6866,66280,1054,706533,5812
2020-09-07,California,06,742689,2456,13763,33,12158292,111101,735235,3091,11423057,108010
2020-09-07,Colorado,08,59823,197,1980,0,754319,5858,59487,213,694832,5645
2020-09-07,Connecticut,09,53365,0,4468,0,1237658,0,53365,0,1184293,0
2020-09-07,Delaware,10,18249,206,609,0,252602,1819,18249,206,234353,1613
2020-09-07,District of Columbia,11,14315,36,611,0,313715,2205,14315,36,299400,2169
2020-09-07,Florida,12,648261,1838,11870,22,4794393,16888,640978,1812,4153415,15076
2020-09-07,Georgia,13,267238,531,5907,7,2488841,9273,283807,608,2205034,8665
2020-09-07,Guam,66,2588,0,19,2,40741,0,1671,0,39070,0
2020-09-07,Hawaii,15,9933,104,85,1,234903,5107,9855,162,225048,4945
2020-09-07,Idaho,16,34153,100,387,0,268189,1017,33667,190,234522,827
2020-09-07,Illinois,17,253649,1343,8417,8,4449275,28975,252889,1381,4196386,27594
2020-09-07,Indiana,18,102527,590,3368,4,1146572,7704,100394,590,1046178,7114
2020-09-07,Iowa,19,70537,327,1170,3,655846,2909,68684,393,587162,2516
2020-09-07,Kansas,20,47409,1258,485,2,436686,9481,46914,1694,389772,7787
2020-09-07,Kentucky,21,56545,373,1036,1,869233,-2896,53064,290,816169,-3186
2020-09-07,Louisiana,22,154073,309,5105,12,1964229,4985,154073,309,1810156,4676
2020-09-07,Maine,23,4701,19,134,0,300032,3178,4701,19,295331,3159
2020-09-07,Maryland,24,113378,821,3804,5,1405189,11865,112883,764,1292306,11101
2020-09-07,Massachusetts,25,122791,229,9133,8,1869279,9877,122791,229,1746488,9648
2020-09-07,Michigan,26,118388,1078,6813,4,2962678,43676,118403,1212,2844275,42464
2020-09-07,Minnesota,27,81277,638,1912,3,1197675,9382,81225,638,1116450,8744
2020-09-07,Mississippi,28,87130,242,2585,1,598051,242,87130,242,510921,0
2020-09-07,Missouri,29,95795,872,1739,0,1054385,8542,94340,906,960045,7636
2020-09-07,Montana,30,8340,68,118,1,267125,5099,8316,52,258809,5047
2020-09-07,Nebraska,31,35975,84,415,0,377461,633,35886,81,341575,552
2020-09-07,Nevada,32,72048,337,1394,0,622642,3160,71967,357,550675,2803
2020-09-07,New Hampshire,33,7476,29,433,0,222299,1637,7476,29,214823,1608
2020-09-07,New Jersey,34,196173,332,15991,2,3054528,52221,194390,332,2860138,51889
2020-09-07,New Mexico,35,26144,37,807,4,795247,3411,26144,37,769103,3374
2020-09-07,New York,36,444751,525,32600,15,8855109,58865,440021,520,8415088,58345
2020-09-07,North Carolina,37,178212,1071,2920,0,2459582,16632,177919,1018,2281663,15614
2020-09-07,North Dakota,38,13805,170,160,0,211894,900,13797,171,198097,729
2020-09-07,Northern Mariana Islands,69,59,1,2,0,13542,0,58,0,13484,0
2020-09-07,Ohio,39,131336,778,4276,17,2426014,21779,131336,778,2294678,21001
2020-09-07,Oklahoma,40,64220,613,853,0,924306,613,64220,613,860086,0
2020-09-07,Oregon,41,28191,146,487,4,588166,2741,28190,146,559976,2595
2020-09-07,Pennsylvania,42,144658,756,7855,18,1748241,9626,139863,547,1608378,9079
2020-09-07,Puerto Rico,72,35375,842,477,0,322664,423,16692,423,305972,0
2020-09-07,Rhode Island,44,22243,0,1055,0,291029,1821,22572,53,268457,1768
2020-09-07,South Carolina,45,125607,655,2907,20,1009710,8485,125607,655,884103,7830
2020-09-07,South Dakota,46,15300,191,173,0,156093,992,15300,191,140793,801
2020-09-07,Tennessee,47,162531,942,1845,4,2344781,13582,165109,983,2179672,12599
2020-09-07,Texas,48,666209,871,13781,42,5320999,38420,640370,2060,4680629,36360
2020-09-07,Utah,49,55052,392,424,1,688805,2882,55033,373,633772,2509
2020-09-07,Vermont,50,1651,3,58,0,145993,1930,1651,3,144342,1927
2020-09-07,Virgin Islands,78,1190,9,17,0,17420,95,1190,9,16230,86
2020-09-07,Virginia,51,127571,645,2684,6,1682098,12014,127571,645,1554527,11369
2020-09-07,Washington,53,80485,116,2043,0,1563053,12576,77235,399,1485818,12177
2020-09-07,West Virginia,54,11575,163,247,1,461765,3387,11575,163,450190,3224
2020-09-07,Wisconsin,55,86981,575,1177,0,1313721,5474,86928,575,1226793,4899
2020-09-07,Wyoming,56,4032,0,42,0,78344,0,4032,0,74312,0
2020-09-08,Alabama,01,133606,633,2277,1,992395,4400,133606,633,858789,3767
2020-09-08,Alaska,02,6670,33,39,0,391656,3035,5843,33,385813,3002
2020-09-08,Arizona,04,206048,77,5221,2,1266599,3202,206045,81,1060554,3121
2020-09-08,Arkansas,05,66757,477,917,9,783730,10917,66757,477,716973,10440
2020-09-08,California,06,746113,3424,13843,80,12267948,109656,737911,2676,11530037,106980
2020-09-08,Colorado,08,60003,180,1980,0,757241,2922,59674,187,697567,2735
2020-09-08,Connecticut,09,53782,417,4474,6,1286887,49229,53782,417,1233105,48812
2020-09-08,Delaware,10,18308,59,609,0,253970,1368,18308,59,235662,1309
2020-09-08,District of Columbia,11,14362,47,611,0,316598,2883,14362,47,302236,2836
2020-09-08,Florida,12,650084,1823,11914,44,4809556,15163,642775,1797,4166781,13366
2020-09-08,Georgia,13,268684,1446,5931,24,2511826,22985,285350,1543,2226476,21442
2020-09-08,Guam,66,2682,94,20,1,41412,671,1713,42,39699,629
2020-09-08,Hawaii,15,10130,197,87,2,237012,2109,9959,104,227053,2005
2020-09-08,Idaho,16,34461,308,390,3,269238,1049,33741,74,235497,975
2020-09-08,Illinois,17,255229,1580,8431,14,4480638,31363,254281,1392,4226357,29971
2020-09-08,Indiana,18,102917,390,3380,12,1150863,4291,100780,386,1050083,3905
2020-09-08,Iowa,19,71018,481,1185,15,658977,3131,69139,455,589838,2676
2020-09-08,Kansas,20,47878,469,486,1,436686,0,46914,0,389772,0
2020-09-08,Kentucky,21,56877,332,1039,3,870650,1417,53319,255,817331,1162
2020-09-08,Louisiana,22,154329,256,5118,13,1968354,4125,154329,256,1814025,3869
2020-09-08,Maine,23,4713,12,134,0,302706,2674,4713,12,297993,2662
2020-09-08,Maryland,24,113734,356,3807,3,1410598,5409,113239,356,1297359,5053
2020-09-08,Massachusetts,25,122962,171,9141,8,1878721,9442,122962,171,1755759,9271
2020-09-08,Michigan,26,118984,596,6814,1,2980084,17406,118902,499,2861182,16907
2020-09-08,Minnesota,27,81660,383,1914,2,1201870,4195,81608,383,1120262,3812
2020-09-08,Mississippi,28,87379,249,2585,0,606461,8410,87379,249,519082,8161
2020-09-08,Missouri,29,97044,1249,1746,7,1061230,6845,95113,773,966117,6072
2020-09-08,Montana,30,8409,69,119,1,268780,1655,8381,65,260399,1590
2020-09-08,Nebraska,31,36477,502,418,3,378300,839,35975,89,342325,750
2020-09-08,Nevada,32,72165,117,1395,1,624052,1410,72104,137,551948,1273
2020-09-08,New Hampshire,33,7494,18,433,0,222963,664,7494,18,215469,646
2020-09-08,New Jersey,34,196450,277,15996,5,3070746,16218,194667,277,2876079,15941
2020-09-08,New Mexico,35,26181,37,807,0,799673,4426,26181,37,773492,4389
2020-09-08,New York,36,445308,557,32612,12,8912935,57826,440578,557,8472357,57269
2020-09-08,North Carolina,37,179150,938,2942,22,2469977,10395,178635,716,2291342,9679
2020-09-08,North Dakota,38,13876,71,160,0,212129,235,13872,75,198257,160
2020-09-08,Northern Mariana Islands,69,59,0,2,0,13543,1,59,1,13484,0
2020-09-08,Ohio,39,131992,656,4298,22,2449545,23531,131992,656,2317553,22875
2020-09-08,Oklahoma,40,65053,833,854,1,925139,833,65053,833,860086,0
2020-09-08,Oregon,41,28355,164,492,5,591499,3333,28355,165,563144,3168
2020-09-08,Pennsylvania,42,145191,533,7862,7,1755076,6835,140359,496,1614717,6339
2020-09-08,Puerto Rico,72,35504,129,482,5,322760,96,16788,96,305972,0
2020-09-08,Rhode Island,44,22592,349,1059,4,291439,410,22592,20,268847,390
2020-09-08,South Carolina,45,125908,301,2912,5,1014151,4441,125908,301,888243,4140
2020-09-08,South Dakota,46,15403,103,173,0,156686,593,15403,103,141283,490
2020-09-08,Tennessee,47,163180,649,1873,28,2350991,6210,165754,645,2185237,5565
2020-09-08,Texas,48,670427,4218,13855,74,5339126,18127,641791,1421,4697335,16706
2020-09-08,Utah,49,55424,372,426,2,691359,2554,55359,326,636000,2228
2020-09-08,Vermont,50,1654,3,58,0,146782,789,1654,3,145128,786
2020-09-08,Virgin Islands,78,1191,1,18,1,17444,24,1191,1,16253,23
2020-09-08,Virginia,51,128407,836,2686,2,1689744,7646,128407,836,1561337,6810
2020-09-08,Washington,53,81048,563,2045,2,1563053,0,77235,0,1485818,0
2020-09-08,West Virginia,54,11661,86,250,3,462760,995,11661,86,451099,909
2020-09-08,Wisconsin,55,87730,749,1179,2,1317836,4115,87677,749,1230159,3366
2020-09-08,Wyoming,56,4103,71,42,0,81469,3125,4103,71,77366,3054
2020-09-09,Alabama,01,134417,811,2285,8,998399,6004,134417,811,863982,5193
2020-09-09,Alaska,02,6735,65,39,0,391937,281,5908,65,386029,216
2020-09-09,Arizona,04,206548,500,5253,32,1269197,2598,206541,496,1062656,2102
2020-09-09,Arkansas,05,67255,498,928,11,784228,498,67255,498,716973,0
2020-09-09,California,06,749196,3083,13990,147,12343797,75849,739527,1616,11604270,74233
2020-09-09,Colorado,08,60291,288,1984,4,760352,3111,59920,246,700432,2865
2020-09-09,Connecticut,09,53871,89,4474,0,1292847,5960,53871,89,1238976,5871
2020-09-09,Delaware,10,18308,0,609,0,253970,0,18308,0,235662,0
2020-09-09,District of Columbia,11,14387,25,615,4,317660,1062,14387,25,303273,1037
2020-09-09,Florida,12,652140,2056,12114,200,4823881,14325,644781,2006,4179100,12319
2020-09-09,Georgia,13,270624,1940,5987,56,2527779,15953,287287,1937,2240492,14016
2020-09-09,Guam,66,2727,45,21,1,42095,683,1758,45,40337,638
2020-09-09,Hawaii,15,10228,98,90,3,237917,905,10156,197,227761,708
2020-09-09,Idaho,16,34707,246,406,16,270534,1296,33981,240,236553,1056
2020-09-09,Illinois,17,256614,1385,8457,26,4528667,48029,255618,1337,4273049,46692
2020-09-09,Indiana,18,103641,724,3397,17,1158018,7155,101485,705,1056533,6450
2020-09-09,Iowa,19,71594,576,1204,19,661575,2598,69503,364,592072,2234
2020-09-09,Kansas,20,48389,511,497,11,441414,4728,47410,496,394004,4232
2020-09-09,Kentucky,21,57518,641,1058,19,878290,7640,53977,658,824313,6982
2020-09-09,Louisiana,22,155890,1561,5140,22,1999962,31608,155890,1561,1844072,30047
2020-09-09,Maine,23,4734,21,134,0,309725,7019,4734,21,304991,6998
2020-09-09,Maryland,24,114070,336,3816,9,1415522,4924,113575,336,1301947,4588
2020-09-09,Massachusetts,25,123143,181,9146,5,1890070,11349,123143,181,1766927,11168
2020-09-09,Michigan,26,119952,968,6889,75,3003277,23193,119863,961,2883414,22232
2020-09-09,Minnesota,27,81920,260,1921,7,1204193,2323,81868,260,1122325,2063
2020-09-09,Mississippi,28,87805,426,2623,38,609638,3177,87805,426,521833,2751
2020-09-09,Missouri,29,98446,1402,1755,9,1070909,9679,96475,1362,974434,8317
2020-09-09,Montana,30,8499,90,122,3,271150,2370,8468,87,262682,2283
2020-09-09,Nebraska,31,36917,440,434,16,385349,7049,36477,502,348872,6547
2020-09-09,Nevada,32,72317,152,1414,19,624874,822,72258,154,552616,668
2020-09-09,New Hampshire,33,7517,23,433,0,222963,0,7494,0,215469,0
2020-09-09,New Jersey,34,196779,329,16009,13,3091149,20403,194990,323,2896159,20080
2020-09-09,New Mexico,35,26268,87,813,6,803101,3428,26268,87,776833,3341
2020-09-09,New York,36,445881,573,32611,-1,8976165,63230,441154,576,8535011,62654
2020-09-09,North Carolina,37,180061,911,2990,48,2490113,20136,179532,897,2310581,19239
2020-09-09,North Dakota,38,14114,238,161,1,212959,830,14110,238,198849,592
2020-09-09,Northern Mariana Islands,69,59,0,2,0,13543,0,59,0,13484,0
2020-09-09,Ohio,39,132965,973,4324,26,2470564,21019,132965,973,2337599,20046
2020-09-09,Oklahoma,40,65929,876,863,9,953536,28397,65929,876,887607,27521
2020-09-09,Oregon,41,28474,119,499,7,594077,2578,28471,116,565606,2462
2020-09-09,Pennsylvania,42,146058,867,7882,20,1766930,11854,141290,931,1625640,10923
2020-09-09,Puerto Rico,72,35507,3,500,18,322761,1,16789,1,305972,0
2020-09-09,Rhode Island,44,22676,84,1062,3,299014,7575,22676,84,276338,7491
2020-09-09,South Carolina,45,126213,305,2942,30,1017319,3168,126213,305,891106,2863
2020-09-09,South Dakota,46,15571,168,173,0,157889,1203,15571,168,142318,1035
2020-09-09,Tennessee,47,164032,852,1908,35,2367502,16511,166587,833,2200915,15678
2020-09-09,Texas,48,675149,4722,13986,131,5372132,33006,645791,4000,4726341,29006
2020-09-09,Utah,49,55730,306,428,2,694309,2950,55673,314,638636,2636
2020-09-09,Vermont,50,1656,2,58,0,147170,388,1656,2,145514,386
2020-09-09,Virgin Islands,78,1197,6,18,0,17444,0,1191,0,16253,0
2020-09-09,Virginia,51,129289,882,2697,11,1700004,10260,129289,882,1570715,9378
2020-09-09,Washington,53,81528,480,2066,21,1583903,20850,78009,774,1505894,20076
2020-09-09,West Virginia,54,11808,147,254,4,463930,1170,11808,147,452122,1023
2020-09-09,Wisconsin,55,88643,913,1193,14,1326763,8927,88590,913,1238173,8014
2020-09-09,Wyoming,56,4151,48,42,0,84835,3366,4151,48,80684,3318
2020-09-10,Alabama,01,135565,1148,2301,16,1005738,7339,135565,1148,870173,6191
2020-09-10,Alaska,02,6860,125,39,0,393077,1140,6022,114,387055,1026
2020-09-10,Arizona,04,207002,454,5275,22,1272734,3537,207002,461,1065732,3076
2020-09-10,Arkansas,05,67803,548,940,12,797178,12950,67803,548,729375,12402
2020-09-10,California,06,753017,3821,14094,104,12389991,46194,742865,3338,11647126,42856
2020-09-10,Colorado,08,60576,285,1988,4,764682,4330,60185,265,704497,4065
2020-09-10,Connecticut,09,54093,222,4478,4,1309460,16613,54093,222,1255367,16391
2020-09-10,Delaware,10,18466,158,613,4,256698,2728,18466,158,238232,2570
2020-09-10,District of Columbia,11,14412,25,616,1,319188,1528,14412,25,304776,1503
2020-09-10,Florida,12,654723,2583,12325,211,4842846,18965,647318,2537,4195528,16428
2020-09-10,Georgia,13,272588,1964,6062,75,2542594,14815,289123,1836,2253471,12979
2020-09-10,Guam,66,2815,88,22,1,42618,523,1846,88,40772,435
2020-09-10,Hawaii,15,10397,169,93,3,239403,1486,10254,98,229149,1388
2020-09-10,Idaho,16,35027,320,407,1,272164,1630,34310,329,237854,1301
2020-09-10,Illinois,17,258573,1959,8480,23,4577649,48982,257571,1953,4320078,47029
2020-09-10,Indiana,18,104429,788,3410,13,1164141,6123,102243,758,1061898,5365
2020-09-10,Iowa,19,72548,954,1208,4,667869,6294,70405,902,597464,5392
2020-09-10,Kansas,20,48443,54,499,2,441414,0,47410,0,394004,0
2020-09-10,Kentucky,21,58452,934,1073,15,884491,6201,54772,795,829719,5406
2020-09-10,Louisiana,22,156354,464,5161,21,2010519,10557,156354,464,1854165,10093
2020-09-10,Maine,23,4760,26,134,0,313909,4184,4760,26,309149,4158
2020-09-10,Maryland,24,114574,504,3824,8,1423727,8205,114078,503,1309649,7702
2020-09-10,Massachusetts,25,123546,403,9166,20,1907999,17929,123546,403,1784453,17526
2020-09-10,Michigan,26,120896,944,6894,5,3036448,33171,120846,983,2915602,32188
2020-09-10,Minnesota,27,82301,381,1936,15,1205501,1308,82249,381,1123252,927
2020-09-10,Mississippi,28,88322,517,2656,33,613238,3600,88322,517,524916,3083
2020-09-10,Missouri,29,99677,1231,1773,18,1083924,13015,97591,1116,986333,11899
2020-09-10,Montana,30,8694,195,123,1,273353,2203,8663,195,264690,2008
2020-09-10,Nebraska,31,37373,456,440,6,390318,4969,36917,440,353401,4529
2020-09-10,Nevada,32,72620,303,1432,18,627319,2445,72546,288,554773,2157
2020-09-10,New Hampshire,33,7573,56,434,1,225659,2696,7573,79,218086,2617
2020-09-10,New Jersey,34,197203,424,16014,5,3113654,22505,195414,424,2918240,22081
2020-09-10,New Mexico,35,26429,161,816,3,806999,3898,26429,161,780570,3737
2020-09-10,New York,36,446637,756,32618,7,9052978,76813,441911,757,8611067,76056
2020-09-10,North Carolina,37,181335,1274,3016,26,2521839,31726,180754,1222,2341085,30504
2020-09-10,North Dakota,38,14446,332,163,2,214292,1333,14443,333,199849,1000
2020-09-10,Northern Mariana Islands,69,59,0,2,0,14375,832,59,0,14316,832
2020-09-10,Ohio,39,134086,1121,4354,30,2490351,19787,134086,1121,2356265,18666
2020-09-10,Oklahoma,40,66700,771,876,13,961710,8174,66700,771,895010,7403
2020-09-10,Oregon,41,28661,187,501,2,596988,2911,28654,183,568334,2728
2020-09-10,Pennsylvania,42,146735,677,7894,12,1781226,14296,141877,587,1639349,13709
2020-09-10,Puerto Rico,72,36279,772,512,12,323220,459,17248,459,305972,0
2020-09-10,Rhode Island,44,22782,106,1067,5,301313,2299,22782,106,278531,2193
2020-09-10,South Carolina,45,126592,379,2975,33,1032459,15140,126592,379,905867,14761
2020-09-10,South Dakota,46,15834,263,177,4,159250,1361,15834,263,143416,1098
2020-09-10,Tennessee,47,165911,1879,1963,55,2393040,25538,168237,1650,2224803,23888
2020-09-10,Texas,48,677888,2739,13998,12,5405257,33125,649809,4018,4755448,29107
2020-09-10,Utah,49,56182,452,431,3,698425,4116,56019,346,642406,3770
2020-09-10,Vermont,50,1661,5,58,0,147306,136,1661,5,145645,131
2020-09-10,Virgin Islands,78,1201,4,18,0,17865,421,1197,6,16668,415
2020-09-10,Virginia,51,130525,1236,2708,11,1716462,16458,130525,1236,1585937,15222
2020-09-10,Washington,53,82125,597,2073,7,1597987,14084,78467,458,1519520,13626
2020-09-10,West Virginia,54,12017,209,257,3,467790,3860,12017,209,455773,3651
2020-09-10,Wisconsin,55,90232,1589,1202,9,1335630,8867,90182,1592,1245448,7275
2020-09-10,Wyoming,56,4199,48,42,0,85299,464,4199,48,81100,416
2020-09-11,Alabama,01,136703,1138,2333,32,1010922,5184,136703,1138,874219,4046
2020-09-11,Alaska,02,6968,108,40,1,394586,1509,6111,89,388475,1420
2020-09-11,Arizona,04,207525,523,5290,15,1279424,6690,207523,521,1071901,6169
2020-09-11,Arkansas,05,68987,1184,953,13,798358,1180,68983,1180,729375,0
2020-09-11,California,06,757125,4108,14265,171,12451660,61669,746191,3326,11705469,58343
2020-09-11,Colorado,08,60881,305,1991,3,770227,5545,60492,307,709735,5238
2020-09-11,Connecticut,09,54326,233,4480,2,1330984,21524,54326,233,1276658,21291
2020-09-11,Delaware,10,18559,93,613,0,256698,0,18466,0,238232,0
2020-09-11,District of Columbia,11,14493,81,616,0,321436,2248,14493,81,306943,2167
2020-09-11,Florida,12,658373,3650,12501,176,4869297,26451,650922,3604,4218375,22847
2020-09-11,Georgia,13,274242,1654,6103,41,2558319,15725,290781,1658,2267538,14067
2020-09-11,Guam,66,2832,17,24,2,43013,395,1863,17,41150,378
2020-09-11,Hawaii,15,10567,170,95,2,246614,7211,10423,169,236191,7042
2020-09-11,Idaho,16,35354,327,415,8,273816,1652,34617,307,239199,1345
2020-09-11,Illinois,17,260949,2376,8522,42,4634477,56828,259883,2312,4374594,54516
2020-09-11,Indiana,18,105703,1274,3420,10,1183104,18963,103505,1262,1079599,17701
2020-09-11,Iowa,19,73399,851,1216,8,673597,5728,71133,728,602464,5000
2020-09-11,Kansas,20,49393,950,520,21,448930,7516,48386,976,400544,6540
2020-09-11,Kentucky,21,59349,897,1087,14,900690,16199,55704,932,844986,15267
2020-09-11,Louisiana,22,157109,755,5202,41,2037753,27234,157109,755,1880644,26479
2020-09-11,Maine,23,4792,32,134,0,320008,6099,4792,32,315216,6067
2020-09-11,Maryland,24,115217,643,3828,4,1432876,9149,114724,646,1318152,8503
2020-09-11,Massachusetts,25,123986,440,9180,14,1927402,19403,123986,440,1803416,18963
2020-09-11,Michigan,26,122319,1423,6900,6,3072786,36338,122251,1405,2950535,34933
2020-09-11,Minnesota,27,82768,467,1949,13,1212560,7059,82716,467,1129844,6592
2020-09-11,Mississippi,28,89175,853,2670,14,618379,5141,89175,853,529204,4288
2020-09-11,Missouri,29,101285,1608,1784,11,1096572,12648,99160,1569,997412,11079
2020-09-11,Montana,30,8817,123,132,9,274658,1305,8785,122,265873,1183
2020-09-11,Nebraska,31,37841,468,449,9,393812,3494,37373,456,356439,3038
2020-09-11,Nevada,32,72886,266,1441,9,633282,5963,72806,260,560476,5703
2020-09-11,New Hampshire,33,7620,47,434,0,227291,1632,7620,47,219671,1585
2020-09-11,New Jersey,34,197677,474,16023,9,3140786,27132,195888,474,2944898,26658
2020-09-11,New Mexico,35,26563,134,818,2,812050,5051,26563,134,785487,4917
2020-09-11,New York,36,447498,861,32619,1,9142700,89722,442791,880,8699909,88842
2020-09-11,North Carolina,37,182934,1599,3050,34,2558654,36815,182286,1532,2376368,35283
2020-09-11,North Dakota,38,14687,241,167,4,215076,784,14684,241,200392,543
2020-09-11,Northern Mariana Islands,69,59,0,2,0,14375,0,59,0,14316,0
2020-09-11,Ohio,39,135326,1240,4403,49,2519213,28862,135326,1240,2383887,27622
2020-09-11,Oklahoma,40,67642,942,888,12,974751,13041,67642,942,907109,12099
2020-09-11,Oregon,41,28888,227,500,-1,605739,8751,28865,211,576874,8540
2020-09-11,Pennsylvania,42,147744,1009,7914,20,1794913,13687,142885,1008,1652028,12679
2020-09-11,Puerto Rico,72,36581,302,523,11,323329,109,17357,109,305972,0
2020-09-11,Rhode Island,44,22905,123,1071,4,303023,1710,22905,123,280118,1587
2020-09-11,South Carolina,45,129046,2454,3028,53,1044476,12017,129046,2454,915430,9563
2020-09-11,South Dakota,46,16117,283,177,0,160963,1713,16117,283,144846,1430
2020-09-11,Tennessee,47,167263,1352,1999,36,2420379,27339,169859,1622,2250520,25717
2020-09-11,Texas,48,683295,5407,14279,281,5454041,48784,653356,3547,4800685,45237
2020-09-11,Utah,49,56789,607,433,2,703161,4736,56675,656,646486,4080
2020-09-11,Vermont,50,1668,7,58,0,148575,1269,1668,7,146907,1262
2020-09-11,Virgin Islands,78,1201,0,18,0,18050,185,1201,4,16849,181
2020-09-11,Virginia,51,131640,1115,2711,3,1734047,17585,131640,1115,1602407,16470
2020-09-11,Washington,53,82590,465,2079,6,1614748,16761,79011,544,1535737,16217
2020-09-11,West Virginia,54,12174,157,263,6,471791,4001,12174,157,459617,3844
2020-09-11,Wisconsin,55,91672,1440,1206,4,1345659,10029,91625,1443,1254034,8586
2020-09-11,Wyoming,56,4264,65,42,0,86355,1056,4264,65,82091,991
2020-09-12,Alabama,01,137646,943,2350,17,1016369,5447,137646,943,878723,4504
2020-09-12,Alaska,02,7074,106,41,1,399629,5043,6214,103,393415,4940
2020-09-12,Arizona,04,208128,603,5316,26,1288729,9305,208128,605,1080601,8700
2020-09-12,Arkansas,05,69710,723,969,16,820000,21642,69710,727,750290,20915
2020-09-12,California,06,760581,3456,14333,68,12556967,105307,750298,4107,11806669,101200
2020-09-12,Colorado,08,61311,430,1994,3,777488,7261,60907,415,716581,6846
2020-09-12,Connecticut,09,54326,0,4480,0,1330984,0,54326,0,1276658,0
2020-09-12,Delaware,10,18726,167,613,0,259585,2887,18726,260,240859,2627
2020-09-12,District of Columbia,11,14552,59,616,0,327437,6001,14552,59,312885,5942
2020-09-12,Florida,12,661563,3190,12599,98,4894199,24902,654090,3168,4240109,21734
2020-09-12,Georgia,13,276319,2077,6144,41,2610171,51852,292905,2124,2317266,49728
2020-09-12,Guam,66,2832,0,24,0,43363,350,1891,28,41472,322
2020-09-12,Hawaii,15,10696,129,96,1,250173,3559,10593,170,239580,3389
2020-09-12,Idaho,16,35588,234,416,1,275610,1794,34950,333,240660,1461
2020-09-12,Illinois,17,262957,2008,8546,24,4691071,56594,262004,2121,4429067,54473
2020-09-12,Indiana,18,106777,1074,3437,17,1206980,23876,104561,1056,1102419,22820
2020-09-12,Iowa,19,74204,805,1218,2,678890,5293,71706,573,607184,4720
2020-09-12,Kansas,20,49398,5,533,13,448930,0,48386,0,400544,0
2020-09-12,Kentucky,21,60187,838,1099,12,930222,29532,56415,711,873807,28821
2020-09-12,Louisiana,22,157109,0,5202,0,2037753,0,157109,0,1880644,0
2020-09-12,Maine,23,4834,42,135,1,325003,4995,4834,42,320169,4953
2020-09-12,Maryland,24,115876,659,3836,8,1444452,11576,115533,809,1328919,10767
2020-09-12,Massachusetts,25,124540,554,9196,16,1945834,18432,124540,554,1821294,17878
2020-09-12,Michigan,26,123048,729,6912,12,3110610,37824,123058,807,2987552,37017
2020-09-12,Minnesota,27,83640,872,1958,9,1222522,9962,83588,872,1138934,9090
2020-09-12,Mississippi,28,89620,445,2685,15,622539,4160,89620,445,532919,3715
2020-09-12,Missouri,29,103085,1800,1802,18,1113373,16801,101134,1974,1012239,14827
2020-09-12,Montana,30,8946,129,134,2,278728,4070,8925,140,269803,3930
2020-09-12,Nebraska,31,38108,267,449,0,397354,3542,37841,468,359513,3074
2020-09-12,Nevada,32,73291,405,1453,12,637902,4620,73220,414,564682,4206
2020-09-12,New Hampshire,33,7652,32,435,1,229024,1733,7652,32,221372,1701
2020-09-12,New Jersey,34,198126,449,16027,4,3141235,449,196337,449,2944898,0
2020-09-12,New Mexico,35,26661,98,821,3,817270,5220,26661,98,790609,5122
2020-09-12,New York,36,448347,849,32625,6,9245625,102925,443640,849,8801985,102076
2020-09-12,North Carolina,37,184305,1371,3073,23,2581132,22478,183740,1454,2397392,21024
2020-09-12,North Dakota,38,15154,467,170,3,216581,1505,15151,467,201430,1038
2020-09-12,Northern Mariana Islands,69,60,1,2,0,14376,1,60,1,14316,0
2020-09-12,Ohio,39,136568,1242,4411,8,2567011,47798,136568,1242,2430443,46556
2020-09-12,Oklahoma,40,68659,1017,899,11,988835,14084,68659,1017,920176,13067
2020-09-12,Oregon,41,29156,268,505,5,610104,4365,29156,291,580948,4074
2020-09-12,Pennsylvania,42,148635,891,7915,1,1807805,12892,143805,920,1664000,11972
2020-09-12,Puerto Rico,72,37092,511,535,12,323570,241,17598,241,305972,0
2020-09-12,Rhode Island,44,22905,0,1071,0,306136,3113,22999,94,283137,3019
2020-09-12,South Carolina,45,129978,932,3040,12,1054872,10396,129978,932,924894,9464
2020-09-12,South Dakota,46,16437,320,183,6,162609,1646,16437,320,146172,1326
2020-09-12,Tennessee,47,168552,1289,2040,41,2442734,22355,170891,1032,2271843,21323
2020-09-12,Texas,48,685921,2626,14384,105,5519641,65600,657589,4233,4862052,61367
2020-09-12,Utah,49,57276,487,434,1,708231,5070,57247,572,650984,4498
2020-09-12,Vermont,50,1677,9,58,0,149661,1086,1677,9,147984,1077
2020-09-12,Virgin Islands,78,1220,19,19,1,18223,173,1211,10,17012,163
2020-09-12,Virginia,51,132940,1300,2722,11,1750110,16063,132940,1300,1617170,14763
2020-09-12,Washington,53,82957,367,2079,0,1631162,16414,79476,465,1551686,15949
2020-09-12,West Virginia,54,12521,347,265,2,478876,7085,12521,347,466355,6738
2020-09-12,Wisconsin,55,93102,1430,1218,12,1357360,11701,93055,1430,1264305,10271
2020-09-12,Wyoming,56,4297,33,42,0,86388,33,4297,33,82091,0
2020-09-13,Alabama,01,138755,1109,2351,1,1023187,6818,138755,1109,884432,5709
2020-09-13,Alaska,02,7136,62,41,0,401213,1584,6275,61,394938,1523
2020-09-13,Arizona,04,208514,386,5322,6,1296137,7408,208512,384,1087625,7024
2020-09-13,Arkansas,05,70219,509,981,12,822068,2068,70219,509,751849,1559
2020-09-13,California,06,763389,2808,14386,53,12690016,133049,754923,4625,11935093,128424
2020-09-13,Colorado,08,61641,330,1994,0,784530,7042,61324,417,723206,6625
2020-09-13,Connecticut,09,54326,0,4480,0,1330984,0,54326,0,1276658,0
2020-09-13,Delaware,10,18849,123,615,2,261296,1711,18849,123,242447,1588
2020-09-13,District of Columbia,11,14592,40,616,0,330641,3204,14592,40,316049,3164
2020-09-13,Florida,12,663986,2423,12607,8,4916421,22222,656485,2395,4259936,19827
2020-09-13,Georgia,13,277715,1396,6191,47,2602202,-7969,294314,1409,2307888,-9378
2020-09-13,Guam,66,2832,0,24,0,43363,0,1891,0,41472,0
2020-09-13,Hawaii,15,10808,112,98,2,255533,5360,10722,129,244811,5231
2020-09-13,Idaho,16,35693,105,416,0,277123,1513,35167,217,241956,1296
2020-09-13,Illinois,17,264340,1383,8562,16,4737961,46890,263466,1462,4474495,45428
2020-09-13,Indiana,18,108020,1243,3438,1,1238984,32004,105804,1243,1133180,30761
2020-09-13,Iowa,19,74675,471,1220,2,683445,4555,72490,784,610955,3771
2020-09-13,Kansas,20,49408,10,536,3,448930,0,48386,0,400544,0
2020-09-13,Kentucky,21,60607,420,1102,3,930752,530,56945,530,873807,0
2020-09-13,Louisiana,22,158390,1281,5235,33,2066730,28977,158390,1281,1908340,27696
2020-09-13,Maine,23,4863,29,136,1,330168,5165,4863,29,325305,5136
2020-09-13,Maryland,24,116600,724,3838,2,1455845,11393,116110,577,1339735,10816
2020-09-13,Massachusetts,25,124826,286,9210,14,1957955,12121,124826,286,1833129,11835
2020-09-13,Michigan,26,123075,27,6912,0,3110610,0,123058,0,2987552,0
2020-09-13,Minnesota,27,84363,723,1971,13,1233305,10783,84311,723,1148994,10060
2020-09-13,Mississippi,28,89874,254,2697,12,622793,254,89874,254,532919,0
2020-09-13,Missouri,29,104603,1518,1812,10,1128700,15327,102747,1613,1025953,13714
2020-09-13,Montana,30,9037,91,136,2,280124,1396,9021,96,271103,1300
2020-09-13,Nebraska,31,38188,80,449,0,400684,3330,38108,267,362576,3063
2020-09-13,Nevada,32,73648,357,1454,1,642075,4173,73537,317,568538,3856
2020-09-13,New Hampshire,33,7696,44,436,1,230542,1518,7696,44,222846,1474
2020-09-13,New Jersey,34,198423,297,16031,4,3168530,27295,196634,297,2971896,26998
2020-09-13,New Mexico,35,26761,100,823,2,823145,5875,26761,100,796384,5775
2020-09-13,New York,36,449072,725,32629,4,9318293,72668,444365,725,8873928,71943
2020-09-13,North Carolina,37,185325,1020,3080,7,2616108,34976,184936,1196,2431172,33780
2020-09-13,North Dakota,38,15580,426,171,1,218606,2025,15577,426,203029,1599
2020-09-13,Northern Mariana Islands,69,60,0,2,0,14376,0,60,0,14316,0
2020-09-13,Ohio,39,137405,837,4415,4,2593830,26819,137405,837,2456425,25982
2020-09-13,Oklahoma,40,69354,695,905,6,989530,695,69354,695,920176,0
2020-09-13,Oregon,41,29337,181,509,4,612620,2516,29337,181,583283,2335
2020-09-13,Pennsylvania,42,148635,0,7915,0,1807881,76,143881,76,1664000,0
2020-09-13,Puerto Rico,72,37380,288,539,4,323741,171,17769,171,305972,0
2020-09-13,Rhode Island,44,22905,0,1071,0,307483,1347,23098,99,284385,1248
2020-09-13,South Carolina,45,131864,1886,3064,24,1071863,16991,131864,1886,939999,15105
2020-09-13,South Dakota,46,16638,201,184,1,163956,1347,16638,201,147318,1146
2020-09-13,Tennessee,47,169310,758,2055,15,2456149,13415,171824,933,2284325,12482
2020-09-13,Texas,48,689941,4020,14458,74,5550139,30498,659434,1845,4890705,28653
2020-09-13,Utah,49,57892,616,434,0,711973,3742,57875,628,654098,3114
2020-09-13,Vermont,50,1684,7,58,0,150673,1012,1684,7,148989,1005
2020-09-13,Virgin Islands,78,1220,0,19,0,18343,120,1220,9,17123,111
2020-09-13,Virginia,51,133814,874,2724,2,1766238,16128,133814,874,1632424,15254
2020-09-13,Washington,53,83177,220,2079,0,1644585,13423,79826,350,1564759,13073
2020-09-13,West Virginia,54,12699,178,266,1,483764,4888,12699,178,471065,4710
2020-09-13,Wisconsin,55,94723,1621,1219,1,1365137,7777,94679,1624,1270458,6153
2020-09-13,Wyoming,56,4346,49,42,0,86437,49,4346,49,82091,0
2020-09-14,Alabama,01,139459,704,2355,4,1027551,4364,139459,704,888092,3660
2020-09-14,Alaska,02,7213,77,41,0,403413,2200,6350,75,397063,2125
2020-09-14,Arizona,04,208726,212,5322,0,1300664,4527,208725,213,1091939,4314
2020-09-14,Arkansas,05,70627,408,992,11,828267,6199,70627,408,757640,5791
2020-09-14,California,06,767062,3673,14458,72,12806189,116173,757778,2855,12048411,113318
2020-09-14,Colorado,08,62032,391,2000,6,790757,6227,61699,375,729058,5852
2020-09-14,Connecticut,09,54895,569,4485,5,1379988,49004,54895,569,1325093,48435
2020-09-14,Delaware,10,18937,88,617,2,262504,1208,18937,88,243567,1120
2020-09-14,District of Columbia,11,14622,30,616,0,332148,1507,14622,30,317526,1477
2020-09-14,Florida,12,665722,1736,12641,34,4933481,17060,658203,1718,4275278,15342
2020-09-14,Georgia,13,278699,984,6211,20,2615247,13045,295337,1023,2319910,12022
2020-09-14,Guam,66,2896,64,27,3,43894,531,1927,36,41967,495
2020-09-14,Hawaii,15,10887,79,98,0,259665,4132,10834,112,248831,4020
2020-09-14,Idaho,16,35984,291,420,4,278613,1490,35279,112,243334,1378
2020-09-14,Illinois,17,265869,1529,8571,9,4773891,35930,264839,1373,4509052,34557
2020-09-14,Indiana,18,108755,735,3439,1,1247293,8309,106540,736,1140753,7573
2020-09-14,Iowa,19,75069,394,1233,13,686636,3191,72876,386,613760,2805
2020-09-14,Kansas,20,50871,1463,546,10,458381,9451,49899,1513,408482,7938
2020-09-14,Kentucky,21,61182,575,1105,3,996575,65823,57282,337,939293,65486
2020-09-14,Louisiana,22,158882,492,5252,17,2079299,12569,158882,492,1920417,12077
2020-09-14,Maine,23,4903,40,136,0,333777,3609,4903,40,328874,3569
2020-09-14,Maryland,24,117147,547,3839,1,1464863,9018,116646,536,1348217,8482
2020-09-14,Massachusetts,25,125080,254,9219,9,1970175,12220,125080,254,1845095,11966
2020-09-14,Michigan,26,124276,1201,6922,10,3162087,51477,124287,1229,3037800,50248
2020-09-14,Minnesota,27,85001,638,1974,3,1243355,10050,84949,638,1158406,9412
2020-09-14,Mississippi,28,90018,144,2706,9,625806,3013,90018,144,535788,2869
2020-09-14,Missouri,29,106057,1454,1812,0,1145207,16507,104079,1332,1041128,15175
2020-09-14,Montana,30,9164,127,139,3,285870,5746,9107,86,276763,5660
2020-09-14,Nebraska,31,38642,454,450,1,403965,3281,38335,227,365630,3054
2020-09-14,Nevada,32,73889,241,1456,2,644871,2796,73814,277,571057,2519
2020-09-14,New Hampshire,33,7714,18,436,0,231816,1274,7714,18,224102,1256
2020-09-14,New Jersey,34,198757,334,16034,3,3189970,21440,196968,334,2993002,21106
2020-09-14,New Mexico,35,26842,81,823,0,826619,3474,26842,81,799777,3393
2020-09-14,New York,36,449658,586,32639,10,9381651,63358,444948,583,8936703,62775
2020-09-14,North Carolina,37,186447,1122,3094,14,2634819,18711,185781,845,2449038,17866
2020-09-14,North Dakota,38,15834,254,173,2,220230,1624,15831,254,204399,1370
2020-09-14,Northern Mariana Islands,69,61,1,2,0,14377,1,61,1,14316,0
2020-09-14,Ohio,39,138484,1079,4419,4,2623256,29426,138484,1079,2484772,28347
2020-09-14,Oklahoma,40,70223,869,905,0,990399,869,70223,869,920176,0
2020-09-14,Oregon,41,29488,151,511,2,614804,2184,29484,147,585320,2037
2020-09-14,Pennsylvania,42,150044,1409,7940,25,1829672,21791,145063,1182,1684609,20609
2020-09-14,Puerto Rico,72,37750,370,542,3,323949,208,17977,208,305972,0
2020-09-14,Rhode Island,44,23130,225,1075,4,308197,714,23130,32,285067,682
2020-09-14,South Carolina,45,132680,816,3077,13,1088473,16610,132680,816,955793,15794
2020-09-14,South Dakota,46,16801,163,184,0,165139,1183,16801,163,148338,1020
2020-09-14,Tennessee,47,171498,2188,2073,18,2492851,36702,174274,2450,2318577,34252
2020-09-14,Texas,48,694547,4606,14508,50,5213247,-336892,663445,4011,4549802,-340903
2020-09-14,Utah,49,58451,559,436,2,714922,2949,58438,563,656484,2386
2020-09-14,Vermont,50,1696,12,58,0,151478,805,1696,12,149782,793
2020-09-14,Virgin Islands,78,1221,1,19,0,18351,8,1221,1,17130,7
2020-09-14,Virginia,51,134571,757,2743,19,1779329,13091,134571,757,1644758,12334
2020-09-14,Washington,53,83861,684,2095,16,1653967,9382,80138,312,1573829,9070
2020-09-14,West Virginia,54,12820,121,275,9,488015,4251,12820,121,475195,4130
2020-09-14,Wisconsin,55,95564,841,1219,0,1369104,3967,95497,818,1273607,3149
2020-09-14,Wyoming,56,4392,46,46,4,89006,2569,4392,46,84614,2523
2020-09-15,Alabama,01,140160,701,2387,32,1032970,5419,140160,701,892810,4718
2020-09-15,Alaska,02,7256,43,41,0,407124,3711,6393,43,400731,3668
2020-09-15,Arizona,04,209215,489,5346,24,1312304,11640,209209,484,1103095,11156
2020-09-15,Arkansas,05,71497,870,1150,158,872116,43849,71357,730,800759,43119
2020-09-15,California,06,769917,2855,14606,148,12928170,121981,760013,2235,12168157,119746
2020-09-15,Colorado,08,62575,543,2006,6,795733,4976,62099,400,733634,4576
2020-09-15,Connecticut,09,55031,136,4485,0,1390771,10783,55031,136,1335740,10647
2020-09-15,Delaware,10,19137,200,618,1,264159,1655,19137,200,245022,1455
2020-09-15,District of Columbia,11,14687,65,616,0,336280,4132,14687,65,321593,4067
2020-09-15,Florida,12,668838,3116,12786,145,4960947,27466,660946,2743,4300001,24723
2020-09-15,Georgia,13,280356,1657,6255,44,2629090,13843,296833,1496,2332257,12347
2020-09-15,Guam,66,2935,39,29,2,44329,435,1966,39,42363,396
2020-09-15,Hawaii,15,10951,64,99,1,262041,2376,10913,79,251128,2297
2020-09-15,Idaho,16,36306,322,425,5,280170,1557,35532,253,244638,1304
2020-09-15,Illinois,17,267380,1511,8589,18,4812922,39031,266305,1466,4546617,37565
2020-09-15,Indiana,18,109445,690,3460,21,1254731,7438,107229,689,1147502,6749
2020-09-15,Iowa,19,75722,653,1234,1,689612,2976,73277,401,616335,2575
2020-09-15,Kansas,20,51006,135,555,9,458381,0,49899,0,408482,0
2020-09-15,Kentucky,21,61986,804,1112,7,1006439,9864,58000,718,948439,9146
2020-09-15,Louisiana,22,159253,371,5278,26,2091958,12659,159253,371,1932705,12288
2020-09-15,Maine,23,4918,15,137,1,336489,2712,4918,15,331571,2697
2020-09-15,Maryland,24,117745,598,3849,10,1472782,7919,117245,599,1355537,7320
2020-09-15,Massachusetts,25,125393,313,9225,6,1981998,11823,125393,313,1856605,11510
2020-09-15,Michigan,26,124978,702,6933,11,3187621,25534,124969,682,3062652,24852
2020-09-15,Minnesota,27,85403,402,1979,5,1247867,4512,85351,402,1162516,4110
2020-09-15,Mississippi,28,90523,505,2734,28,626311,505,90523,505,535788,0
2020-09-15,Missouri,29,107687,1630,1830,18,1155752,10545,105396,1317,1050356,9228
2020-09-15,Montana,30,9281,117,141,2,289368,3498,9244,137,280124,3361
2020-09-15,Nebraska,31,38970,328,451,1,406675,2710,38642,307,368033,2403
2020-09-15,Nevada,32,74129,240,1484,28,646536,1665,74040,226,572496,1439
2020-09-15,New Hampshire,33,7748,34,438,2,232458,642,7748,34,224710,608
2020-09-15,New Jersey,34,199193,436,16043,9,3212311,22341,197404,436,3014907,21905
2020-09-15,New Mexico,35,26923,81,830,7,831995,5376,26923,81,805072,5295
2020-09-15,New York,36,450425,767,32655,16,9455329,73678,445714,766,9009615,72912
2020-09-15,North Carolina,37,187486,1039,3135,41,2652440,17621,186887,1106,2465553,16515
2020-09-15,North Dakota,38,16067,233,175,2,220645,415,16064,233,204581,182
2020-09-15,Northern Mariana Islands,69,61,0,2,0,14377,0,61,0,14316,0
2020-09-15,Ohio,39,139485,1001,4506,87,2659531,36275,139485,1001,2520046,35274
2020-09-15,Oklahoma,40,71314,1091,912,7,1016508,26109,71314,1091,945194,25018
2020-09-15,Oregon,41,29664,176,519,8,618064,3260,29662,178,588402,3082
2020-09-15,Pennsylvania,42,151081,1037,7945,5,1841498,11826,146214,1151,1695284,10675
2020-09-15,Puerto Rico,72,38172,422,551,9,324178,229,18206,229,305972,0
2020-09-15,Rhode Island,44,23250,120,1078,3,310041,1844,23250,120,286791,1724
2020-09-15,South Carolina,45,133470,790,3098,21,1074737,-13736,133470,790,941267,-14526
2020-09-15,South Dakota,46,16994,193,184,0,166096,957,16994,193,149102,764
2020-09-15,Tennessee,47,172692,1194,2102,29,2515429,22578,175231,957,2340198,21621
2020-09-15,Texas,48,701509,6962,14661,153,5247542,34295,668746,5301,4578796,28994
2020-09-15,Utah,49,59017,566,436,0,720331,5409,59000,562,661331,4847
2020-09-15,Vermont,50,1702,6,58,0,151592,114,1702,6,149890,108
2020-09-15,Virgin Islands,78,1232,11,19,0,18545,194,1225,4,17320,190
2020-09-15,Virginia,51,135514,943,2839,96,1791808,12479,135514,943,1656294,11536
2020-09-15,Washington,53,84222,361,2107,12,1665715,11748,80465,327,1585250,11421
2020-09-15,West Virginia,54,12976,156,280,5,490646,2631,12976,156,477670,2475
2020-09-15,Wisconsin,55,97002,1438,1230,11,1381463,12359,96938,1441,1284525,10918
2020-09-15,Wyoming,56,4438,46,46,0,89745,739,4438,46,85307,693
2020-09-16,Alabama,01,141087,927,2392,5,1040771,7801,141087,927,899684,6874
2020-09-16,Alaska,02,7308,52,41,0,408564,1440,6443,50,402121,1390
2020-09-16,Arizona,04,209911,696,5376,30,1328461,16157,209907,698,1118554,15459
2020-09-16,Arkansas,05,72219,722,1157,7,846177,-25939,72219,862,773958,-26801
2020-09-16,California,06,773318,3401,14716,110,13000522,72352,762963,2950,12237559,69402
2020-09-16,Colorado,08,63068,493,2010,4,801922,6189,62686,587,739236,5602
2020-09-16,Connecticut,09,55166,135,4487,2,1394405,3634,55166,135,1339239,3499
2020-09-16,Delaware,10,19234,97,619,1,265905,1746,19234,97,246671,1649
2020-09-16,District of Columbia,11,14743,56,617,1,338241,1961,14743,56,323498,1905
2020-09-16,Florida,12,671193,2355,12938,152,4976056,15109,663234,2288,4312822,12821
2020-09-16,Georgia,13,282363,2007,6276,21,2654121,25031,299056,2223,2355065,22808
2020-09-16,Guam,66,2982,47,29,0,44851,522,2013,47,42838,475
2020-09-16,Hawaii,15,11052,101,102,3,263142,1101,10978,65,252164,1036
2020-09-16,Idaho,16,36594,288,430,5,281642,1472,35810,278,245832,1194
2020-09-16,Illinois,17,269282,1902,8622,33,4865233,52311,268246,1941,4596987,50370
2020-09-16,Indiana,18,110025,580,3472,12,1261892,7161,107809,580,1154083,6581
2020-09-16,Iowa,19,76680,958,1248,14,695111,5499,74080,803,621031,4696
2020-09-16,Kansas,20,51829,823,586,31,464226,5845,50870,971,413356,4874
2020-09-16,Kentucky,21,62723,737,1118,6,1027779,21340,58764,764,969015,20576
2020-09-16,Louisiana,22,159865,612,5294,16,2115184,23226,159865,612,1955319,22614
2020-09-16,Maine,23,4941,23,138,1,342187,5698,4941,23,337246,5675
2020-09-16,Maryland,24,118387,642,3855,6,1482958,10176,117888,643,1365070,9533
2020-09-16,Massachusetts,25,125699,306,9245,20,1998641,16643,125699,306,1872942,16337
2020-09-16,Michigan,26,125782,804,6944,11,3218461,30840,125742,773,3092719,30067
2020-09-16,Minnesota,27,85865,462,1985,6,1252392,4525,85813,462,1166579,4063
2020-09-16,Mississippi,28,91234,711,2756,22,632731,6420,91234,711,541497,5709
2020-09-16,Missouri,29,108997,1310,1844,14,1164383,8631,106587,1191,1057796,7440
2020-09-16,Montana,30,9487,206,141,0,292401,3033,9431,187,282970,2846
2020-09-16,Nebraska,31,39419,449,455,4,408961,2286,38970,328,369991,1958
2020-09-16,Nevada,32,74377,248,1496,12,649533,2997,74248,208,575285,2789
2020-09-16,New Hampshire,33,7780,32,438,0,233731,1273,7780,32,225951,1241
2020-09-16,New Jersey,34,199583,390,16054,11,3234972,22661,197792,388,3037180,22273
2020-09-16,New Mexico,35,27041,118,832,2,837400,5405,27041,118,810359,5287
2020-09-16,New York,36,451078,653,32662,7,9530416,75087,446366,652,9084050,74435
2020-09-16,North Carolina,37,188800,1314,3176,41,2683384,30944,188024,1137,2495360,29807
2020-09-16,North Dakota,38,16336,269,180,5,222057,1412,16333,269,205724,1143
2020-09-16,Northern Mariana Islands,69,61,0,2,0,14377,0,61,0,14316,0
2020-09-16,Ohio,39,140518,1033,4555,49,2689480,29949,140518,1033,2548962,28916
2020-09-16,Oklahoma,40,72284,970,924,12,1027596,11088,72284,970,955312,10118
2020-09-16,Oregon,41,29856,192,521,2,621273,3209,29850,188,591423,3021
2020-09-16,Pennsylvania,42,151889,808,7963,18,1855121,13623,146990,776,1708131,12847
2020-09-16,Puerto Rico,72,38284,112,570,19,324224,46,18252,46,305972,0
2020-09-16,Rhode Island,44,23358,108,1081,3,311344,1303,23358,108,287986,1195
2020-09-16,South Carolina,45,134122,652,3132,34,1080922,6185,134122,652,946800,5533
2020-09-16,South Dakota,46,17291,297,192,8,169655,3559,17291,297,152364,3262
2020-09-16,Tennessee,47,174400,1708,2127,25,2543236,27807,177087,1856,2366149,25951
2020-09-16,Texas,48,706034,4525,14803,142,5299620,52078,674772,6026,4624848,46052
2020-09-16,Utah,49,59770,753,437,1,726490,6159,59747,747,666743,5412
2020-09-16,Vermont,50,1702,0,58,0,152064,472,1702,0,150362,472
2020-09-16,Virgin Islands,78,1232,0,19,0,18672,127,1232,7,17440,120
2020-09-16,Virginia,51,136359,845,2884,45,1806247,14439,136359,845,1669888,13594
2020-09-16,Washington,53,84714,492,2113,6,1676702,10987,80812,347,1595890,10640
2020-09-16,West Virginia,54,13196,220,290,10,493883,3237,13196,220,480687,3017
2020-09-16,Wisconsin,55,98501,1499,1238,8,1393753,12290,98440,1502,1295313,10788
2020-09-16,Wyoming,56,4566,128,46,0,89969,224,4566,128,85403,96
2020-09-17,Alabama,01,141757,670,2401,9,1044913,4142,141757,670,903156,3472
2020-09-17,Alaska,02,7413,105,41,0,415863,7299,6551,108,409312,7191
2020-09-17,Arizona,04,211663,1752,5411,35,1352882,24421,211660,1753,1141222,22668
2020-09-17,Arkansas,05,73211,992,1166,9,856918,10741,73211,992,783707,9749
2020-09-17,California,06,776944,3626,14807,91,13080037,79515,766201,3238,12313836,76277
2020-09-17,Colorado,08,63613,545,2016,6,809241,7319,63145,459,746096,6860
2020-09-17,Connecticut,09,55386,220,4488,1,1408273,13868,55386,220,1352887,13648
2020-09-17,Delaware,10,19318,84,619,0,267168,1263,19318,84,247850,1179
2020-09-17,District of Columbia,11,14790,47,619,2,341318,3077,14790,47,326528,3030
2020-09-17,Florida,12,674448,3255,13085,147,5003024,26968,666507,3273,4336517,23695
2020-09-17,Georgia,13,284219,1856,6328,52,2679891,25770,300903,1847,2378988,23923
2020-09-17,Guam,66,3014,32,31,2,45253,402,2045,32,43208,370
2020-09-17,Hawaii,15,11211,159,106,4,265634,2492,11080,102,254554,2390
2020-09-17,Idaho,16,36924,330,435,5,283365,1723,36093,283,247272,1440
2020-09-17,Illinois,17,271370,2088,8643,21,4923033,57800,270302,2056,4652731,55744
2020-09-17,Indiana,18,110863,838,3478,6,1269650,7758,108646,837,1161004,6921
2020-09-17,Iowa,19,77865,1185,1257,9,701438,6327,75028,948,626410,5379
2020-09-17,Kansas,20,52039,210,586,0,464226,0,50870,0,413356,0
2020-09-17,Kentucky,21,63412,689,1127,9,1038685,10906,59370,606,979315,10300
2020-09-17,Louisiana,22,160343,478,5311,17,2124190,9006,160343,478,1963847,8528
2020-09-17,Maine,23,4962,21,138,0,351378,9191,4962,21,346416,9170
2020-09-17,Maryland,24,119017,630,3861,6,1494342,11384,118519,631,1375823,10753
2020-09-17,Massachusetts,25,126128,429,9260,15,2026295,27654,126128,429,1900167,27225
2020-09-17,Michigan,26,126794,1012,6956,12,3251731,33270,126722,980,3125009,32290
2020-09-17,Minnesota,27,86774,909,1994,9,1263546,11154,86722,909,1176824,10245
2020-09-17,Mississippi,28,91935,701,2780,24,633432,701,91935,701,541497,0
2020-09-17,Missouri,29,110554,1557,1864,20,1178581,14198,108334,1747,1070247,12451
2020-09-17,Montana,30,9721,234,143,2,295299,2898,9647,216,285652,2682
2020-09-17,Nebraska,31,39921,502,457,2,412851,3890,39419,449,373432,3441
2020-09-17,Nevada,32,74792,415,1509,13,652583,3050,74595,347,577988,2703
2020-09-17,New Hampshire,33,7814,34,438,0,235510,1779,7814,34,227696,1745
2020-09-17,New Jersey,34,200152,569,16057,3,3265818,30846,198361,569,3067457,30277
2020-09-17,New Mexico,35,27199,158,836,4,845167,7767,27199,158,817968,7609
2020-09-17,New York,36,451971,893,32669,7,9621920,91504,447262,896,9174658,90608
2020-09-17,North Carolina,37,190307,1507,3208,32,2714175,30791,189576,1552,2524599,29239
2020-09-17,North Dakota,38,16726,390,185,5,223170,1113,16723,390,206447,723
2020-09-17,Northern Mariana Islands,69,62,1,2,0,14378,1,62,1,14316,0
2020-09-17,Ohio,39,141585,1067,4580,25,2718333,28853,141585,1067,2576748,27786
2020-09-17,Oklahoma,40,73318,1034,930,6,1039837,12241,73318,1034,966519,11207
2020-09-17,Oregon,41,30068,212,521,0,625424,4151,29850,0,595574,4151
2020-09-17,Pennsylvania,42,152813,924,7978,15,1869198,14077,147923,933,1721275,13144
2020-09-17,Puerto Rico,72,38867,583,588,18,324606,382,18634,382,305972,0
2020-09-17,Rhode Island,44,23488,130,1085,4,313275,1931,23488,130,289787,1801
2020-09-17,South Carolina,45,135446,1324,3158,26,1087587,6665,135446,1324,952141,5341
2020-09-17,South Dakota,46,17686,395,193,1,171523,1868,17686,395,153837,1473
2020-09-17,Tennessee,47,175702,1302,2141,14,2564879,21643,178140,1053,2386739,20590
2020-09-17,Texas,48,710423,4389,14909,106,5345176,45556,678819,4047,4666357,41509
2020-09-17,Utah,49,60662,892,437,0,732682,6192,60658,911,672024,5281
2020-09-17,Vermont,50,1705,3,58,0,153195,1131,1705,3,151490,1128
2020-09-17,Virgin Islands,78,1238,6,19,0,18779,107,1238,6,17541,101
2020-09-17,Virginia,51,137460,1101,2920,36,1828512,22265,137460,1101,1691052,21164
2020-09-17,Washington,53,85101,387,2123,10,1691047,14345,81198,386,1609849,13959
2020-09-17,West Virginia,54,13430,234,294,4,498283,4400,13430,234,484853,4166
2020-09-17,Wisconsin,55,100619,2118,1240,2,1405298,11545,100574,2134,1304724,9411
2020-09-17,Wyoming,56,4652,86,49,3,91452,1483,4652,86,86800,1397
2020-09-18,Alabama,01,142863,1106,2428,27,1053055,8142,142863,1106,910192,7036
2020-09-18,Alaska,02,7528,115,42,1,418293,2430,6658,107,411635,2323
2020-09-18,Arizona,04,213663,2000,5455,44,1362319,9437,212942,1282,1149377,8155
2020-09-18,Arkansas,05,74082,871,1173,7,868179,11261,74082,871,794097,10390
2020-09-18,California,06,781436,4492,14912,105,13177186,97149,769831,3630,12407355,93519
2020-09-18,Colorado,08,64277,664,2020,4,817869,8628,63750,605,754119,8023
2020-09-18,Connecticut,09,55527,141,4492,4,1422148,13875,55527,141,1366621,13734
2020-09-18,Delaware,10,19366,48,620,1,268638,1470,19366,48,249272,1422
2020-09-18,District of Columbia,11,14852,62,619,0,347118,5800,14852,62,332266,5738
2020-09-18,Florida,12,677652,3204,13224,139,5030285,27261,669684,3177,4360601,24084
2020-09-18,Georgia,13,286170,1951,6390,62,2701952,22061,302737,1834,2399215,20227
2020-09-18,Guam,66,3043,29,34,3,45653,400,2074,29,43579,371
2020-09-18,Hawaii,15,11348,137,119,13,269463,3829,11239,159,258224,3670
2020-09-18,Idaho,16,37358,434,439,4,285552,2187,36489,396,249063,1791
2020-09-18,Illinois,17,273596,2226,8666,23,4985054,62021,272525,2223,4712529,59798
2020-09-18,Indiana,18,111900,1037,3495,17,1281438,11788,109683,1037,1171755,10751
2020-09-18,Iowa,19,78839,974,1264,7,708031,6593,76211,1183,631820,5410
2020-09-18,Kansas,20,53403,1364,596,10,474749,10523,52285,1415,422464,9108
2020-09-18,Kentucky,21,64155,743,1132,5,1051851,13166,60128,758,991723,12408
2020-09-18,Louisiana,22,161322,979,5340,29,2146986,22796,161322,979,1985664,21817
2020-09-18,Maine,23,5005,43,138,0,364424,13046,5005,43,359419,13003
2020-09-18,Maryland,24,119559,542,3869,8,1504867,10525,119062,543,1385805,9982
2020-09-18,Massachusetts,25,126582,454,9269,9,2048535,22240,126582,454,1921953,21786
2020-09-18,Michigan,26,127558,764,6955,-1,3285030,33299,127500,778,3157530,32521
2020-09-18,Minnesota,27,87859,1085,2002,8,1278837,15291,87807,1085,1191030,14206
2020-09-18,Mississippi,28,92432,497,2792,12,633432,0,91935,0,541497,0
2020-09-18,Missouri,29,112547,1993,1892,28,1190380,11799,110129,1795,1080251,10004
2020-09-18,Montana,30,9934,213,146,3,298555,3256,9871,224,288684,3032
2020-09-18,Nebraska,31,40387,466,457,0,416575,3724,39921,502,376654,3222
2020-09-18,Nevada,32,75153,361,1526,17,656601,4018,75096,501,581505,3517
2020-09-18,New Hampshire,33,7861,47,438,0,237518,2008,7861,47,229657,1961
2020-09-18,New Jersey,34,200639,487,16061,4,3291916,26098,198848,487,3093068,25611
2020-09-18,New Mexico,35,27350,151,841,5,850963,5796,27350,151,823613,5645
2020-09-18,New York,36,452764,793,32682,13,9711647,89727,448052,790,9263595,88937
2020-09-18,North Carolina,37,191672,1365,3232,24,2749020,34845,191019,1443,2558001,33402
2020-09-18,North Dakota,38,17233,507,187,2,225193,2023,17230,507,207963,1516
2020-09-18,Northern Mariana Islands,69,62,0,2,0,14378,0,62,0,14316,0
2020-09-18,Ohio,39,142596,1011,4608,28,2753105,34772,142596,1011,2610509,33761
2020-09-18,Oklahoma,40,74567,1249,939,9,1054217,14380,74567,1249,979650,13131
2020-09-18,Oregon,41,30351,283,524,3,629422,3998,30342,492,599080,3506
2020-09-18,Pennsylvania,42,153560,747,8006,28,1881488,12290,148683,760,1732805,11530
2020-09-18,Puerto Rico,72,39684,817,599,11,325085,479,19113,479,305972,0
2020-09-18,Rhode Island,44,23620,132,1088,3,315555,2280,23620,132,291935,2148
2020-09-18,South Carolina,45,136318,872,3177,19,1111404,23817,136318,872,975086,22945
2020-09-18,South Dakota,46,18075,389,198,5,173704,2181,18075,389,155629,1792
2020-09-18,Tennessee,47,177707,2005,2173,32,2603342,38463,180497,2357,2422845,36106
2020-09-18,Texas,48,713652,3229,15037,128,5444801,99625,682241,3422,4762560,96203
2020-09-18,Utah,49,61786,1124,437,0,738980,6298,61775,1117,677205,5181
2020-09-18,Vermont,50,1706,1,58,0,154099,904,1706,1,152393,903
2020-09-18,Virgin Islands,78,1257,19,19,0,18954,175,1242,4,17712,171
2020-09-18,Virginia,51,138702,1242,2949,29,1838235,9723,138702,1242,1699533,8481
2020-09-18,Washington,53,85583,482,2130,7,1704670,13623,81602,404,1623068,13219
2020-09-18,West Virginia,54,13683,253,297,3,503133,4850,13683,253,489450,4597
2020-09-18,Wisconsin,55,103211,2592,1247,7,1418412,13114,103154,2580,1315258,10534
2020-09-18,Wyoming,56,4747,95,49,0,92307,855,4747,95,87560,760
2020-09-19,Alabama,01,144164,1301,2437,9,1062612,9557,144164,1301,918448,8256
2020-09-19,Alaska,02,7613,85,42,0,422850,4557,6752,94,416098,4463
2020-09-19,Arizona,04,213551,-112,5471,16,1373159,10840,213551,609,1159608,10231
2020-09-19,Arkansas,05,75160,1078,1181,8,869257,1078,75160,1078,794097,0
2020-09-19,California,06,785076,3640,15023,111,13343886,166700,774135,4304,12569751,162396
2020-09-19,Colorado,08,64694,417,2022,2,825702,7833,64356,606,761346,7227
2020-09-19,Connecticut,09,55527,0,4492,0,1422148,0,55527,0,1366621,0
2020-09-19,Delaware,10,19449,83,621,1,269711,1073,19449,83,250262,990
2020-09-19,District of Columbia,11,14902,50,619,0,350877,3759,14902,50,335975,3709
2020-09-19,Florida,12,681225,3573,13286,62,5060515,30230,673194,3510,4387321,26720
2020-09-19,Georgia,13,288059,1889,6450,60,2735389,33437,305021,2284,2430368,31153
2020-09-19,Guam,66,3043,0,35,1,45958,305,2117,43,43841,262
2020-09-19,Hawaii,15,11457,109,119,0,279899,10436,11376,137,268523,10299
2020-09-19,Idaho,16,37624,266,441,2,288195,2643,36959,470,251236,2173
2020-09-19,Illinois,17,276057,2461,8688,22,5059340,74286,275054,2529,4784286,71757
2020-09-19,Indiana,18,112982,1082,3503,8,1292615,11177,110759,1076,1181856,10101
2020-09-19,Iowa,19,79785,946,1265,1,713775,5744,77058,847,636717,4897
2020-09-19,Kansas,20,53420,17,596,0,474749,0,52285,0,422464,0
2020-09-19,Kentucky,21,65068,913,1137,5,1054776,2925,61106,978,993670,1947
2020-09-19,Louisiana,22,161322,0,5340,0,2146986,0,161322,0,1985664,0
2020-09-19,Maine,23,5035,30,139,1,371187,6763,5035,30,366152,6733
2020-09-19,Maryland,24,120107,548,3876,7,1518804,13937,119744,682,1399060,13255
2020-09-19,Massachusetts,25,127181,599,9295,26,2069863,21328,127181,599,1942682,20729
2020-09-19,Michigan,26,128112,554,6970,15,3318469,33439,128087,587,3190382,32852
2020-09-19,Minnesota,27,88773,914,2015,13,1291395,12558,88721,914,1202674,11644
2020-09-19,Mississippi,28,93087,655,2809,17,702886,69454,93087,1152,609799,68302
2020-09-19,Missouri,29,113794,1247,1905,13,1202624,12244,111516,1387,1091108,10857
2020-09-19,Montana,30,10193,259,156,10,300840,2285,10163,292,290677,1993
2020-09-19,Nebraska,31,40797,410,457,0,419995,3420,40387,466,379608,2954
2020-09-19,Nevada,32,75524,371,1528,2,660686,4085,75419,323,585267,3762
2020-09-19,New Hampshire,33,7920,59,438,0,238732,1214,7920,59,230812,1155
2020-09-19,New Jersey,34,201100,461,16064,3,3292377,461,199309,461,3093068,0
2020-09-19,New Mexico,35,27512,162,847,6,857456,6493,27512,162,829944,6331
2020-09-19,New York,36,453747,983,32679,-3,9822091,110444,449038,986,9373053,109458
2020-09-19,North Carolina,37,192751,1079,3260,28,2771020,22000,192248,1229,2578772,20771
2020-09-19,North Dakota,38,17610,377,195,8,226502,1309,17607,377,208895,932
2020-09-19,Northern Mariana Islands,69,68,6,2,0,14378,0,62,0,14316,0
2020-09-19,Ohio,39,143547,951,4612,4,2788695,35590,143547,951,2645148,34639
2020-09-19,Oklahoma,40,75804,1237,943,4,1071501,17284,75804,1237,995697,16047
2020-09-19,Oregon,41,30600,249,527,3,633910,4488,30599,257,603311,4231
2020-09-19,Pennsylvania,42,154261,701,8028,22,1896125,14637,149845,1162,1746280,13475
2020-09-19,Puerto Rico,72,40993,1309,605,6,325779,694,19807,694,305972,0
2020-09-19,Rhode Island,44,23620,0,1088,0,318016,2461,23798,178,294218,2283
2020-09-19,South Carolina,45,137240,922,3188,11,1123265,11861,137240,922,986025,10939
2020-09-19,South Dakota,46,18444,369,200,2,175221,1517,18444,369,156777,1148
2020-09-19,Tennessee,47,179017,1310,2193,20,2627087,23745,181439,942,2445648,22803
2020-09-19,Texas,48,716914,3262,15124,87,5563176,118375,686068,3827,4877108,114548
2020-09-19,Utah,49,62893,1107,440,3,746137,7157,62852,1077,683285,6080
2020-09-19,Vermont,50,1710,4,58,0,154800,701,1710,4,153090,697
2020-09-19,Virgin Islands,78,1257,0,19,0,18954,0,1242,0,17712,0
2020-09-19,Virginia,51,139655,953,2990,41,1873355,35120,139655,953,1733700,34167
2020-09-19,Washington,53,85886,303,2130,0,1704670,0,81602,0,1623068,0
2020-09-19,West Virginia,54,13874,191,308,11,509486,6353,13874,191,495612,6162
2020-09-19,Wisconsin,55,105609,2398,1249,2,1431004,12592,105557,2403,1325447,10189
2020-09-19,Wyoming,56,4780,33,49,0,92340,33,4780,33,87560,0
2020-09-20,Alabama,01,144962,798,2437,0,1068328,5716,144962,798,923366,4918
2020-09-20,Alaska,02,7704,91,42,0,426925,4075,6860,108,420065,3967
2020-09-20,Arizona,04,214018,467,5480,9,1383924,10765,214018,467,1169906,10298
2020-09-20,Arkansas,05,75723,563,1181,0,886017,16760,75723,563,810294,16197
2020-09-20,California,06,788077,3001,15018,-5,13523158,179272,778400,4265,12744758,175007
2020-09-20,Colorado,08,65248,554,2023,1,832709,7007,64857,501,767852,6506
2020-09-20,Connecticut,09,55527,0,4492,0,1422148,0,55527,0,1366621,0
2020-09-20,Delaware,10,19566,117,621,0,271421,1710,19566,117,251855,1593
2020-09-20,District of Columbia,11,14955,53,620,1,355144,4267,14955,53,340189,4214
2020-09-20,Florida,12,683746,2521,13295,9,5087026,26511,675691,2497,4411335,24014
2020-09-20,Georgia,13,289096,1037,6453,3,2750822,15433,306155,1134,2444667,14299
2020-09-20,Guam,66,3043,0,35,0,45958,0,2117,0,43841,0
2020-09-20,Hawaii,15,11534,77,119,0,280008,109,11485,109,268523,0
2020-09-20,Idaho,16,37768,144,443,2,289928,1733,37247,288,252681,1445
2020-09-20,Illinois,17,277373,1316,8700,12,5107351,48011,276456,1402,4830895,46609
2020-09-20,Indiana,18,113728,746,3506,3,1301940,9325,111505,746,1190435,8579
2020-09-20,Iowa,19,80410,625,1265,0,718279,4504,77679,621,640600,3883
2020-09-20,Kansas,20,53433,13,597,1,474749,0,52285,0,422464,0
2020-09-20,Kentucky,21,65413,345,1139,2,1055212,436,61542,436,993670,0
2020-09-20,Louisiana,22,162258,936,5366,26,2178999,32013,162258,936,2016741,31077
2020-09-20,Maine,23,5079,44,139,0,374138,2951,5079,44,369059,2907
2020-09-20,Maryland,24,120656,549,3879,3,1529476,10672,120156,412,1409320,10260
2020-09-20,Massachusetts,25,127540,359,9310,15,2087281,17418,127540,359,1959741,17059
2020-09-20,Michigan,26,128148,36,6971,1,3318469,0,128087,0,3190382,0
2020-09-20,Minnesota,27,90069,1296,2017,2,1303475,12080,90017,1296,1213458,10784
2020-09-20,Mississippi,28,93364,277,2810,1,703163,277,93364,277,609799,0
2020-09-20,Missouri,29,115000,1206,1896,-9,1212508,9884,112844,1328,1099664,8556
2020-09-20,Montana,30,10325,132,157,1,302813,1973,10299,136,292514,1837
2020-09-20,Nebraska,31,41083,286,457,0,423360,3365,40797,410,382563,2955
2020-09-20,Nevada,32,75914,390,1532,4,665184,4498,75804,385,589380,4113
2020-09-20,New Hampshire,33,7947,27,438,0,240401,1669,7947,27,232454,1642
2020-09-20,New Jersey,34,201553,453,16067,3,3352791,60414,199762,453,3153029,59961
2020-09-20,New Mexico,35,27579,67,849,2,862899,5443,27579,67,835320,5376
2020-09-20,New York,36,454612,865,32686,7,9922446,100355,449900,862,9472546,99493
2020-09-20,North Carolina,37,193978,1227,3270,10,2804818,33798,193581,1333,2611237,32465
2020-09-20,North Dakota,38,17961,351,195,0,228255,1753,17958,351,210297,1402
2020-09-20,Northern Mariana Islands,69,68,0,2,0,14384,6,68,6,14316,0
2020-09-20,Ohio,39,144309,762,4615,3,2825297,36602,144309,762,2680988,35840
2020-09-20,Oklahoma,40,76807,1003,946,3,1072504,1003,76807,1003,995697,0
2020-09-20,Oregon,41,30802,202,528,1,636069,2159,30801,202,605268,1957
2020-09-20,Pennsylvania,42,154924,663,8049,21,1908910,12785,150578,733,1758332,12052
2020-09-20,Puerto Rico,72,41838,845,608,3,326041,262,20069,262,305972,0
2020-09-20,Rhode Island,44,23620,0,1088,0,319803,1787,23880,82,295923,1705
2020-09-20,South Carolina,45,137708,468,3199,11,1132595,9330,137708,468,994887,8862
2020-09-20,South Dakota,46,18696,252,202,2,176353,1132,18696,252,157657,880
2020-09-20,Tennessee,47,180621,1604,2195,2,2667126,40039,183514,2075,2483612,37964
2020-09-20,Texas,48,722460,5546,15159,35,5593488,30312,688534,2466,4904954,27846
2020-09-20,Utah,49,63774,881,440,0,752105,5968,63772,920,688333,5048
2020-09-20,Vermont,50,1715,5,58,0,155895,1095,1715,5,154180,1090
2020-09-20,Virgin Islands,78,1269,12,19,0,19312,358,1269,27,18043,331
2020-09-20,Virginia,51,140511,856,3015,25,1888817,15462,140511,856,1748306,14606
2020-09-20,Washington,53,86169,283,2130,0,1723040,18370,82199,597,1640841,17773
2020-09-20,West Virginia,54,14054,180,310,2,514304,4818,14054,180,500250,4638
2020-09-20,Wisconsin,55,107343,1734,1250,1,1439394,8390,107292,1735,1332102,6655
2020-09-20,Wyoming,56,4871,91,49,0,92431,91,4871,91,87560,0
2020-09-21,Alabama,01,145780,818,2439,2,1073892,5564,145780,818,928112,4746
2020-09-21,Alaska,02,7775,71,42,0,428645,1720,6930,70,421715,1650
2020-09-21,Arizona,04,214251,233,5482,2,1390962,7038,214251,233,1176711,6805
2020-09-21,Arkansas,05,76364,641,1197,16,893602,7585,76364,641,817238,6944
2020-09-21,California,06,792217,4140,15069,51,13672782,149624,781694,3294,12891088,146330
2020-09-21,Colorado,08,65936,688,2031,8,838884,6175,65399,542,773485,5633
2020-09-21,Connecticut,09,56024,497,4495,3,1467766,45618,56024,497,1411742,45121
2020-09-21,Delaware,10,19667,101,627,6,273213,1792,19667,101,253546,1691
2020-09-21,District of Columbia,11,14978,23,621,1,357744,2600,14978,23,342766,2577
2020-09-21,Florida,12,685431,1685,13316,21,5105183,18157,677362,1671,4427821,16486
2020-09-21,Georgia,13,289975,879,6455,2,2770863,20041,307339,1184,2463524,18857
2020-09-21,Guam,66,3116,73,36,1,46354,396,2147,30,44207,366
2020-09-21,Hawaii,15,11590,56,119,0,281577,1569,11562,77,270015,1492
2020-09-21,Idaho,16,38196,428,447,4,292286,2358,37491,244,254795,2114
2020-09-21,Illinois,17,279032,1659,8717,17,5145585,38234,277933,1477,4867652,36757
2020-09-21,Indiana,18,114251,523,3512,6,1308645,6705,112027,522,1196618,6183
2020-09-21,Iowa,19,81006,596,1284,19,721595,3316,78339,660,643256,2656
2020-09-21,Kansas,20,54956,1523,604,7,484691,9942,53959,1674,430732,8268
2020-09-21,Kentucky,21,65905,492,1141,2,1065404,10192,61917,375,1003487,9817
2020-09-21,Louisiana,22,162501,243,5375,9,2185792,6793,162501,243,2023291,6550
2020-09-21,Maine,23,5106,27,140,1,375392,1254,5106,27,370286,1227
2020-09-21,Maryland,24,121068,412,3883,4,1537629,8153,120568,412,1417061,7741
2020-09-21,Massachusetts,25,127796,256,9317,7,2098116,10835,127796,256,1970320,10579
2020-09-21,Michigan,26,129655,1507,6982,11,3370667,52198,129662,1575,3241005,50623
2020-09-21,Minnesota,27,90994,925,2021,4,1312937,9462,90942,925,1221995,8537
2020-09-21,Mississippi,28,93556,192,2810,0,706906,3743,93556,192,613350,3551
2020-09-21,Missouri,29,116814,1814,1936,40,1219559,7051,114307,1463,1105252,5588
2020-09-21,Montana,30,10509,184,160,3,311262,8449,10429,130,300833,8319
2020-09-21,Nebraska,31,41388,305,464,7,425816,2456,41083,286,384733,2170
2020-09-21,Nevada,32,76119,205,1531,-1,666792,1608,76036,232,590756,1376
2020-09-21,New Hampshire,33,7952,5,438,0,242242,1841,7952,5,234290,1836
2020-09-21,New Jersey,34,201945,392,16069,2,3353183,392,200154,392,3153029,0
2020-09-21,New Mexico,35,27683,104,851,2,866683,3784,27683,104,839000,3680
2020-09-21,New York,36,455187,575,32691,5,9980765,58319,450473,573,9530292,57746
2020-09-21,North Carolina,37,195093,1115,3283,13,2817539,12721,194381,800,2623158,11921
2020-09-21,North Dakota,38,18247,286,196,1,229511,1256,18244,286,211267,970
2020-09-21,Northern Mariana Islands,69,69,1,2,0,14385,1,69,1,14316,0
2020-09-21,Ohio,39,145165,856,4623,8,2856161,30864,145165,856,2710996,30008
2020-09-21,Oklahoma,40,77908,1101,948,2,1073605,1101,77908,1101,995697,0
2020-09-21,Oregon,41,30999,197,532,4,638798,2729,30995,194,607803,2535
2020-09-21,Pennsylvania,42,155729,805,8080,31,1917993,9083,150812,234,1767181,8849
2020-09-21,Puerto Rico,72,42476,638,609,1,326283,242,20311,242,305972,0
2020-09-21,Rhode Island,44,23932,312,1097,9,320566,763,23932,52,296634,711
2020-09-21,South Carolina,45,138124,416,3212,13,1144118,11523,138124,416,1005994,11107
2020-09-21,South Dakota,46,18869,173,202,0,177023,670,18869,173,158154,497
2020-09-21,Tennessee,47,181725,1104,2209,14,2679406,12280,184409,895,2494997,11385
2020-09-21,Texas,48,744736,22276,15212,53,5622498,29010,698387,9853,4924111,19157
2020-09-21,Utah,49,64404,630,441,1,756090,3985,64394,622,691696,3363
2020-09-21,Vermont,50,1719,4,58,0,156739,844,1719,4,155020,840
2020-09-21,Virgin Islands,78,1269,0,19,0,19312,0,1269,0,18043,0
2020-09-21,Virginia,51,141138,627,3021,6,1905474,16657,141138,627,1764336,16030
2020-09-21,Washington,53,86803,634,2137,7,1736556,13516,82548,349,1654008,13167
2020-09-21,West Virginia,54,14171,117,312,2,519516,5212,14171,117,505345,5095
2020-09-21,Wisconsin,55,108656,1313,1253,3,1446215,6821,108588,1296,1337627,5525
2020-09-21,Wyoming,56,4944,73,49,0,94131,1700,4944,73,89187,1627
2020-09-22,Alabama,01,146584,804,2457,18,1080149,6257,146584,804,933565,5453
2020-09-22,Alaska,02,7821,46,42,0,431191,2546,6987,57,424204,2489
2020-09-22,Arizona,04,214846,595,5501,19,1400654,9692,214846,595,1185808,9097
2020-09-22,Arkansas,05,76981,617,1209,12,900206,6604,76981,617,823225,5987
2020-09-22,California,06,795077,2860,15209,140,13804055,131273,784324,2630,13019731,128643
2020-09-22,Colorado,08,66552,616,2034,3,845111,6227,66053,654,779058,5573
2020-09-22,Connecticut,09,56160,136,4496,1,1479824,12058,56160,136,1423664,11922
2020-09-22,Delaware,10,19761,94,628,1,274837,1624,19761,94,255076,1530
2020-09-22,District of Columbia,11,15021,43,621,0,361633,3889,15021,43,346612,3846
2020-09-22,Florida,12,687901,2470,13415,99,5124209,19026,679776,2414,4444433,16612
2020-09-22,Georgia,13,290930,955,6524,69,2783427,12564,308221,882,2475206,11682
2020-09-22,Guam,66,3159,43,38,2,46828,474,2190,43,44638,431
2020-09-22,Hawaii,15,11653,63,119,0,282739,1162,11618,56,271121,1106
2020-09-22,Idaho,16,38676,480,452,5,294071,1785,37901,410,256170,1375
2020-09-22,Illinois,17,280511,1479,8741,24,5187414,41829,279464,1531,4907950,40298
2020-09-22,Indiana,18,114864,613,3520,8,1315440,6795,112626,599,1202814,6196
2020-09-22,Iowa,19,81674,668,1293,9,725082,3487,78887,548,646195,2939
2020-09-22,Kansas,20,55237,281,618,14,484691,0,53959,0,430732,0
2020-09-22,Kentucky,21,66624,719,1148,7,1075620,10216,62731,814,1012889,9402
2020-09-22,Louisiana,22,163253,752,5386,11,2206974,21182,163253,752,2043721,20430
2020-09-22,Maine,23,5146,40,140,0,375432,40,5146,40,370286,0
2020-09-22,Maryland,24,121409,341,3895,12,1544014,6385,120912,344,1423102,6041
2020-09-22,Massachusetts,25,127969,173,9328,11,2107281,9165,127969,173,1979312,8992
2020-09-22,Michigan,26,130406,751,6998,16,3390878,20211,130357,695,3260521,19516
2020-09-22,Minnesota,27,91474,480,2031,10,1317433,4496,91422,480,1226011,4016
2020-09-22,Mississippi,28,94021,465,2846,36,712501,5595,94021,465,618480,5130
2020-09-22,Missouri,29,118574,1760,1974,38,1241749,22190,115366,1059,1126383,21131
2020-09-22,Montana,30,10792,283,163,3,314009,2747,10700,271,303309,2476
2020-09-22,Nebraska,31,41828,440,473,9,428046,2230,41388,305,386658,1925
2020-09-22,Nevada,32,76376,257,1546,15,669074,2282,76298,262,592776,2020
2020-09-22,New Hampshire,33,7990,38,438,0,243527,1285,7990,38,235537,1247
2020-09-22,New Jersey,34,202371,426,16076,7,3397649,44466,200580,426,3197069,44040
2020-09-22,New Mexico,35,27790,107,854,3,872331,5648,27790,107,844541,5541
2020-09-22,New York,36,455938,751,32690,-1,10064762,83997,451227,754,9613535,83243
2020-09-22,North Carolina,37,196258,1165,3320,37,2824929,7390,195549,1168,2629380,6222
2020-09-22,North Dakota,38,18511,264,199,3,230070,559,18508,264,211562,295
2020-09-22,Northern Mariana Islands,69,69,0,2,0,14385,0,69,0,14316,0
2020-09-22,Ohio,39,145850,685,4635,12,2888787,32626,145850,685,2742937,31941
2020-09-22,Oklahoma,40,79072,1164,962,14,1101839,28234,79072,1164,1022767,27070
2020-09-22,Oregon,41,31323,324,535,3,642581,3783,31313,318,611268,3465
2020-09-22,Pennsylvania,42,156512,783,8099,19,1929562,11569,151646,834,1777916,10735
2020-09-22,Puerto Rico,72,42596,120,613,4,326371,88,20399,88,305972,0
2020-09-22,Rhode Island,44,24044,112,1099,2,322391,1825,24044,112,298347,1713
2020-09-22,South Carolina,45,140789,2665,3243,31,1172484,28366,140789,2665,1031695,25701
2020-09-22,South Dakota,46,19189,320,202,0,178346,1323,19189,320,159157,1003
2020-09-22,Tennessee,47,182546,821,2236,27,2691404,11998,185148,739,2506256,11259
2020-09-22,Texas,48,749069,4333,15322,110,5667732,45234,716207,17820,4951525,27414
2020-09-22,Utah,49,65058,654,443,2,762359,6269,65044,650,697315,5619
2020-09-22,Vermont,50,1721,2,58,0,157341,602,1721,2,155620,600
2020-09-22,Virgin Islands,78,1278,9,19,0,19464,152,1276,7,18188,145
2020-09-22,Virginia,51,142010,872,3060,39,1918489,13015,142010,872,1776479,12143
2020-09-22,Washington,53,87233,430,2163,26,1740899,4343,83193,645,1657706,3698
2020-09-22,West Virginia,54,14384,213,317,5,522669,3153,14384,213,508285,2940
2020-09-22,Wisconsin,55,110393,1737,1259,6,1458819,12604,110327,1739,1348492,10865
2020-09-22,Wyoming,56,5016,72,49,0,94840,709,5016,72,89824,637
2020-09-23,Alabama,01,147153,569,2488,31,1085604,5455,147153,569,938451,4886
2020-09-23,Alaska,02,7875,54,42,0,433198,2007,7063,76,426135,1931
2020-09-23,Arizona,04,215284,438,5526,25,1409866,9212,215284,438,1194582,8774
2020-09-23,Arkansas,05,77963,982,1229,20,909264,9058,77963,982,831301,8076
2020-09-23,California,06,798350,3273,15313,104,13879423,75368,787470,3146,13091953,72222
2020-09-23,Colorado,08,67186,634,2038,4,853592,8481,66669,616,786923,7865
2020-09-23,Connecticut,09,56315,155,4497,1,1489898,10074,56315,155,1433583,9919
2020-09-23,Delaware,10,19830,69,629,1,276044,1207,19830,69,256214,1138
2020-09-23,District of Columbia,11,15050,29,621,0,363448,1815,15050,29,348398,1786
2020-09-23,Florida,12,690491,2590,13617,202,5147851,23642,682370,2594,4465481,21048
2020-09-23,Georgia,13,292797,1867,6620,96,2803215,19788,309678,1457,2493537,18331
2020-09-23,Guam,66,3204,45,38,0,47251,423,2235,45,45016,378
2020-09-23,Hawaii,15,11820,167,121,2,284228,1489,11681,63,272547,1426
2020-09-23,Idaho,16,39030,354,454,2,295401,1330,38347,446,257054,884
2020-09-23,Illinois,17,282331,1820,8762,21,5233805,46391,281312,1848,4952493,44543
2020-09-23,Indiana,18,115578,714,3530,10,1322819,7379,113337,711,1209482,6668
2020-09-23,Iowa,19,82956,1282,1298,5,731853,6771,79923,1036,651930,5735
2020-09-23,Kansas,20,56355,1118,629,11,492281,7590,55226,1267,437055,6323
2020-09-23,Kentucky,21,67590,966,1161,13,1224142,148522,63517,786,1160625,147736
2020-09-23,Louisiana,22,163869,616,5407,21,2220009,13035,163869,616,2056140,12419
2020-09-23,Maine,23,5171,25,140,0,386035,10603,5171,25,380864,10578
2020-09-23,Maryland,24,121793,384,3902,7,1552105,8091,121297,385,1430808,7706
2020-09-23,Massachusetts,25,128512,543,9347,19,2127944,20663,128512,543,1999432,20120
2020-09-23,Michigan,26,131292,886,7013,15,3425107,34229,131259,902,3293848,33327
2020-09-23,Minnesota,27,92152,678,2037,6,1323951,6518,92100,678,1231851,5840
2020-09-23,Mississippi,28,94573,552,2870,24,716711,4210,94573,552,622138,3658
2020-09-23,Missouri,29,120124,1550,2035,61,1244563,2814,116946,1580,1127617,1234
2020-09-23,Montana,30,11034,242,165,2,317160,3151,10912,212,306248,2939
2020-09-23,Nebraska,31,42278,450,477,4,431102,3056,41785,397,389317,2659
2020-09-23,Nevada,32,76907,531,1556,10,671924,2850,76807,509,595117,2341
2020-09-23,New Hampshire,33,8007,17,438,0,244489,962,8007,17,236482,945
2020-09-23,New Jersey,34,202779,408,16082,6,3422747,25098,200988,408,3221759,24690
2020-09-23,New Mexico,35,27987,197,857,3,878406,6075,27987,197,850419,5878
2020-09-23,New York,36,456604,666,32691,1,10135692,70930,451892,665,9683800,70265
2020-09-23,North Carolina,37,197431,1173,3345,25,2842427,17498,196501,952,2645926,16546
2020-09-23,North Dakota,38,18984,473,206,7,231852,1782,18981,473,212871,1309
2020-09-23,Northern Mariana Islands,69,69,0,2,0,14845,460,69,0,14776,460
2020-09-23,Ohio,39,146753,903,4687,52,2931199,42412,146753,903,2784446,41509
2020-09-23,Oklahoma,40,80161,1089,970,8,1114326,12487,80161,1089,1034165,11398
2020-09-23,Oregon,41,31513,190,538,3,646125,3544,31503,190,614622,3354
2020-09-23,Pennsylvania,42,157373,861,8137,38,1942956,13394,152544,898,1790412,12496
2020-09-23,Puerto Rico,72,42660,64,617,4,326411,40,20439,40,305972,0
2020-09-23,Rhode Island,44,24177,133,1102,3,325120,2729,24177,133,300943,2596
2020-09-23,South Carolina,45,141686,897,3262,19,1190584,18100,141686,897,1048898,17203
2020-09-23,South Dakota,46,19634,445,202,0,180132,1786,19634,445,160498,1341
2020-09-23,Tennessee,47,184068,1522,2252,16,2713343,21939,186709,1561,2526634,20378
2020-09-23,Texas,48,753551,4482,15455,133,5740674,72942,719599,3392,5021075,69550
2020-09-23,Utah,49,65948,890,444,1,769910,7551,65921,877,703989,6674
2020-09-23,Vermont,50,1722,1,58,0,157263,-78,1722,1,155541,-79
2020-09-23,Virgin Islands,78,1290,12,19,0,19618,154,1278,2,18340,152
2020-09-23,Virginia,51,142590,580,3089,29,1929570,11081,142590,580,1786980,10501
2020-09-23,Washington,53,88042,809,2175,12,1740899,0,83193,0,1657706,0
2020-09-23,West Virginia,54,14504,120,319,2,525580,2911,14504,120,511076,2791
2020-09-23,Wisconsin,55,112276,1883,1269,10,1472405,13586,112222,1895,1360183,11691
2020-09-23,Wyoming,56,5169,153,50,1,94993,153,5169,153,89824,0
2020-09-24,Alabama,01,148206,1053,2506,18,1092953,7349,148206,1053,944747,6296
2020-09-24,Alaska,02,8015,140,43,1,433198,0,7194,131,426004,-131
2020-09-24,Arizona,04,215852,568,5560,34,1420417,10551,215852,568,1204565,9983
2020-09-24,Arkansas,05,79049,1086,1246,17,919786,10522,79049,1086,840737,9436
2020-09-24,California,06,801671,3321,15389,76,13952857,73434,790640,3170,13162217,70264
2020-09-24,Colorado,08,67745,559,2042,4,862805,9213,67217,548,795588,8665
2020-09-24,Connecticut,09,56472,157,4499,2,1505473,15575,56472,157,1449001,15418
2020-09-24,Delaware,10,19947,117,630,1,277916,1872,19947,117,257969,1755
2020-09-24,District of Columbia,11,15106,56,621,0,367867,4419,15106,56,352761,4363
2020-09-24,Florida,12,693032,2541,13794,177,5171306,23455,684847,2477,4486459,20978
2020-09-24,Georgia,13,294334,1537,6667,47,2824816,21601,311046,1368,2513770,20233
2020-09-24,Guam,66,3232,28,39,1,47687,436,2263,28,45424,408
2020-09-24,Hawaii,15,11908,88,123,2,286944,2716,11848,167,275096,2549
2020-09-24,Idaho,16,39547,517,458,4,297443,2042,38743,396,258700,1646
2020-09-24,Illinois,17,284620,2289,8793,31,5295876,62071,283569,2257,5012307,59814
2020-09-24,Indiana,18,116481,903,3548,18,1331608,8789,114236,899,1217372,7890
2020-09-24,Iowa,19,83993,1037,1303,5,738580,6727,81071,1148,657509,5579
2020-09-24,Kansas,20,56461,106,633,4,492281,0,55226,0,437055,0
2020-09-24,Kentucky,21,68230,640,1166,5,1233935,9793,64158,641,1169777,9152
2020-09-24,Louisiana,22,164446,577,5423,16,2237534,17525,164446,577,2073088,16948
2020-09-24,Maine,23,5215,44,140,0,399966,13931,5215,44,394751,13887
2020-09-24,Maryland,24,122293,500,3909,7,1561579,9474,121800,503,1439779,8971
2020-09-24,Massachusetts,25,128993,481,9362,15,2146526,18582,128993,481,2017533,18101
2020-09-24,Michigan,26,132400,1108,7020,7,3462824,37717,132337,1078,3330487,36639
2020-09-24,Minnesota,27,93064,912,2040,3,1336851,12900,93012,912,1243839,11988
2020-09-24,Mississippi,28,95310,737,2874,4,721759,5048,95310,737,626449,4311
2020-09-24,Missouri,29,121485,1361,2055,20,1259531,14968,118311,1365,1141220,13603
2020-09-24,Montana,30,11381,347,165,0,321518,4358,11242,330,310276,4028
2020-09-24,Nebraska,31,42731,453,478,1,434369,3267,42278,493,392091,2774
2020-09-24,Nevada,32,77338,431,1565,9,675488,3564,77197,390,598291,3174
2020-09-24,New Hampshire,33,8044,37,438,0,247151,2662,8044,37,239107,2625
2020-09-24,New Jersey,34,203343,564,16091,9,3451804,29057,201552,564,3250252,28493
2020-09-24,New Mexico,35,28224,237,859,2,885373,6967,28224,237,857149,6730
2020-09-24,New York,36,457557,953,32696,5,10228645,92953,452847,955,9775798,91998
2020-09-24,North Carolina,37,199236,1805,3380,35,2870191,27764,198189,1688,2672002,26076
2020-09-24,North Dakota,38,19454,470,215,9,233113,1261,19451,470,213662,791
2020-09-24,Northern Mariana Islands,69,69,0,2,0,14845,0,69,0,14776,0
2020-09-24,Ohio,39,147744,991,4715,28,2955715,24516,147744,991,2807971,23525
2020-09-24,Oklahoma,40,81244,1083,981,11,1126926,12600,81244,1083,1045682,11517
2020-09-24,Oregon,41,31869,356,540,2,650498,4373,31865,362,618633,4011
2020-09-24,Pennsylvania,42,158221,848,8150,13,1956867,13911,153397,853,1803470,13058
2020-09-24,Puerto Rico,72,43842,1182,627,10,327128,717,21156,717,305972,0
2020-09-24,Rhode Island,44,24311,134,1106,4,327583,2463,24311,134,303272,2329
2020-09-24,South Carolina,45,142707,1021,3279,17,1207106,16522,142707,1021,1064399,15501
2020-09-24,South Dakota,46,20097,463,210,8,181661,1529,20097,463,161564,1066
2020-09-24,Tennessee,47,185121,1053,2287,35,2729388,16045,187544,835,2541844,15210
2020-09-24,Texas,48,758379,4828,15587,132,5860833,120159,723919,4320,5136914,115839
2020-09-24,Utah,49,67167,1219,444,0,778412,8502,67119,1198,711293,7304
2020-09-24,Vermont,50,1724,2,58,0,158189,926,1724,2,156465,924
2020-09-24,Virgin Islands,78,1290,0,19,0,19824,206,1290,12,18534,194
2020-09-24,Virginia,51,143492,902,3113,24,1960009,30439,143492,902,1816517,29537
2020-09-24,Washington,53,88597,555,2175,0,1743296,2397,83702,509,1659594,1888
2020-09-24,West Virginia,54,14706,202,325,6,529025,3445,14706,202,514319,3243
2020-09-24,Wisconsin,55,114743,2467,1275,6,1485770,13365,114700,2478,1371070,10887
2020-09-24,Wyoming,56,5305,136,50,0,96640,1647,5305,136,91335,1511
2020-09-25,Alabama,01,150658,2452,2491,-15,1114022,21069,150658,2452,963364,18617
2020-09-25,Alaska,02,8133,118,48,5,441332,8134,7320,126,434012,8008
2020-09-25,Arizona,04,216367,515,5588,28,1428024,7607,216367,515,1211657,7092
2020-09-25,Arkansas,05,79946,897,1266,20,928768,8982,79946,897,848822,8085
2020-09-25,California,06,805733,4062,15533,144,14052247,99390,794040,3400,13258207,95990
2020-09-25,Colorado,08,68506,761,2045,3,872732,9927,67926,709,804806,9218
2020-09-25,Connecticut,09,56587,115,4501,2,1519151,13678,56587,115,1462564,13563
2020-09-25,Delaware,10,20085,138,631,1,279374,1458,20085,138,259289,1320
2020-09-25,District of Columbia,11,15163,57,623,2,373586,5719,15163,57,358423,5662
2020-09-25,Florida,12,695879,2847,13914,120,5197763,26457,687656,2809,4510107,23648
2020-09-25,Georgia,13,296089,1755,6717,50,2847494,22678,312514,1468,2534980,21210
2020-09-25,Guam,66,3255,23,40,1,48256,569,2286,23,45970,546
2020-09-25,Hawaii,15,12039,131,126,3,287034,90,11938,90,275096,0
2020-09-25,Idaho,16,40228,681,458,0,299882,2439,39234,491,260648,1948
2020-09-25,Illinois,17,287375,2755,8826,33,5365960,70084,286374,2805,5079586,67279
2020-09-25,Indiana,18,117656,1175,3566,18,1341462,9854,115407,1171,1226055,8683
2020-09-25,Iowa,19,85031,1038,1312,9,744981,6401,82045,974,662936,5427
2020-09-25,Kansas,20,57852,1391,634,1,502770,10489,56592,1366,446178,9123
2020-09-25,Kentucky,21,69150,920,1179,13,1252328,18393,65066,908,1187262,17485
2020-09-25,Louisiana,22,165152,706,5444,21,2256065,18531,165152,706,2090913,17825
2020-09-25,Maine,23,5235,20,140,0,406394,6428,5235,20,401159,6408
2020-09-25,Maryland,24,122850,557,3917,8,1572484,10905,122359,559,1450125,10346
2020-09-25,Massachusetts,25,129481,488,9373,11,2162414,15888,129481,488,2032933,15400
2020-09-25,Michigan,26,133443,1043,7028,8,3502312,39488,133377,1040,3368935,38448
2020-09-25,Minnesota,27,94241,1177,2046,6,1351156,14305,94189,1177,1256967,13128
2020-09-25,Mississippi,28,96032,722,2894,20,726386,4627,96032,722,630354,3905
2020-09-25,Missouri,29,123544,2059,2075,20,1273165,13634,120298,1987,1152867,11647
2020-09-25,Montana,30,11656,275,170,5,326116,4598,11564,322,314552,4276
2020-09-25,Nebraska,31,43162,431,483,5,437304,2935,42731,453,394573,2482
2020-09-25,Nevada,32,77930,592,1573,8,681336,5848,77753,556,603583,5292
2020-09-25,New Hampshire,33,8085,41,438,0,247151,0,8044,0,239107,0
2020-09-25,New Jersey,34,203891,548,16097,6,3478711,26907,202100,548,3276611,26359
2020-09-25,New Mexico,35,28487,263,865,6,893489,8116,28487,263,865002,7853
2020-09-25,New York,36,458466,909,32708,12,10323463,94818,453755,908,9869708,93910
2020-09-25,North Carolina,37,204658,5422,3427,47,2907617,37426,204331,6142,2703286,31284
2020-09-25,North Dakota,38,19888,434,222,7,234634,1521,19885,434,214749,1087
2020-09-25,Northern Mariana Islands,69,69,0,2,0,14845,0,69,0,14776,0
2020-09-25,Ohio,39,148894,1150,4734,19,2995593,39878,148894,1150,2846699,38728
2020-09-25,Oklahoma,40,82520,1276,993,12,1140664,13738,82520,1276,1058144,12462
2020-09-25,Oregon,41,32328,459,545,5,662906,12408,32314,449,630592,11959
2020-09-25,Pennsylvania,42,159051,830,8157,7,1970600,13733,154203,806,1816397,12927
2020-09-25,Puerto Rico,72,44905,1063,635,8,327840,712,21868,712,305972,0
2020-09-25,Rhode Island,44,24181,-130,1107,1,330034,2451,24181,-130,305853,2581
2020-09-25,South Carolina,45,143902,1195,3297,18,1226467,19361,143902,1195,1082565,18166
2020-09-25,South Dakota,46,20554,457,216,6,183947,2286,20554,457,163393,1829
2020-09-25,Tennessee,47,186769,1648,2326,39,2762845,33457,189454,1910,2573391,31547
2020-09-25,Texas,48,761644,3265,15637,50,5913449,52616,728552,4633,5184897,47983
2020-09-25,Utah,49,68537,1370,448,4,785727,7315,68530,1411,717197,5904
2020-09-25,Vermont,50,1731,7,58,0,159279,1090,1731,7,157548,1083
2020-09-25,Virgin Islands,78,1296,6,19,0,19972,148,1296,6,18676,142
2020-09-25,Virginia,51,144433,941,3136,23,1980649,20640,144433,941,1836216,19699
2020-09-25,Washington,53,89149,552,2193,18,1783279,39983,84238,536,1699041,39447
2020-09-25,West Virginia,54,14953,247,330,5,535394,6369,14953,247,520441,6122
2020-09-25,Wisconsin,55,117355,2612,1285,10,1500974,15204,117329,2629,1383645,12575
2020-09-25,Wyoming,56,5420,115,50,0,97826,1186,5420,115,92406,1071
2020-09-26,Alabama,01,151591,933,2501,10,1121639,7617,151591,933,970048,6684
2020-09-26,Alaska,02,8244,111,48,0,442869,1537,7439,119,435430,1418
2020-09-26,Arizona,04,216826,459,5623,35,1438677,10653,216826,459,1221851,10194
2020-09-26,Arkansas,05,80755,809,1285,19,936390,7622,80755,809,855635,6813
2020-09-26,California,06,809214,3481,15588,55,14182730,130483,798237,4197,13384493,126286
2020-09-26,Colorado,08,68973,467,2047,2,882842,10110,68510,584,814332,9526
2020-09-26,Connecticut,09,56587,0,4501,0,1519151,0,56587,0,1462564,0
2020-09-26,Delaware,10,20156,71,633,2,280399,1025,20156,71,260243,954
2020-09-26,District of Columbia,11,15215,52,624,1,377979,4393,15215,52,362764,4341
2020-09-26,Florida,12,698674,2795,14021,107,5226712,28949,690387,2731,4536325,26218
2020-09-26,Georgia,13,297553,1464,6758,41,2872355,24861,313873,1359,2558482,23502
2020-09-26,Guam,66,3255,0,40,0,48719,463,2354,68,46365,395
2020-09-26,Hawaii,15,12166,127,130,4,290146,3112,12070,132,278076,2980
2020-09-26,Idaho,16,40411,183,460,2,302177,2295,39757,523,262420,1772
2020-09-26,Illinois,17,289683,2308,8847,21,5431177,65217,288815,2441,5142362,62776
2020-09-26,Indiana,18,118819,1163,3577,11,1350390,8928,116549,1142,1233841,7786
2020-09-26,Iowa,19,85908,877,1314,2,750898,5917,82944,899,667954,5018
2020-09-26,Kansas,20,57852,0,634,0,502770,0,56592,0,446178,0
2020-09-26,Kentucky,21,70038,888,1185,6,1282596,30268,66036,970,1216560,29298
2020-09-26,Louisiana,22,165152,0,5444,0,2256065,0,165152,0,2090913,0
2020-09-26,Maine,23,5260,25,140,0,406419,25,5260,25,401159,0
2020-09-26,Maryland,24,123328,478,3925,8,1584300,11816,122972,613,1461328,11203
2020-09-26,Massachusetts,25,130050,569,9391,18,2176778,14364,130050,569,2046728,13795
2020-09-26,Michigan,26,134372,929,7044,16,3543057,40745,134373,996,3408684,39749
2020-09-26,Minnesota,27,95711,1470,2056,10,1368682,17526,95659,1470,1273023,16056
2020-09-26,Mississippi,28,96677,645,2911,17,730713,4327,96677,645,634036,3682
2020-09-26,Missouri,29,124939,1395,2118,43,1289169,16004,122014,1716,1167155,14288
2020-09-26,Montana,30,11943,287,171,1,329285,3169,11907,343,317378,2826
2020-09-26,Nebraska,31,43596,434,484,1,440645,3341,43162,431,397483,2910
2020-09-26,Nevada,32,78464,534,1583,10,685678,4342,78355,602,607323,3740
2020-09-26,New Hampshire,33,8121,36,439,1,265378,18227,8121,77,257257,18150
2020-09-26,New Jersey,34,204641,750,16103,6,3512568,33857,202850,750,3309718,33107
2020-09-26,New Mexico,35,28692,205,870,5,899937,6448,28692,205,871245,6243
2020-09-26,New York,36,459472,1006,32713,5,10423416,99953,454760,1005,9968656,98948
2020-09-26,North Carolina,37,206241,1583,3458,31,2947803,40186,206090,1759,2741713,38427
2020-09-26,North Dakota,38,20383,495,230,8,236229,1595,20380,495,215849,1100
2020-09-26,Northern Mariana Islands,69,69,0,2,0,14845,0,69,0,14776,0
2020-09-26,Ohio,39,150009,1115,4740,6,3033987,38394,150009,1115,2883978,37279
2020-09-26,Oklahoma,40,83510,990,1004,11,1158985,18321,83510,990,1075475,17331
2020-09-26,Oregon,41,32581,253,549,4,668671,5765,32581,267,636090,5498
2020-09-26,Pennsylvania,42,159937,886,8177,20,1985524,14924,155232,1029,1830292,13895
2020-09-26,Puerto Rico,72,45413,508,642,7,328136,296,22164,296,305972,0
2020-09-26,Rhode Island,44,24181,0,1107,0,333148,3114,24284,103,308864,3011
2020-09-26,South Carolina,45,145273,1371,3323,26,1242797,16330,145273,1371,1097524,14959
2020-09-26,South Dakota,46,21133,579,218,2,186134,2187,21133,579,165001,1608
2020-09-26,Tennessee,47,188205,1436,2347,21,2789879,27034,190891,1437,2598988,25597
2020-09-26,Texas,48,764642,2998,15792,155,5994813,81364,733438,4886,5261375,76478
2020-09-26,Utah,49,69556,1019,448,0,794487,8760,69547,1017,724940,7743
2020-09-26,Vermont,50,1739,8,58,0,160276,997,1739,8,158537,989
2020-09-26,Virgin Islands,78,1317,21,19,0,19972,0,1296,0,18676,0
2020-09-26,Virginia,51,145408,975,3144,8,2000579,19930,145408,975,1855171,18955
2020-09-26,Washington,53,89514,365,2196,3,1801021,17742,85226,988,1715795,16754
2020-09-26,West Virginia,54,15158,205,332,2,542291,6897,15158,205,527133,6692
2020-09-26,Wisconsin,55,120249,2894,1291,6,1513643,12669,120231,2902,1393412,9767
2020-09-26,Wyoming,56,5465,45,50,0,97871,45,5465,45,92406,0
2020-09-27,Alabama,01,152321,730,2502,1,1128006,6367,152321,730,975685,5637
2020-09-27,Alaska,02,8359,115,52,4,442869,0,7549,110,435320,-110
2020-09-27,Arizona,04,217237,411,5623,0,1447845,9168,217237,411,1230608,8757
2020-09-27,Arkansas,05,81242,487,1308,23,943134,6744,81242,487,861892,6257
2020-09-27,California,06,811698,2484,15608,20,14333498,150768,802308,4071,13531190,146697
2020-09-27,Colorado,08,69472,499,2048,1,893381,10539,69079,569,824302,9970
2020-09-27,Connecticut,09,56587,0,4501,0,1519151,0,56587,0,1462564,0
2020-09-27,Delaware,10,20260,104,633,0,282024,1625,20260,104,261764,1521
2020-09-27,District of Columbia,11,15250,35,624,0,381159,3180,15250,35,365909,3145
2020-09-27,Florida,12,700556,1882,14031,10,5245111,18399,692234,1847,4552877,16552
2020-09-27,Georgia,13,298321,768,6789,31,2886269,13914,314685,812,2571584,13102
2020-09-27,Guam,66,3255,0,40,0,48719,0,2354,0,46365,0
2020-09-27,Hawaii,15,12264,98,131,1,291836,1690,12197,127,279639,1563
2020-09-27,Idaho,16,40501,90,460,0,304781,2604,40296,539,264485,2065
2020-09-27,Illinois,17,291271,1588,8859,12,5481999,50822,290419,1604,5191580,49218
2020-09-27,Indiana,18,119721,902,3580,3,1358860,8470,117450,901,1241410,7569
2020-09-27,Iowa,19,86624,716,1316,2,754623,3725,83636,692,670987,3033
2020-09-27,Kansas,20,57978,126,636,2,502770,0,56592,0,446178,0
2020-09-27,Kentucky,21,70385,347,1189,4,1283051,455,66491,455,1216560,0
2020-09-27,Louisiana,22,166075,923,5465,21,2283149,27084,166075,923,2117074,26161
2020-09-27,Maine,23,5288,28,140,0,421196,14777,5288,28,415908,14749
2020-09-27,Maryland,24,123895,567,3935,10,1594363,10063,123403,431,1470960,9632
2020-09-27,Massachusetts,25,130642,592,9404,13,2194841,18063,130642,592,2064199,17471
2020-09-27,Michigan,26,134409,37,7044,0,3543057,0,134373,0,3408684,0
2020-09-27,Minnesota,27,96786,1075,2060,4,1384512,15830,96734,1075,1287778,14755
2020-09-27,Mississippi,28,96859,182,2919,8,730895,182,96859,182,634036,0
2020-09-27,Missouri,29,126115,1176,2117,-1,1298106,8937,123406,1392,1174700,7545
2020-09-27,Montana,30,12126,183,173,2,330307,1022,12107,200,318200,822
2020-09-27,Nebraska,31,44063,467,485,1,445129,4484,43596,434,401533,4050
2020-09-27,Nevada,32,78820,356,1585,2,688956,3278,78728,373,610228,2905
2020-09-27,New Hampshire,33,8172,51,439,0,267486,2108,8172,51,259314,2057
2020-09-27,New Jersey,34,205339,698,16106,3,3513266,698,203548,698,3309718,0
2020-09-27,New Mexico,35,28844,152,870,0,905329,5392,28844,152,876485,5240
2020-09-27,New York,36,460340,868,32722,9,10508186,84770,455626,866,10052560,83904
2020-09-27,North Carolina,37,207407,1166,3460,2,2978728,30925,207380,1290,2771348,29635
2020-09-27,North Dakota,38,20727,344,234,4,237618,1389,20724,344,216894,1045
2020-09-27,Northern Mariana Islands,69,69,0,2,0,14846,1,70,1,14776,0
2020-09-27,Ohio,39,150809,800,4741,1,3071187,37200,150809,800,2920378,36400
2020-09-27,Oklahoma,40,84333,823,1006,2,1158985,0,83510,0,1075475,0
2020-09-27,Oregon,41,32820,239,549,0,671490,2819,32820,239,638670,2580
2020-09-27,Pennsylvania,42,160770,833,8180,3,2001220,15696,156150,918,1845070,14778
2020-09-27,Puerto Rico,72,46304,891,644,2,328669,533,22697,533,305972,0
2020-09-27,Rhode Island,44,24181,0,1107,0,335120,1972,24398,114,310722,1858
2020-09-27,South Carolina,45,145887,614,3326,3,1252538,9741,145887,614,1106651,9127
2020-09-27,South Dakota,46,21541,408,218,0,187504,1370,21541,408,165963,962
2020-09-27,Tennessee,47,190037,1832,2350,3,2832536,42657,192995,2104,2639541,40553
2020-09-27,Texas,48,770539,5897,15831,39,6016907,22094,735132,1694,5281775,20400
2020-09-27,Utah,49,70616,1060,453,5,801308,6821,70615,1068,730693,5753
2020-09-27,Vermont,50,1742,3,58,0,160990,714,1742,3,159248,711
2020-09-27,Virgin Islands,78,1317,0,19,0,20160,188,1317,21,18843,167
2020-09-27,Virginia,51,146144,736,3159,15,2010539,9960,146144,736,1864395,9224
2020-09-27,Washington,53,89822,308,2196,0,1820623,19602,85830,604,1734793,18998
2020-09-27,West Virginia,54,15348,190,334,2,549723,7432,15348,190,534375,7242
2020-09-27,Wisconsin,55,122498,2249,1291,0,1521696,8053,122478,2247,1399218,5806
2020-09-27,Wyoming,56,5633,168,50,0,98039,168,5633,168,92406,0
2020-09-28,Alabama,01,152983,662,2501,-1,1133274,5268,152983,662,980291,4606
2020-09-28,Alaska,02,8477,118,52,0,444791,1922,7663,114,437128,1808
2020-09-28,Arizona,04,217513,276,5624,1,1453252,5407,217510,273,1235742,5134
2020-09-28,Arkansas,05,82049,807,1329,21,1000226,57092,82049,807,918177,56285
2020-09-28,California,06,814796,3098,15641,33,14484852,151354,805263,2955,13679589,148399
2020-09-28,Colorado,08,69967,495,2052,4,899874,6493,69490,411,830384,6082
2020-09-28,Connecticut,09,57147,560,4503,2,1571206,52055,57147,560,1514059,51495
2020-09-28,Delaware,10,20389,129,634,1,283815,1791,20389,129,263426,1662
2020-09-28,District of Columbia,11,15264,14,624,0,383048,1889,15264,14,367784,1875
2020-09-28,Florida,12,701294,738,14036,5,5253332,8221,692962,728,4560370,7493
2020-09-28,Georgia,13,298963,642,6803,14,2898498,12229,315281,596,2583217,11633
2020-09-28,Guam,66,3255,0,40,0,49211,492,2390,36,46821,456
2020-09-28,Hawaii,15,12351,87,131,0,293741,1905,12295,98,281446,1807
2020-09-28,Idaho,16,41386,885,460,0,306854,2073,40501,205,266353,1868
2020-09-28,Illinois,17,293169,1898,8877,18,5523141,41142,292128,1709,5231013,39433
2020-09-28,Indiana,18,120581,860,3591,11,1366294,7434,118322,872,1247972,6562
2020-09-28,Iowa,19,87256,632,1324,8,755316,693,84002,366,671314,327
2020-09-28,Kansas,20,59793,1815,641,5,513909,11139,58629,2037,455280,9102
2020-09-28,Kentucky,21,71003,618,1195,6,1301191,18140,66939,448,1234252,17692
2020-09-28,Louisiana,22,166315,240,5480,15,2289618,6469,166315,240,2123303,6229
2020-09-28,Maine,23,5300,12,140,0,423396,2200,5300,12,418096,2188
2020-09-28,Maryland,24,124371,476,3938,3,1603099,8736,123880,477,1479219,8259
2020-09-28,Massachusetts,25,131072,430,9415,11,2207953,13112,131072,430,2076881,12682
2020-09-28,Michigan,26,135782,1373,7052,8,3593990,50933,135702,1329,3458288,49604
2020-09-28,Minnesota,27,97690,904,2067,7,1397865,13353,97638,904,1300227,12449
2020-09-28,Mississippi,28,97049,190,2921,2,735892,4997,97049,190,638843,4807
2020-09-28,Missouri,29,127894,1779,2132,15,1302958,4852,124686,1280,1178272,3572
2020-09-28,Montana,30,12538,412,174,1,337196,6889,12413,306,324783,6583
2020-09-28,Nebraska,31,44578,515,487,2,448361,3232,44063,467,404298,2765
2020-09-28,Nevada,32,79313,493,1586,1,692673,3717,79191,463,613482,3254
2020-09-28,New Hampshire,33,8208,36,439,0,269367,1881,8208,36,261159,1845
2020-09-28,New Jersey,34,205898,559,16107,1,3566304,53038,204107,559,3362197,52479
2020-09-28,New Mexico,35,28985,141,873,3,909505,4176,28985,141,880520,4035
2020-09-28,New York,36,461176,836,32737,15,10561122,52936,456460,834,10104662,52102
2020-09-28,North Carolina,37,208497,1090,3469,9,3004533,25805,208248,868,2796285,24937
2020-09-28,North Dakota,38,20986,259,237,3,238737,1119,20983,259,217754,860
2020-09-28,Northern Mariana Islands,69,69,0,2,0,14846,0,70,0,14776,0
2020-09-28,Ohio,39,151802,993,4746,5,3106176,34989,151802,993,2954374,33996
2020-09-28,Oklahoma,40,85194,861,1007,1,1160669,1684,85194,1684,1075475,0
2020-09-28,Oregon,41,32995,175,549,0,675029,3539,32994,174,642035,3365
2020-09-28,Pennsylvania,42,161642,872,8181,1,2012317,11097,156826,676,1855491,10421
2020-09-28,Puerto Rico,72,47422,1118,648,4,329329,660,23357,660,305972,0
2020-09-28,Rhode Island,44,24424,243,1110,3,335684,564,24424,26,311260,538
2020-09-28,South Carolina,45,146455,568,3337,11,1273928,21390,146455,568,1127473,20822
2020-09-28,South Dakota,46,21738,197,218,0,188344,840,21738,197,166606,643
2020-09-28,Tennessee,47,190991,954,2362,12,2847342,14806,193732,737,2653610,14069
2020-09-28,Texas,48,773679,3140,15898,67,6171755,154848,739743,4611,5432012,150237
2020-09-28,Utah,49,71442,826,453,0,805996,4688,71442,827,734554,3861
2020-09-28,Vermont,50,1745,3,58,0,161925,935,1745,3,160180,932
2020-09-28,Virgin Islands,78,1318,1,20,1,20160,0,1317,0,18843,0
2020-09-28,Virginia,51,146593,449,3172,13,2034617,24078,146593,449,1888024,23629
2020-09-28,Washington,53,90596,774,2199,3,1837206,16583,86269,439,1750937,16144
2020-09-28,West Virginia,54,15512,164,337,3,553270,3547,15512,164,537758,3383
2020-09-28,Wisconsin,55,124320,1822,1293,2,1529594,7898,124217,1739,1405377,6159
2020-09-28,Wyoming,56,5754,121,50,0,100116,2077,5754,121,94362,1956
2020-09-29,Alabama,01,153554,571,2517,16,1136717,3443,153554,571,983163,2872
2020-09-29,Alaska,02,8602,125,52,0,451056,6265,7785,122,443271,6143
2020-09-29,Arizona,04,218185,672,5632,8,1458090,4838,218184,674,1239906,4164
2020-09-29,Arkansas,05,82755,706,1350,21,1010657,10431,82755,706,927902,9725
2020-09-29,California,06,817939,3143,15791,150,14613545,128693,807425,2162,13806120,126531
2020-09-29,Colorado,08,70458,491,2058,6,907152,7278,70025,535,837127,6743
2020-09-29,Connecticut,09,57329,182,4505,2,1581592,10386,57329,182,1524263,10204
2020-09-29,Delaware,10,20531,142,635,1,285488,1673,20531,142,264957,1531
2020-09-29,District of Columbia,11,15300,36,626,2,386396,3348,15300,36,371096,3312
2020-09-29,Florida,12,704560,3266,14142,106,5281719,28387,696171,3209,4585548,25178
2020-09-29,Georgia,13,300019,1056,6836,33,2910833,12335,316306,1025,2594527,11310
2020-09-29,Guam,66,3412,157,48,8,49727,516,2443,53,47284,463
2020-09-29,Hawaii,15,12436,85,133,2,296593,2852,12382,87,284211,2765
2020-09-29,Idaho,16,41854,468,466,6,308542,1688,40923,422,267619,1266
2020-09-29,Illinois,17,294673,1504,8901,24,5568765,45624,293490,1362,5275275,44262
2020-09-29,Indiana,18,121327,746,3612,21,1371355,5061,119066,744,1252289,4317
2020-09-29,Iowa,19,88234,978,1341,17,758388,3072,84476,474,673912,2598
2020-09-29,Kansas,20,59951,158,650,9,513909,0,58629,0,455280,0
2020-09-29,Kentucky,21,71921,918,1205,10,1371241,70050,67856,917,1303385,69133
2020-09-29,Louisiana,22,166848,533,5490,10,2307757,18139,166848,533,2140909,17606
2020-09-29,Maine,23,5337,37,141,1,428054,4658,5337,37,422717,4621
2020-09-29,Maryland,24,124805,434,3946,8,1610310,7211,124311,431,1485999,6780
2020-09-29,Massachusetts,25,131584,512,9423,8,2222139,14186,131584,512,2090555,13674
2020-09-29,Michigan,26,136899,1117,7073,21,3618084,24094,136820,1118,3481264,22976
2020-09-29,Minnesota,27,98499,809,2072,5,1406578,8713,98447,809,1308131,7904
2020-09-29,Mississippi,28,97638,589,2957,36,736481,589,97638,589,638843,0
2020-09-29,Missouri,29,128816,922,2148,16,1303034,76,124762,76,1178272,0
2020-09-29,Montana,30,12825,287,177,3,339926,2730,12724,311,327202,2419
2020-09-29,Nebraska,31,45044,466,493,6,452557,4196,44578,515,407979,3681
2020-09-29,Nevada,32,79691,378,1594,8,695720,3047,79595,404,616125,2643
2020-09-29,New Hampshire,33,8233,25,439,0,270204,837,8233,25,261971,812
2020-09-29,New Jersey,34,206354,456,16117,10,3566760,456,204563,456,3362197,0
2020-09-29,New Mexico,35,29157,172,875,2,914986,5481,29157,172,885829,5309
2020-09-29,New York,36,462364,1188,32743,6,10649353,88231,457649,1189,10191704,87042
2020-09-29,North Carolina,37,209384,887,3511,42,3019586,15053,209137,889,2810449,14164
2020-09-29,North Dakota,38,21404,418,242,5,239848,1111,21401,418,218447,693
2020-09-29,Northern Mariana Islands,69,69,0,2,0,14846,0,70,0,14776,0
2020-09-29,Ohio,39,152907,1105,4783,37,3141377,35201,152907,1105,2988470,34096
2020-09-29,Oklahoma,40,86219,1025,1018,11,1192403,31734,86219,1025,1106184,30709
2020-09-29,Oregon,41,33297,302,555,6,679383,4354,33291,297,646092,4057
2020-09-29,Pennsylvania,42,163219,1577,8196,15,2024575,12258,157814,988,1866761,11270
2020-09-29,Puerto Rico,72,48467,1045,654,6,329773,444,23801,444,305972,0
2020-09-29,Rhode Island,44,24556,132,1113,3,337898,2214,24556,132,313342,2082
2020-09-29,South Carolina,45,147634,1179,3359,22,1300414,26486,147634,1179,1152780,25307
2020-09-29,South Dakota,46,21997,259,223,5,189146,802,21997,259,167149,543
2020-09-29,Tennessee,47,191859,868,2393,31,2860481,13139,194611,879,2665870,12260
2020-09-29,Texas,48,780543,6864,15994,96,6200826,29071,743284,3541,5457542,25530
2020-09-29,Utah,49,72136,694,457,4,812209,6213,72136,694,740073,5519
2020-09-29,Vermont,50,1749,4,58,0,162747,822,1749,4,160998,818
2020-09-29,Virgin Islands,78,1318,0,20,0,20373,213,1318,1,19055,212
2020-09-29,Virginia,51,147516,923,3187,15,2047065,12448,147516,923,1899549,11525
2020-09-29,Washington,53,91011,415,2218,19,1848463,11257,86638,369,1761825,10888
2020-09-29,West Virginia,54,15692,180,345,8,558313,5043,15692,180,542621,4863
2020-09-29,Wisconsin,55,126744,2424,1312,19,1540438,10844,126664,2447,1413774,8397
2020-09-29,Wyoming,56,5821,67,50,0,100543,427,5821,67,94722,360
2020-09-30,Alabama,01,154701,1147,2540,23,1149176,12459,154701,1147,994475,11312
2020-09-30,Alaska,02,8707,105,52,0,457207,6151,7889,104,449318,6047
2020-09-30,Arizona,04,218511,326,5654,22,1462148,4058,218507,323,1243641,3735
2020-09-30,Arkansas,05,83697,942,1369,19,1032804,22147,83697,942,949107,21205
2020-09-30,California,06,821125,3186,15898,107,14705202,91657,810625,3200,13894577,88457
2020-09-30,Colorado,08,71090,632,2061,3,916384,9232,70536,511,845848,8721
2020-09-30,Connecticut,09,57550,221,4508,3,1593993,12401,57550,221,1536443,12180
2020-09-30,Delaware,10,20613,82,636,1,286562,1074,20613,82,265949,992
2020-09-30,District of Columbia,11,15326,26,627,1,387860,1464,15326,26,372534,1438
2020-09-30,Florida,12,706508,1948,14316,174,5292719,11000,698051,1880,4594668,9120
2020-09-30,Georgia,13,301485,1466,6861,25,2933679,22846,318026,1720,2615653,21126
2020-09-30,Guam,66,3457,45,50,2,50114,387,2488,45,47626,342
2020-09-30,Hawaii,15,12555,119,135,2,296680,87,12469,87,284211,0
2020-09-30,Idaho,16,42549,695,469,3,310441,1899,41434,511,269007,1388
2020-09-30,Illinois,17,296935,2262,8935,34,5627311,58546,295763,2273,5331548,56273
2020-09-30,Indiana,18,122295,968,3632,20,1379850,8495,120019,953,1259831,7542
2020-09-30,Iowa,19,89248,1014,1358,17,764867,6479,85596,1120,679271,5359
2020-09-30,Kansas,20,60957,1006,678,28,521450,7541,59749,1120,461701,6421
2020-09-30,Kentucky,21,72830,909,1208,3,1384609,13368,68840,984,1315769,12384
2020-09-30,Louisiana,22,167458,610,5511,21,2318604,10847,167458,610,2151146,10237
2020-09-30,Maine,23,5391,54,141,0,435100,7046,5391,54,429709,6992
2020-09-30,Maryland,24,125217,412,3949,3,1618007,7697,124725,414,1493282,7283
2020-09-30,Massachusetts,25,132116,532,9456,33,2236565,14426,132116,532,2104449,13894
2020-09-30,Michigan,26,138074,1175,7084,11,3647862,29778,138014,1194,3509848,28584
2020-09-30,Minnesota,27,99187,688,2089,17,1414701,8123,99134,687,1315567,7436
2020-09-30,Mississippi,28,98190,552,2969,12,737033,552,98190,552,638843,0
2020-09-30,Missouri,29,130065,1249,2157,9,1304385,1351,126113,1351,1178272,0
2020-09-30,Montana,30,13179,354,180,3,343158,3232,13071,347,330087,2885
2020-09-30,Nebraska,31,45564,520,493,0,455638,3081,45044,466,410594,2615
2020-09-30,Nevada,32,80084,393,1600,6,698096,2376,79980,385,618116,1991
2020-09-30,New Hampshire,33,8266,33,439,0,273713,3509,8266,33,265447,3476
2020-09-30,New Jersey,34,207062,708,16122,5,3613032,46272,205275,712,3407757,45560
2020-09-30,New Mexico,35,29435,278,877,2,921009,6023,29435,278,891574,5745
2020-09-30,New York,36,463369,1005,32757,14,10747313,97960,458649,1000,10288664,96960
2020-09-30,North Carolina,37,211004,1620,3565,54,3034871,15285,210632,1495,2824239,13790
2020-09-30,North Dakota,38,21849,445,250,8,241492,1644,21846,445,219646,1199
2020-09-30,Northern Mariana Islands,69,70,1,2,0,15182,336,70,0,15112,336
2020-09-30,Ohio,39,153987,1080,4804,21,3165935,24558,153987,1080,3011948,23478
2020-09-30,Oklahoma,40,87199,980,1031,13,1204028,11625,87199,980,1116829,10645
2020-09-30,Oregon,41,33554,257,560,5,685873,6490,33509,218,652364,6272
2020-09-30,Pennsylvania,42,164135,916,8216,20,2038094,13519,158967,1153,1879127,12366
2020-09-30,Puerto Rico,72,48755,288,661,7,329972,199,24000,199,305972,0
2020-09-30,Rhode Island,44,24748,192,1114,1,340601,2703,24748,192,315853,2511
2020-09-30,South Carolina,45,147942,308,3378,19,1309098,8684,147942,308,1161156,8376
2020-09-30,South Dakota,46,22389,392,223,0,190769,1623,22389,392,168380,1231
2020-09-30,Tennessee,47,193357,1498,2429,36,2884356,23875,196139,1528,2688217,22347
2020-09-30,Texas,48,784027,3484,16102,108,6237157,36331,748967,5683,5488190,30648
2020-09-30,Utah,49,73053,917,460,3,819987,7778,73042,906,746945,6872
2020-09-30,Vermont,50,1752,3,58,0,162727,-20,1752,3,160975,-23
2020-09-30,Virgin Islands,78,1318,0,20,0,20561,188,1318,0,19243,188
2020-09-30,Virginia,51,148271,755,3208,21,2057645,10580,148271,755,1909374,9825
2020-09-30,Washington,53,91560,549,2222,4,1854399,5936,87042,404,1767357,5532
2020-09-30,West Virginia,54,15848,156,350,5,561568,3255,15848,156,545720,3099
2020-09-30,Wisconsin,55,129172,2428,1338,26,1552370,11932,129123,2459,1423247,9473
2020-09-30,Wyoming,56,5948,127,50,0,101160,617,5948,127,95212,490
2020-10-01,Alabama,01,155744,1043,2548,8,1156314,7138,155744,1043,1000570,6095
2020-10-01,Alaska,02,8838,131,53,1,462323,5116,8026,137,454297,4979
2020-10-01,Arizona,04,219214,703,5674,20,1475972,13824,219212,705,1256760,13119
2020-10-01,Arkansas,05,84821,1124,1384,15,1045906,13102,84821,1124,961085,11978
2020-10-01,California,06,824306,3181,15989,91,14771851,66649,813687,3062,13958164,63587
2020-10-01,Colorado,08,71723,633,2064,3,927208,10824,71218,682,855990,10142
2020-10-01,Connecticut,09,57742,192,4511,3,1604380,10387,57742,192,1546638,10195
2020-10-01,Delaware,10,20787,174,636,0,288217,1655,20787,174,267430,1481
2020-10-01,District of Columbia,11,15358,32,628,1,390180,2320,15358,32,374822,2288
2020-10-01,Florida,12,709136,2628,14443,127,5317293,24574,700602,2551,4616691,22023
2020-10-01,Georgia,13,303010,1525,6903,42,2954392,20713,319334,1308,2635058,19405
2020-10-01,Guam,66,3519,62,50,0,50548,434,2550,62,47998,372
2020-10-01,Hawaii,15,12660,105,138,3,298642,1962,12589,120,286053,1842
2020-10-01,Idaho,16,42915,366,473,4,313018,2577,42048,614,270970,1963
2020-10-01,Illinois,17,299111,2176,8956,21,5692926,65615,297929,2166,5394997,63449
2020-10-01,Indiana,18,123459,1164,3645,13,1387731,7881,121176,1157,1266555,6724
2020-10-01,Iowa,19,90483,1235,1366,8,770943,6076,86634,1038,684309,5038
2020-10-01,Kansas,20,61103,146,678,0,521450,0,59749,0,461701,0
2020-10-01,Kentucky,21,73619,789,1225,17,1408615,24006,69728,888,1338887,23118
2020-10-01,Louisiana,22,168009,551,5519,8,2334745,16141,168009,551,2166736,15590
2020-10-01,Maine,23,5431,40,142,1,442391,7291,5431,40,436960,7251
2020-10-01,Maryland,24,125997,780,3949,0,1628200,10193,125510,785,1502690,9408
2020-10-01,Massachusetts,25,132870,754,9480,24,2254770,18205,132870,754,2121900,17451
2020-10-01,Michigan,26,139064,990,7103,19,3683581,35719,139012,998,3544569,34721
2020-10-01,Minnesota,27,100253,1066,2102,13,1429575,14874,100200,1066,1329375,13808
2020-10-01,Mississippi,28,98886,696,2979,10,737729,696,98886,696,638843,0
2020-10-01,Missouri,29,131778,1713,2184,27,1315418,11033,127912,1799,1187506,9234
2020-10-01,Montana,30,13626,447,181,1,348709,5551,13500,429,335209,5122
2020-10-01,Nebraska,31,46185,621,497,4,459542,3904,45564,520,413978,3384
2020-10-01,Nevada,32,80507,423,1603,3,701557,3461,80410,430,621147,3031
2020-10-01,New Hampshire,33,8317,51,441,2,275834,2121,8317,51,267517,2070
2020-10-01,New Jersey,34,207676,614,16127,5,3613646,614,205889,614,3407757,0
2020-10-01,New Mexico,35,29661,226,882,5,928389,7380,29661,226,898728,7154
2020-10-01,New York,36,464752,1383,32768,11,10856531,109218,460031,1382,10396500,107836
2020-10-01,North Carolina,37,213218,2214,3601,36,3063661,28790,212909,2277,2850752,26513
2020-10-01,North Dakota,38,22221,372,259,9,242900,1408,22218,372,220682,1036
2020-10-01,Northern Mariana Islands,69,70,0,2,0,15182,0,70,0,15112,0
2020-10-01,Ohio,39,155314,1327,4817,13,3240197,74262,155314,1327,3084883,72935
2020-10-01,Oklahoma,40,88369,1170,1035,4,1215441,11413,88369,1170,1127072,10243
2020-10-01,Oregon,41,33865,311,561,1,691945,6072,33862,353,658083,5719
2020-10-01,Pennsylvania,42,165078,943,8234,18,2049762,11668,160123,1156,1889639,10512
2020-10-01,Puerto Rico,72,49067,312,665,4,330148,176,24176,176,305972,0
2020-10-01,Rhode Island,44,24914,166,1117,3,343499,2898,24914,166,318585,2732
2020-10-01,South Carolina,45,148323,381,3400,22,1316454,7356,148323,381,1168131,6975
2020-10-01,South Dakota,46,23136,747,236,13,195003,4234,23136,747,171867,3487
2020-10-01,Tennessee,47,194601,1244,2473,44,2902732,18376,197432,1293,2705300,17083
2020-10-01,Texas,48,788066,4039,16220,118,6282329,45172,752501,3534,5529828,41638
2020-10-01,Utah,49,74099,1046,460,0,827136,7149,74050,1008,753086,6141
2020-10-01,Vermont,50,1755,3,58,0,163844,1117,1755,3,162089,1114
2020-10-01,Virgin Islands,78,1326,8,20,0,20771,210,1323,5,19448,205
2020-10-01,Virginia,51,148721,450,3228,20,2081967,24322,148721,450,1933246,23872
2020-10-01,Washington,53,92166,606,2227,5,1868089,13690,87522,480,1780567,13210
2020-10-01,West Virginia,54,16024,176,354,4,566588,5020,16024,176,550564,4844
2020-10-01,Wisconsin,55,132176,3004,1358,20,1566844,14474,132123,3000,1434721,11474
2020-10-01,Wyoming,56,6083,135,53,3,101295,135,6083,135,95212,0
2020-10-02,Alabama,01,156698,954,2550,2,1163310,6996,156698,954,1006612,6042
2020-10-02,Alaska,02,8964,126,53,0,469290,6967,8167,141,461123,6826
2020-10-02,Arizona,04,219778,564,5693,19,1483180,7208,219763,551,1263417,6657
2020-10-02,Arkansas,05,85779,958,1391,7,1057730,11824,85779,958,971951,10866
2020-10-02,California,06,828364,4058,16074,85,14868431,96580,817277,3590,14051154,92990
2020-10-02,Colorado,08,72454,731,2069,5,937921,10713,71898,680,866023,10033
2020-10-02,Connecticut,09,58297,555,4513,2,1676410,72030,58297,555,1618113,71475
2020-10-02,Delaware,10,20937,150,642,6,290283,2066,20937,150,269346,1916
2020-10-02,District of Columbia,11,15423,65,629,1,394118,3938,15423,65,378695,3873
2020-10-02,Florida,12,711796,2660,14553,110,5342929,25636,703212,2610,4639717,23026
2020-10-02,Georgia,13,304406,1396,6945,42,2970013,15621,320634,1300,2649379,14321
2020-10-02,Guam,66,3586,67,51,1,51118,570,2617,67,48501,503
2020-10-02,Hawaii,15,12754,94,141,3,300459,1817,12694,105,287765,1712
2020-10-02,Idaho,16,43528,613,478,5,315314,2296,42561,513,272753,1783
2020-10-02,Illinois,17,301540,2429,9007,51,5765867,72941,300385,2456,5465482,70485
2020-10-02,Indiana,18,124959,1500,3656,11,1398522,10791,122640,1464,1275882,9327
2020-10-02,Iowa,19,91483,1000,1377,11,775992,5049,87559,925,688433,4124
2020-10-02,Kansas,20,62424,1321,699,21,531117,9667,61111,1362,470006,8305
2020-10-02,Kentucky,21,74566,947,1232,7,1431600,22985,70727,999,1360873,21986
2020-10-02,Louisiana,22,168826,817,5545,26,2357449,22704,168826,817,2188623,21887
2020-10-02,Maine,23,5468,37,142,0,449290,6899,5468,37,443822,6862
2020-10-02,Maryland,24,126711,714,3950,1,1639785,11585,126222,712,1513563,10873
2020-10-02,Massachusetts,25,133631,761,9490,10,2276229,21459,133631,761,2142598,20698
2020-10-02,Michigan,26,140057,993,7110,7,3723748,40167,139996,984,3583752,39183
2020-10-02,Minnesota,27,101419,1166,2112,10,1447050,17475,101366,1166,1345684,16309
2020-10-02,Mississippi,28,99558,672,2999,20,738401,672,99558,672,638843,0
2020-10-02,Missouri,29,133725,1947,2207,23,1326189,10771,129397,1485,1196792,9286
2020-10-02,Montana,30,14044,418,186,5,353362,4653,13855,355,339507,4298
2020-10-02,Nebraska,31,46977,792,498,1,464264,4722,46185,621,418079,4101
2020-10-02,Nevada,32,81285,778,1611,8,706635,5078,81182,772,625453,4306
2020-10-02,New Hampshire,33,8534,217,442,1,277869,2035,8534,217,269335,1818
2020-10-02,New Jersey,34,208416,740,16131,4,3672127,58481,206629,740,3465498,57741
2020-10-02,New Mexico,35,30000,339,887,5,935401,7012,30000,339,905401,6673
2020-10-02,New York,36,466353,1601,32789,21,10976024,119493,461629,1598,10514395,117895
2020-10-02,North Carolina,37,215035,1817,3628,27,3099704,36043,214684,1775,2885020,34268
2020-10-02,North Dakota,38,22697,476,267,8,244312,1412,22694,476,221618,936
2020-10-02,Northern Mariana Islands,69,70,0,2,0,15185,3,73,3,15112,0
2020-10-02,Ohio,39,156809,1495,4905,88,3271748,31551,156809,1495,3114939,30056
2020-10-02,Oklahoma,40,89559,1190,1044,9,1230160,14719,89559,1190,1140601,13529
2020-10-02,Oregon,41,34180,315,566,5,697293,5348,34163,301,663130,5047
2020-10-02,Pennsylvania,42,166270,1192,8254,20,2066255,16493,161284,1161,1904971,15332
2020-10-02,Puerto Rico,72,49747,680,673,8,330477,329,24505,329,305972,0
2020-10-02,Rhode Island,44,25076,162,1118,1,345909,2410,25076,162,320833,2248
2020-10-02,South Carolina,45,149185,862,3409,9,1338052,21598,149185,862,1188867,20736
2020-10-02,South Dakota,46,23522,386,237,1,196261,1258,23522,386,172739,872
2020-10-02,Tennessee,47,195680,1079,2489,16,2919014,16282,198403,971,2720611,15311
2020-10-02,Texas,48,793962,5896,16307,87,6368742,86413,756004,3503,5612738,82910
2020-10-02,Utah,49,75175,1076,474,14,835124,7988,75157,1107,759967,6881
2020-10-02,Vermont,50,1768,13,58,0,164859,1015,1768,13,163091,1002
2020-10-02,Virgin Islands,78,1326,0,20,0,21011,240,1326,3,19685,237
2020-10-02,Virginia,51,149687,966,3250,22,2102198,20231,149687,966,1952511,19265
2020-10-02,Washington,53,92727,561,2239,12,1884704,16615,88116,594,1796588,16021
2020-10-02,West Virginia,54,16307,283,355,1,576499,9911,16307,283,560192,9628
2020-10-02,Wisconsin,55,134996,2820,1364,6,1580519,13675,134948,2825,1445571,10850
2020-10-02,Wyoming,56,6214,131,53,0,103278,1983,6214,131,97064,1852
2020-10-03,Alabama,01,158380,1682,2558,8,1174699,11389,158380,1682,1016319,9707
2020-10-03,Alaska,02,9111,147,54,1,473256,3966,8306,139,464950,3827
2020-10-03,Arizona,04,220403,625,5705,12,1492856,9676,220399,636,1272457,9040
2020-10-03,Arkansas,05,86525,746,1407,16,1068412,10682,86525,746,981887,9936
2020-10-03,California,06,831494,3130,16122,48,14998888,130457,819436,2159,14179452,128298
2020-10-03,Colorado,08,72929,475,2071,2,947395,9474,72555,657,874840,8817
2020-10-03,Connecticut,09,58297,0,4513,0,1676410,0,58297,0,1618113,0
2020-10-03,Delaware,10,21125,188,645,3,292458,2175,21125,188,271333,1987
2020-10-03,District of Columbia,11,15473,50,629,0,397549,3431,15473,50,382076,3381
2020-10-03,Florida,12,714583,2787,14627,74,5367833,24904,705965,2753,4661868,22151
2020-10-03,Georgia,13,305941,1535,6972,27,3001381,31368,322078,1444,2679303,29924
2020-10-03,Guam,66,3668,82,52,1,51756,638,2699,82,49057,556
2020-10-03,Hawaii,15,12887,133,152,11,302213,1754,12788,94,289425,1660
2020-10-03,Idaho,16,43702,174,480,2,318543,3229,43238,677,275305,2552
2020-10-03,Illinois,17,303807,2267,9033,26,5837501,71634,302827,2442,5534674,69192
2020-10-03,Indiana,18,126414,1455,3669,13,1408475,9953,124059,1419,1284416,8534
2020-10-03,Iowa,19,92302,819,1381,4,781309,5317,88470,911,692839,4406
2020-10-03,Kansas,20,62446,22,698,-1,531117,0,61111,0,470006,0
2020-10-03,Kentucky,21,75576,1010,1239,7,1443856,12256,72001,1274,1371855,10982
2020-10-03,Louisiana,22,168826,0,5545,0,2357449,0,168826,0,2188623,0
2020-10-03,Maine,23,5486,18,142,0,449308,18,5486,18,443822,0
2020-10-03,Maryland,24,127194,483,3957,7,1649725,9940,126819,597,1522906,9343
2020-10-03,Massachusetts,25,134303,672,9507,17,2290114,13885,134303,672,2155811,13213
2020-10-03,Michigan,26,141236,1179,7125,15,3764274,40526,141271,1275,3623003,39251
2020-10-03,Minnesota,27,102840,1421,2126,14,1462532,15482,102787,1421,1359745,14061
2020-10-03,Mississippi,28,100167,609,3011,12,739010,609,100167,609,638843,0
2020-10-03,Missouri,29,134826,1101,2220,13,1339556,13367,131105,1708,1208451,11659
2020-10-03,Montana,30,14490,446,186,0,354783,1421,14356,501,340427,920
2020-10-03,Nebraska,31,47403,426,503,5,469968,5704,46977,792,422991,4912
2020-10-03,Nevada,32,81829,544,1623,12,710210,3575,81708,526,628502,3049
2020-10-03,New Hampshire,33,8597,63,442,0,279564,1695,8597,63,270967,1632
2020-10-03,New Jersey,34,209363,947,16135,4,3673074,947,207576,947,3465498,0
2020-10-03,New Mexico,35,30296,296,890,3,941512,6111,30296,296,911216,5815
2020-10-03,New York,36,468081,1728,32794,5,11110291,134267,463360,1731,10646931,132536
2020-10-03,North Carolina,37,217049,2014,3647,19,3136266,36562,216886,2202,2919380,34360
2020-10-03,North Dakota,38,23137,440,274,7,246006,1694,23134,440,222872,1254
2020-10-03,Northern Mariana Islands,69,70,0,2,0,15185,0,73,0,15112,0
2020-10-03,Ohio,39,157966,1157,4925,20,3318775,47027,157966,1157,3160809,45870
2020-10-03,Oklahoma,40,90748,1189,1051,7,1247822,17662,90748,1189,1157074,16473
2020-10-03,Oregon,41,34512,332,572,6,701903,4610,34511,348,667392,4262
2020-10-03,Pennsylvania,42,166270,0,8271,17,2066255,0,161284,0,1904971,0
2020-10-03,Puerto Rico,72,50375,628,681,8,330776,299,24804,299,305972,0
2020-10-03,Rhode Island,44,25076,0,1118,0,348613,2704,25245,169,323368,2535
2020-10-03,South Carolina,45,150891,1706,3442,33,1339758,1706,150891,1706,1188867,0
2020-10-03,South Dakota,46,23986,464,248,11,198019,1758,23986,464,174033,1294
2020-10-03,Tennessee,47,196870,1190,2534,45,2936962,17948,199595,1192,2737367,16756
2020-10-03,Texas,48,799411,5449,16440,133,6472939,104197,763010,7006,5709929,97191
2020-10-03,Utah,49,76231,1056,476,2,842884,7760,76225,1068,766659,6692
2020-10-03,Vermont,50,1778,10,58,0,165786,927,1778,10,164008,917
2020-10-03,Virgin Islands,78,1327,1,20,0,21011,0,1326,0,19685,0
2020-10-03,Virginia,51,150803,1116,3270,20,2121758,19560,150803,1116,1970955,18444
2020-10-03,Washington,53,93160,433,2238,-1,1905759,21055,88810,694,1816949,20361
2020-10-03,West Virginia,54,16468,161,357,2,582705,6206,16468,161,566237,6045
2020-10-03,Wisconsin,55,138018,3022,1383,19,1594765,14246,138002,3054,1456763,11192
2020-10-03,Wyoming,56,6365,151,53,0,103429,151,6365,151,97064,0
2020-10-04,Alabama,01,159169,789,2558,0,1181242,6543,159169,789,1022073,5754
2020-10-04,Alaska,02,9300,189,54,0,476818,3562,8447,141,468371,3421
2020-10-04,Arizona,04,220757,354,5706,1,1500858,8002,220754,355,1280104,7647
2020-10-04,Arkansas,05,87013,488,1425,18,1076050,7638,87013,488,989037,7150
2020-10-04,California,06,834635,3141,16150,28,15160287,161399,823729,4293,14336558,157106
2020-10-04,Colorado,08,73389,460,2077,6,955819,8424,73076,521,882743,7903
2020-10-04,Connecticut,09,58297,0,4513,0,1676410,0,58297,0,1618113,0
2020-10-04,Delaware,10,21243,118,645,0,294089,1631,21243,118,272846,1513
2020-10-04,District of Columbia,11,15519,46,631,2,399825,2276,15519,46,384306,2230
2020-10-04,Florida,12,716451,1868,14670,43,5388166,20333,707751,1786,4680415,18547
2020-10-04,Georgia,13,306778,837,6999,27,3018618,17237,322925,847,2695693,16390
2020-10-04,Guam,66,3586,-82,53,1,51756,0,2699,0,49057,0
2020-10-04,Hawaii,15,12957,70,155,3,304149,1936,12921,133,291228,1803
2020-10-04,Idaho,16,43964,262,482,2,320578,2035,43702,464,276876,1571
2020-10-04,Illinois,17,305218,1411,9050,17,5889157,51656,304280,1453,5584877,50203
2020-10-04,Indiana,18,127501,1087,3674,5,1418063,9588,125146,1087,1292917,8501
2020-10-04,Iowa,19,92744,442,1387,6,785567,4258,89096,626,696471,3632
2020-10-04,Kansas,20,62479,33,698,0,531117,0,61111,0,470006,0
2020-10-04,Kentucky,21,76086,510,1242,3,1444472,616,72617,616,1371855,0
2020-10-04,Louisiana,22,169719,893,5577,32,2383670,26221,169719,893,2213951,25328
2020-10-04,Maine,23,5519,33,142,0,449341,33,5519,33,443822,0
2020-10-04,Maryland,24,127785,591,3958,1,1659847,10122,127290,471,1532557,9651
2020-10-04,Massachusetts,25,134947,644,9510,3,2309113,18999,134947,644,2174166,18355
2020-10-04,Michigan,26,141287,51,7125,0,3764274,0,141271,0,3623003,0
2020-10-04,Minnesota,27,103879,1039,2133,7,1480219,17687,103826,1039,1376393,16648
2020-10-04,Mississippi,28,100488,321,3013,2,739331,321,100488,321,638843,0
2020-10-04,Missouri,29,135691,865,2220,0,1350745,11189,132431,1326,1218314,9863
2020-10-04,Montana,30,14738,248,187,1,357413,2630,14635,279,342778,2351
2020-10-04,Nebraska,31,47807,404,504,1,473353,3385,47403,426,425950,2959
2020-10-04,Nevada,32,82134,305,1623,0,713389,3179,82100,392,631289,2787
2020-10-04,New Hampshire,33,8645,48,443,1,279612,48,8645,48,270967,0
2020-10-04,New Jersey,34,209989,626,16136,1,3734094,61020,208202,626,3525892,60394
2020-10-04,New Mexico,35,30477,181,892,2,947945,6433,30477,181,917468,6252
2020-10-04,New York,36,469307,1226,32813,19,11220620,110329,464582,1222,10756038,109107
2020-10-04,North Carolina,37,217641,592,3653,6,3160968,24702,217496,610,2943472,24092
2020-10-04,North Dakota,38,23553,416,277,3,247592,1586,23550,416,224042,1170
2020-10-04,Northern Mariana Islands,69,73,3,2,0,15185,0,73,0,15112,0
2020-10-04,Ohio,39,158907,941,4925,0,3356675,37900,158907,941,3197768,36959
2020-10-04,Oklahoma,40,91317,569,1052,1,1248391,569,91317,569,1157074,0
2020-10-04,Oregon,41,34771,259,573,1,705436,3533,34770,259,670666,3274
2020-10-04,Pennsylvania,42,168161,1891,8287,16,2095170,28915,163535,2251,1931635,26664
2020-10-04,Puerto Rico,72,50675,300,686,5,331006,230,25034,230,305972,0
2020-10-04,Rhode Island,44,25076,0,1118,0,350570,1957,25369,124,325201,1833
2020-10-04,South Carolina,45,151582,691,3453,11,1378086,38328,151582,691,1226504,37637
2020-10-04,South Dakota,46,24418,432,248,0,199775,1756,24418,432,175357,1324
2020-10-04,Tennessee,47,198262,1392,2550,16,2970388,33426,201210,1615,2769178,31811
2020-10-04,Texas,48,802440,3029,16471,31,6537885,64946,765894,2884,5771991,62062
2020-10-04,Utah,49,77618,1387,478,2,849830,6946,77618,1393,772212,5553
2020-10-04,Vermont,50,1785,7,58,0,166520,734,1785,7,164735,727
2020-10-04,Virgin Islands,78,1327,0,20,0,21239,228,1327,1,19912,227
2020-10-04,Virginia,51,151870,1067,3273,3,2122825,1067,151870,1067,1970955,0
2020-10-04,Washington,53,93527,367,2238,0,1922956,17197,89419,609,1833537,16588
2020-10-04,West Virginia,54,16628,160,358,1,590079,7374,16628,160,573451,7214
2020-10-04,Wisconsin,55,139941,1923,1388,5,1605641,10876,139928,1926,1465713,8950
2020-10-04,Wyoming,56,6504,139,53,0,103568,139,6504,139,97064,0
2020-10-05,Alabama,01,159713,544,2559,1,1186304,5062,159713,544,1026591,4518
2020-10-05,Alaska,02,9511,211,54,0,479374,2556,8643,196,470731,2360
2020-10-05,Arizona,04,221091,334,5707,1,1507610,6752,221070,316,1286540,6436
2020-10-05,Arkansas,05,87430,417,1447,22,1082876,6826,87430,417,995446,6409
2020-10-05,California,06,837720,3085,16179,29,15301681,141394,826784,3055,14474897,138339
2020-10-05,Colorado,08,74029,640,2085,8,962621,6802,73537,461,889084,6341
2020-10-05,Connecticut,09,59120,823,4517,4,1726721,50311,59120,823,1667601,49488
2020-10-05,Delaware,10,21363,120,645,0,295835,1746,21363,120,274472,1626
2020-10-05,District of Columbia,11,15547,28,631,0,401568,1743,15547,28,386021,1715
2020-10-05,Florida,12,717866,1415,14711,41,5403966,15800,709157,1406,4694809,14394
2020-10-05,Georgia,13,328127,21349,7028,29,3032757,14139,323714,789,2709043,13350
2020-10-05,Guam,66,3722,136,56,3,52365,609,2753,54,49612,555
2020-10-05,Hawaii,15,13007,50,156,1,306112,1963,12991,70,293121,1893
2020-10-05,Idaho,16,44832,868,487,5,322409,1831,43964,262,278445,1569
2020-10-05,Illinois,17,307428,2210,9071,21,5927695,38538,306133,1853,5621562,36685
2020-10-05,Indiana,18,128285,784,3681,7,1425175,7112,125976,830,1299199,6282
2020-10-05,Iowa,19,93261,517,1399,12,788014,2447,89460,364,698554,2083
2020-10-05,Kansas,20,63817,1338,706,8,541106,9989,62708,1597,478398,8392
2020-10-05,Kentucky,21,76787,701,1248,6,1463278,18806,73158,541,1390120,18265
2020-10-05,Louisiana,22,169937,218,5586,9,2391020,7350,169937,218,2221083,7132
2020-10-05,Maine,23,5545,26,142,0,466682,17341,5545,26,461137,17315
2020-10-05,Maryland,24,128277,492,3961,3,1668317,8470,127791,501,1540526,7969
2020-10-05,Massachusetts,25,135462,515,9530,20,2320428,11315,135462,515,2184966,10800
2020-10-05,Michigan,26,142757,1470,7141,16,3818827,54553,142726,1455,3676101,53098
2020-10-05,Minnesota,27,104852,973,2136,3,1494177,13958,104799,973,1389378,12985
2020-10-05,Mississippi,28,100703,215,3013,0,805358,66027,100703,215,704655,65812
2020-10-05,Missouri,29,137297,1606,2229,9,1358668,7923,133418,987,1225250,6936
2020-10-05,Montana,30,15127,389,190,3,369975,12562,14847,212,355128,12350
2020-10-05,Nebraska,31,48259,452,509,5,476952,3599,47807,404,429145,3195
2020-10-05,Nevada,32,82544,410,1624,1,716564,3175,82437,337,634127,2838
2020-10-05,New Hampshire,33,8680,35,444,1,281659,2047,8680,35,272979,2012
2020-10-05,New Jersey,34,210500,511,16138,2,3758058,23964,208713,511,3549345,23453
2020-10-05,New Mexico,35,30632,155,894,2,954596,6651,30632,155,923964,6496
2020-10-05,New York,36,470244,937,32827,14,11297024,76404,465515,933,10831509,75471
2020-10-05,North Carolina,37,220045,2404,3656,3,3193916,32948,219754,2258,2974162,30690
2020-10-05,North Dakota,38,23865,312,280,3,248652,1060,23862,312,224790,748
2020-10-05,Northern Mariana Islands,69,75,2,2,0,15196,11,75,2,15121,9
2020-10-05,Ohio,39,159964,1057,4931,6,3388186,31511,159964,1057,3228222,30454
2020-10-05,Oklahoma,40,91982,665,1055,3,1249056,665,91982,665,1157074,0
2020-10-05,Oregon,41,35056,285,574,1,709012,3576,35049,279,673963,3297
2020-10-05,Pennsylvania,42,169126,965,8300,13,2105159,9989,164207,672,1940952,9317
2020-10-05,Puerto Rico,72,51305,630,695,9,331369,363,25397,363,305972,0
2020-10-05,Rhode Island,44,25419,343,1121,3,351261,691,25419,50,325842,641
2020-10-05,South Carolina,45,152159,577,3456,3,1389106,11020,152159,577,1236947,10443
2020-10-05,South Dakota,46,24598,180,248,0,200443,668,24598,180,175845,488
2020-10-05,Tennessee,47,200603,2341,2570,20,3014664,44276,203699,2489,2810965,41787
2020-10-05,Texas,48,806505,4065,16519,48,6571677,33792,769303,3409,5802374,30383
2020-10-05,Utah,49,78733,1115,483,5,854412,4582,78723,1105,775689,3477
2020-10-05,Vermont,50,1817,32,58,0,167506,986,1817,32,165689,954
2020-10-05,Virgin Islands,78,1322,-5,20,0,21477,238,1322,-5,20155,243
2020-10-05,Virginia,51,152557,687,3276,3,2148109,25284,152557,687,1995552,24597
2020-10-05,Washington,53,94202,675,2253,15,1935899,12943,89874,455,1846025,12488
2020-10-05,West Virginia,54,16742,114,361,3,596531,6452,16742,114,579789,6338
2020-10-05,Wisconsin,55,141780,1839,1393,5,1614232,8591,141655,1727,1472577,6864
2020-10-05,Wyoming,56,6629,125,53,0,106162,2594,6629,125,99533,2469
2020-10-06,Alabama,01,160477,764,2580,21,1191770,5466,160477,764,1031293,4702
2020-10-06,Alaska,02,9656,145,54,0,479374,0,8790,147,470584,-147
2020-10-06,Arizona,04,221937,846,5713,6,1516207,8597,221934,864,1294273,7733
2020-10-06,Arkansas,05,88071,641,1469,22,1091512,8636,88071,641,1003441,7995
2020-10-06,California,06,840322,2602,16251,72,15430421,128740,828461,1677,14601960,127063
2020-10-06,Colorado,08,74535,506,2094,9,970591,7970,74191,654,896400,7316
2020-10-06,Connecticut,09,59241,121,4521,4,1744434,17713,59241,121,1685193,17592
2020-10-06,Delaware,10,21466,103,646,1,297513,1678,21466,103,276047,1575
2020-10-06,District of Columbia,11,15652,105,631,0,410029,8461,15652,105,394377,8356
2020-10-06,Florida,12,720117,2251,14766,55,5424811,20845,711358,2201,4713453,18644
2020-10-06,Georgia,13,329101,974,7062,34,3044792,12035,324650,936,2720142,11099
2020-10-06,Guam,66,3787,65,56,0,53012,647,2814,61,50198,586
2020-10-06,Hawaii,15,13090,83,159,3,307028,916,13041,50,293987,866
2020-10-06,Idaho,16,45487,655,494,7,324236,1827,44422,458,279814,1369
2020-10-06,Illinois,17,308990,1562,9100,29,5977208,49513,307750,1617,5669458,47896
2020-10-06,Indiana,18,129281,996,3711,30,1432219,7044,126946,970,1305273,6074
2020-10-06,Iowa,19,93909,648,1414,15,790843,2829,89934,474,700909,2355
2020-10-06,Kansas,20,64077,260,706,0,541106,0,62708,0,478398,0
2020-10-06,Kentucky,21,77741,954,1255,7,1475754,12476,74194,1036,1401560,11440
2020-10-06,Louisiana,22,170469,532,5592,6,2403780,12760,170469,532,2233311,12228
2020-10-06,Maine,23,5565,20,142,0,469220,2538,5565,20,463655,2518
2020-10-06,Maryland,24,128691,414,3967,6,1675227,6910,128204,413,1547023,6497
2020-10-06,Massachusetts,25,135957,495,9538,8,2333254,12826,135957,495,2197297,12331
2020-10-06,Michigan,26,143901,1144,7163,22,3844962,26135,143878,1152,3701084,24983
2020-10-06,Minnesota,27,105793,941,2140,4,1502736,8559,105740,941,1396996,7618
2020-10-06,Mississippi,28,101678,975,3027,14,805358,0,100703,0,704655,0
2020-10-06,Missouri,29,139172,1875,2258,29,1367139,8471,134583,1165,1232556,7306
2020-10-06,Montana,30,15633,506,192,2,372720,2745,15347,500,357373,2245
2020-10-06,Nebraska,31,48757,498,511,2,481013,4061,48259,452,432754,3609
2020-10-06,Nevada,32,83036,492,1630,6,718732,2168,82916,479,635816,1689
2020-10-06,New Hampshire,33,8731,51,446,2,283471,1812,8731,51,274740,1761
2020-10-06,New Jersey,34,211129,629,16147,9,3758687,629,209342,629,3549345,0
2020-10-06,New Mexico,35,30947,315,894,0,960934,6338,30947,315,929987,6023
2020-10-06,New York,36,471638,1394,32836,9,11393383,96359,466908,1393,10926475,94966
2020-10-06,North Carolina,37,221438,1393,3691,35,3216686,22770,221258,1504,2995428,21266
2020-10-06,North Dakota,38,24368,503,284,4,250087,1435,24364,502,225723,933
2020-10-06,Northern Mariana Islands,69,75,0,2,0,15196,0,75,0,15121,0
2020-10-06,Ohio,39,161299,1335,4947,16,3427972,39786,161299,1335,3266673,38451
2020-10-06,Oklahoma,40,93346,1364,1066,11,1280061,31005,93346,1364,1186715,29641
2020-10-06,Oregon,41,35347,291,581,7,713398,4386,35340,291,678058,4095
2020-10-06,Pennsylvania,42,170255,1129,8318,18,2117235,12076,165243,1036,1951992,11040
2020-10-06,Puerto Rico,72,51737,432,696,1,331607,238,25635,238,305972,0
2020-10-06,Rhode Island,44,25596,177,1125,4,354081,2820,25596,177,328485,2643
2020-10-06,South Carolina,45,152970,811,3471,15,1403136,14030,152970,811,1250166,13219
2020-10-06,South Dakota,46,24876,278,248,0,201477,1034,24876,278,176601,756
2020-10-06,Tennessee,47,202257,1654,2594,24,3040282,25618,205375,1676,2834907,23942
2020-10-06,Texas,48,811184,4679,16622,103,6636248,64571,773435,4132,5862813,60439
2020-10-06,Utah,49,79449,716,489,6,857060,2648,79439,716,777621,1932
2020-10-06,Vermont,50,1821,4,58,0,167441,-65,1821,4,165620,-69
2020-10-06,Virgin Islands,78,1321,-1,20,0,21477,0,1322,0,20155,0
2020-10-06,Virginia,51,153182,625,3291,15,2162363,14254,153182,625,2009181,13629
2020-10-06,Washington,53,94694,492,2261,8,1951407,15508,90276,402,1861131,15106
2020-10-06,West Virginia,54,16936,194,364,3,599553,3022,16936,194,582617,2828
2020-10-06,Wisconsin,55,143886,2106,1410,17,1625846,11614,143730,2075,1482116,9539
2020-10-06,Wyoming,56,6770,141,53,0,106682,520,6770,141,99912,379
2020-10-07,Alabama,01,161418,941,2601,21,1199944,8174,161418,941,1038526,7233
2020-10-07,Alaska,02,9784,128,55,1,490074,10700,8911,121,481163,10579
2020-10-07,Arizona,04,222558,621,5733,20,1523486,7279,222538,604,1300948,6675
2020-10-07,Arkansas,05,88880,809,1482,13,1101523,10011,88880,809,1012643,9202
2020-10-07,California,06,843732,3410,16358,107,15556706,126285,831225,2764,14725481,123521
2020-10-07,Colorado,08,75410,875,2097,3,980037,9446,74922,731,905115,8715
2020-10-07,Connecticut,09,59364,123,4522,1,1752045,7611,59364,123,1692681,7488
2020-10-07,Delaware,10,21550,84,649,3,299173,1660,21550,84,277623,1576
2020-10-07,District of Columbia,11,15697,45,632,1,412656,2627,15697,45,396959,2582
2020-10-07,Florida,12,722699,2582,14903,137,5450906,26095,713902,2544,4737004,23551
2020-10-07,Georgia,13,330769,1668,7089,27,3058187,13395,326142,1492,2732045,11903
2020-10-07,Guam,66,3837,50,58,2,53488,476,2868,54,50620,422
2020-10-07,Hawaii,15,13196,106,162,3,308277,1249,13124,83,295153,1166
2020-10-07,Idaho,16,46233,746,502,8,326191,1955,45082,660,281109,1295
2020-10-07,Illinois,17,311614,2624,9138,38,6036028,58820,310380,2630,5725648,56190
2020-10-07,Indiana,18,130569,1288,3727,16,1440917,8698,128227,1281,1312690,7417
2020-10-07,Iowa,19,95205,1296,1419,5,796057,5214,90884,950,705173,4264
2020-10-07,Kansas,20,65131,1054,725,19,549398,8292,63952,1244,485446,7048
2020-10-07,Kentucky,21,78669,928,1261,6,1491770,16016,76587,2393,1415183,13623
2020-10-07,Louisiana,22,172625,2156,5604,12,2427915,24135,172625,2156,2255290,21979
2020-10-07,Maine,23,5604,39,142,0,475749,6529,5604,39,470145,6490
2020-10-07,Maryland,24,129158,467,3973,6,1683904,8677,128664,460,1555240,8217
2020-10-07,Massachusetts,25,136492,535,9557,19,2349414,16160,136492,535,2212922,15625
2020-10-07,Michigan,26,145131,1230,7171,8,3879635,34673,145092,1214,3734543,33459
2020-10-07,Minnesota,27,106704,911,2154,14,1511141,8405,106651,911,1404490,7494
2020-10-07,Mississippi,28,102241,563,3051,24,806896,1538,102241,1538,704655,0
2020-10-07,Missouri,29,141262,2090,2334,76,1375015,7876,135651,1068,1239364,6808
2020-10-07,Montana,30,16194,561,193,1,376176,3456,16063,716,360113,2740
2020-10-07,Nebraska,31,49396,639,516,5,485994,4981,48757,498,437237,4483
2020-10-07,Nevada,32,83500,464,1639,9,720509,1777,83347,431,637162,1346
2020-10-07,New Hampshire,33,8800,69,448,2,285128,1657,8800,69,276328,1588
2020-10-07,New Jersey,34,211638,509,16152,5,3781810,23123,209850,508,3571960,22615
2020-10-07,New Mexico,35,31372,425,896,2,965319,4385,31372,425,933947,3960
2020-10-07,New York,36,472994,1356,32850,14,11501629,108246,468268,1360,11033361,106886
2020-10-07,North Carolina,37,223349,1911,3716,25,3235273,18587,222969,1711,3012304,16876
2020-10-07,North Dakota,38,24861,493,308,24,251673,1586,24857,493,226816,1093
2020-10-07,Northern Mariana Islands,69,75,0,2,0,15196,0,75,0,15121,0
2020-10-07,Ohio,39,162723,1424,4970,23,3458869,30897,162723,1424,3296146,29473
2020-10-07,Oklahoma,40,94352,1006,1075,9,1290623,10562,94352,1006,1196271,9556
2020-10-07,Oregon,41,35646,299,585,4,718568,5170,35634,294,682934,4876
2020-10-07,Pennsylvania,42,171550,1295,8347,29,2134094,16859,166552,1309,1967542,15550
2020-10-07,Puerto Rico,72,51768,31,705,9,331630,23,25658,23,305972,0
2020-10-07,Rhode Island,44,25776,180,1126,1,357350,3269,25776,180,331574,3089
2020-10-07,South Carolina,45,153705,735,3502,31,1410596,7460,153705,735,1256891,6725
2020-10-07,South Dakota,46,25906,1030,258,10,208780,7303,25906,1030,182874,6273
2020-10-07,Tennessee,47,204286,2029,2615,21,3062543,22261,207455,2080,2855088,20181
2020-10-07,Texas,48,817157,5973,16747,125,6664440,28192,777556,4121,5886884,24071
2020-10-07,Utah,49,80522,1073,499,10,862274,5214,80446,1007,781828,4207
2020-10-07,Vermont,50,1827,6,58,0,168021,580,1827,6,166194,574
2020-10-07,Virgin Islands,78,1322,1,20,0,21594,117,1321,-1,20273,118
2020-10-07,Virginia,51,153691,509,3303,12,2178542,16179,153691,509,2024851,15670
2020-10-07,Washington,53,95500,806,2274,13,1961067,9660,90663,387,1870404,9273
2020-10-07,West Virginia,54,17139,203,369,5,603345,3792,17139,203,586206,3589
2020-10-07,Wisconsin,55,146376,2490,1427,17,1639497,13651,146193,2463,1493304,11188
2020-10-07,Wyoming,56,6899,129,53,0,107845,1163,6899,129,100946,1034
2020-10-08,Alabama,01,161975,557,2637,36,1204021,4077,161975,557,1042046,3520
2020-10-08,Alaska,02,9919,135,56,1,491171,1097,9045,134,482126,963
2020-10-08,Arizona,04,223407,849,5743,10,1535900,12414,223401,863,1312499,11551
2020-10-08,Arkansas,05,90145,1265,1503,21,1115691,14168,90145,1265,1025546,12903
2020-10-08,California,06,847384,3652,16425,67,15623623,66917,834800,3575,14788823,63342
2020-10-08,Colorado,08,76186,776,2107,10,990222,10185,75785,863,914437,9322
2020-10-08,Connecticut,09,59748,384,4527,5,1779258,27213,59748,384,1719510,26829
2020-10-08,Delaware,10,21682,132,651,2,301502,2329,21682,132,279820,2197
2020-10-08,District of Columbia,11,15765,68,634,2,416816,4160,15765,68,401051,4092
2020-10-08,Florida,12,726005,3306,15067,164,5480893,29987,717148,3246,4763745,26741
2020-10-08,Georgia,13,332142,1373,7125,36,3083121,24934,327407,1265,2755714,23669
2020-10-08,Guam,66,3903,66,59,1,54071,583,2934,66,51137,517
2020-10-08,Hawaii,15,13297,101,163,1,308385,108,13232,108,295153,0
2020-10-08,Idaho,16,46848,615,504,2,328861,2670,45753,671,283108,1999
2020-10-08,Illinois,17,314725,3111,9173,35,6108519,72491,313439,3059,5795080,69432
2020-10-08,Indiana,18,132030,1461,3742,15,1451391,10474,129677,1450,1321714,9024
2020-10-08,Iowa,19,96749,1544,1433,14,803037,6980,92145,1261,710892,5719
2020-10-08,Kansas,20,65296,165,741,16,549398,0,63952,0,485446,0
2020-10-08,Kentucky,21,79550,881,1272,11,1511238,19468,77455,868,1433783,18600
2020-10-08,Louisiana,22,173149,524,5609,5,2440215,12300,173149,524,2267066,11776
2020-10-08,Maine,23,5639,35,142,0,482615,6866,5639,35,476976,6831
2020-10-08,Maryland,24,129919,761,3979,6,1696299,12395,129425,761,1566874,11634
2020-10-08,Massachusetts,25,136936,444,9565,8,2363484,14070,136936,444,2226548,13626
2020-10-08,Michigan,26,146548,1417,7194,23,3921840,42205,146493,1401,3775347,40804
2020-10-08,Minnesota,27,107975,1271,2160,6,1526559,15418,107922,1271,1418637,14147
2020-10-08,Mississippi,28,102819,578,3074,23,807474,578,102819,578,704655,0
2020-10-08,Missouri,29,142732,1470,2360,26,1387139,12124,137156,1505,1249983,10619
2020-10-08,Montana,30,16766,572,197,4,381665,5489,16677,614,364988,4875
2020-10-08,Nebraska,31,50059,663,518,2,490130,4136,49396,639,440734,3497
2020-10-08,Nevada,32,83971,471,1650,11,724198,3689,83827,480,640371,3209
2020-10-08,New Hampshire,33,8878,78,448,0,287628,2500,8878,78,278750,2422
2020-10-08,New Jersey,34,212936,1298,16161,9,3842667,60857,211148,1298,3631519,59559
2020-10-08,New Mexico,35,31756,384,899,3,973945,8626,31756,384,942189,8242
2020-10-08,New York,36,474829,1835,32859,9,11647440,145811,470104,1836,11177336,143975
2020-10-08,North Carolina,37,225738,2389,3744,28,3268955,33682,225397,2428,3043558,31254
2020-10-08,North Dakota,38,25388,527,314,6,253407,1734,25384,527,228023,1207
2020-10-08,Northern Mariana Islands,69,75,0,2,0,15196,0,75,0,15121,0
2020-10-08,Ohio,39,164262,1539,4983,13,3489730,30861,164262,1539,3325468,29322
2020-10-08,Oklahoma,40,95564,1212,1085,10,1304870,14247,95564,1212,1209306,13035
2020-10-08,Oregon,41,36121,475,596,11,724378,5810,36116,482,688262,5328
2020-10-08,Pennsylvania,42,172971,1421,8372,25,2153031,18937,167928,1376,1985103,17561
2020-10-08,Puerto Rico,72,52294,526,715,10,331982,352,26010,352,305972,0
2020-10-08,Rhode Island,44,26045,269,1127,1,364314,6964,26045,269,338269,6695
2020-10-08,South Carolina,45,154755,1050,3514,12,1430639,20043,154755,1050,1275884,18993
2020-10-08,South Dakota,46,26441,535,272,14,211261,2481,26411,505,184850,1976
2020-10-08,Tennessee,47,206265,1979,2676,61,3089853,27310,209447,1992,2880406,25318
2020-10-08,Texas,48,821715,4558,16853,106,6703106,38666,781794,4238,5921312,34428
2020-10-08,Utah,49,81975,1453,504,5,871780,9506,81947,1501,789833,8005
2020-10-08,Vermont,50,1838,11,58,0,169402,1381,1838,11,167564,1370
2020-10-08,Virgin Islands,78,1324,2,20,0,21688,94,1322,1,20366,93
2020-10-08,Virginia,51,155535,1844,3328,25,2198370,19828,155535,1844,2042835,17984
2020-10-08,Washington,53,96227,727,2280,6,1987477,26410,91208,545,1896269,25865
2020-10-08,West Virginia,54,17325,186,370,1,609660,6315,17325,186,592335,6129
2020-10-08,Wisconsin,55,149613,3237,1436,9,1656295,16798,149467,3274,1506828,13524
2020-10-08,Wyoming,56,7092,193,54,1,108942,1097,7092,193,101850,904
2020-10-09,Alabama,01,163465,1490,2653,16,1216017,11996,163465,1490,1052552,10506
2020-10-09,Alaska,02,10099,180,56,0,493070,1899,9232,187,483838,1712
2020-10-09,Arizona,04,224101,694,5746,3,1548282,12382,224084,683,1324198,11699
2020-10-09,Arkansas,05,91312,1167,1530,27,1115691,0,90145,0,1025546,0
2020-10-09,California,06,851228,3844,16502,77,15736497,112874,838606,3806,14897891,109068
2020-10-09,Colorado,08,77068,882,2115,8,1001087,10865,76619,834,924468,10031
2020-10-09,Connecticut,09,60038,290,4530,3,1796539,17281,60038,290,1736501,16991
2020-10-09,Delaware,10,21827,145,651,0,304367,2865,21827,145,282540,2720
2020-10-09,District of Columbia,11,15843,78,634,0,422225,5409,15843,78,406382,5331
2020-10-09,Florida,12,728913,2908,15185,118,5509242,28349,720001,2853,4789241,25496
2020-10-09,Georgia,13,333934,1792,7178,53,3112629,29508,329032,1625,2783597,27883
2020-10-09,Guam,66,3958,55,59,0,54495,424,2989,55,51506,369
2020-10-09,Hawaii,15,13461,164,165,2,308486,101,13333,101,295153,0
2020-10-09,Idaho,16,47674,826,506,2,331475,2614,46426,673,285049,1941
2020-10-09,Illinois,17,317501,2776,9207,34,6180417,71898,316556,3117,5863861,68781
2020-10-09,Indiana,18,133864,1834,3761,19,1463436,12045,131493,1816,1331943,10229
2020-10-09,Iowa,19,98023,1274,1454,21,808801,5764,93187,1042,715614,4722
2020-10-09,Kansas,20,67086,1790,765,24,560189,10791,65807,1855,494382,8936
2020-10-09,Kentucky,21,80633,1083,1283,11,1536085,24847,78456,1001,1457629,23846
2020-10-09,Louisiana,22,173406,257,5635,26,2450087,9872,173406,257,2276681,9615
2020-10-09,Maine,23,5666,27,143,1,491052,8437,5666,27,485386,8410
2020-10-09,Maryland,24,130652,733,3990,11,1707367,11068,130159,734,1577208,10334
2020-10-09,Massachusetts,25,137701,765,9577,12,2383082,19598,137701,765,2245381,18833
2020-10-09,Michigan,26,147880,1332,7202,8,3965016,43176,147816,1323,3817200,41853
2020-10-09,Minnesota,27,109365,1390,2174,14,1543542,16983,109312,1390,1434230,15593
2020-10-09,Mississippi,28,103681,862,3080,6,808336,862,103681,862,704655,0
2020-10-09,Missouri,29,145034,2302,2463,103,1399619,12480,139164,2008,1260455,10472
2020-10-09,Montana,30,17478,712,206,9,386746,5081,17399,722,369347,4359
2020-10-09,Nebraska,31,50168,109,522,4,494467,4337,50059,663,444408,3674
2020-10-09,Nevada,32,84785,814,1658,8,730234,6036,84593,766,645641,5270
2020-10-09,New Hampshire,33,8970,92,450,2,287628,0,8878,0,278750,0
2020-10-09,New Jersey,34,213801,865,16164,3,3878988,36321,212013,865,3666975,35456
2020-10-09,New Mexico,35,32241,485,902,3,980053,6108,32241,485,947812,5623
2020-10-09,New York,36,476422,1593,32867,8,11786740,139300,471696,1592,11315044,137708
2020-10-09,North Carolina,37,227756,2018,3768,24,3311285,42330,227431,2034,3083854,40296
2020-10-09,North Dakota,38,26044,656,325,11,255196,1789,26040,656,229156,1133
2020-10-09,Northern Mariana Islands,69,75,0,2,0,15196,0,75,0,15121,0
2020-10-09,Ohio,39,166102,1840,4994,11,3537962,48232,166102,1840,3371860,46392
2020-10-09,Oklahoma,40,97088,1524,1091,6,1321971,17101,97088,1524,1224883,15577
2020-10-09,Oregon,41,36538,417,600,4,730671,6293,36526,410,694145,5883
2020-10-09,Pennsylvania,42,174352,1381,8387,15,2169073,16042,169308,1380,1999765,14662
2020-10-09,Puerto Rico,72,52892,598,720,5,332298,316,26326,316,305972,0
2020-10-09,Rhode Island,44,26294,249,1130,3,368061,3747,26294,249,341767,3498
2020-10-09,South Carolina,45,155676,921,3530,16,1452568,21929,155676,921,1296892,21008
2020-10-09,South Dakota,46,27215,774,277,5,214153,2892,27215,804,186938,2088
2020-10-09,Tennessee,47,207823,1558,2702,26,3116772,26919,211003,1556,2905769,25363
2020-10-09,Texas,48,826221,4506,16955,102,6746030,42924,785830,4036,5960200,38888
2020-10-09,Utah,49,83307,1332,508,4,880169,8389,83290,1343,796879,7046
2020-10-09,Vermont,50,1846,8,58,0,170439,1037,1846,8,168593,1029
2020-10-09,Virgin Islands,78,1324,0,20,0,21758,70,1324,2,20434,68
2020-10-09,Virginia,51,156649,1114,3344,16,2228231,29861,156649,1114,2071582,28747
2020-10-09,Washington,53,96837,610,2288,8,2016471,28994,91918,710,1924553,28284
2020-10-09,West Virginia,54,17707,382,376,6,617623,7963,17707,382,599916,7581
2020-10-09,Wisconsin,55,152831,3218,1453,17,1671293,14998,152631,3164,1518662,11834
2020-10-09,Wyoming,56,7335,243,54,0,110511,1569,7335,243,103176,1326
2020-10-10,Alabama,01,164526,1061,2664,11,1223945,7928,164526,1061,1059419,6867
2020-10-10,Alaska,02,10350,251,56,0,499253,6183,9462,230,489791,5953
2020-10-10,Arizona,04,224985,884,5759,13,1560907,12625,224978,894,1335929,11731
2020-10-10,Arkansas,05,92220,908,1552,22,1142188,26497,92220,2075,1049968,24422
2020-10-10,California,06,854302,3074,16568,66,15878445,141948,842776,4170,15035669,137778
2020-10-10,Colorado,08,78047,979,2121,6,1012173,11086,77642,1023,934531,10063
2020-10-10,Connecticut,09,60038,0,4530,0,1796539,0,60038,0,1736501,0
2020-10-10,Delaware,10,21998,171,653,2,307645,3278,21998,171,285647,3107
2020-10-10,District of Columbia,11,15918,75,636,2,429099,6874,15918,75,413181,6799
2020-10-10,Florida,12,728913,0,15185,0,5509242,0,720001,0,4789241,0
2020-10-10,Georgia,13,335351,1417,7223,45,3132559,19930,330269,1237,2802290,18693
2020-10-10,Guam,66,4025,67,60,1,54816,321,3056,67,51760,254
2020-10-10,Hawaii,15,13532,71,167,2,308651,165,13498,165,295153,0
2020-10-10,Idaho,16,47927,253,508,2,335790,4315,47088,662,288702,3653
2020-10-10,Illinois,17,320283,2782,9235,28,6246673,66256,319461,2905,5927212,63351
2020-10-10,Indiana,18,135789,1925,3782,21,1474639,11203,133411,1918,1341228,9285
2020-10-10,Iowa,19,99099,1076,1460,6,814078,5277,94271,1084,719807,4193
2020-10-10,Kansas,20,67193,107,768,3,560189,0,65807,0,494382,0
2020-10-10,Kentucky,21,81630,997,1293,10,1547178,11093,79445,989,1467733,10104
2020-10-10,Louisiana,22,173406,0,5635,0,2450087,0,173406,0,2276681,0
2020-10-10,Maine,23,5696,30,143,0,491082,30,5696,30,485386,0
2020-10-10,Maryland,24,131169,517,3995,5,1719802,12435,130795,636,1589007,11799
2020-10-10,Massachusetts,25,138340,639,9587,10,2398294,15212,138340,639,2259954,14573
2020-10-10,Michigan,26,149406,1526,7221,19,4010309,45293,149464,1648,3860845,43645
2020-10-10,Minnesota,27,110881,1516,2184,10,1561103,17561,110828,1516,1450275,16045
2020-10-10,Mississippi,28,104638,957,3096,16,809293,957,104638,957,704655,0
2020-10-10,Missouri,29,148199,3165,2483,20,1447667,48048,144230,5066,1303437,42982
2020-10-10,Montana,30,18118,640,209,3,388649,1903,18117,718,370532,1185
2020-10-10,Nebraska,31,51887,1719,525,3,504432,9965,51144,1085,453288,8880
2020-10-10,Nevada,32,85463,678,1659,1,734943,4709,85399,806,649544,3903
2020-10-10,New Hampshire,33,9092,122,455,5,292451,4823,9092,214,283359,4609
2020-10-10,New Jersey,34,214665,864,16171,7,3914021,35033,212877,864,3701144,34169
2020-10-10,New Mexico,35,32722,481,907,5,989652,9599,32722,481,956930,9118
2020-10-10,New York,36,477870,1448,32875,8,11921319,134579,473143,1447,11448176,133132
2020-10-10,North Carolina,37,229959,2203,3786,18,3350815,39530,229752,2321,3121063,37209
2020-10-10,North Dakota,38,26632,588,340,15,257186,1990,26628,588,230558,1402
2020-10-10,Northern Mariana Islands,69,77,2,2,0,15198,2,77,2,15121,0
2020-10-10,Ohio,39,167458,1356,4997,3,3583857,45895,167458,1356,3416399,44539
2020-10-10,Oklahoma,40,98621,1533,1095,4,1339139,17168,98621,1533,1240518,15635
2020-10-10,Oregon,41,36925,387,600,0,736598,5927,36935,409,699663,5518
2020-10-10,Pennsylvania,42,175804,1452,8421,34,2190490,21417,171050,1742,2019440,19675
2020-10-10,Puerto Rico,72,53364,472,728,8,332530,232,26558,232,305972,0
2020-10-10,Rhode Island,44,26294,0,1130,0,373851,5790,26580,286,347271,5504
2020-10-10,South Carolina,45,156621,945,3551,21,1470311,17743,156621,945,1313690,16798
2020-10-10,South Dakota,46,27947,732,286,9,216485,2332,27947,732,188538,1600
2020-10-10,Tennessee,47,209593,1770,2729,27,3141232,24460,212649,1646,2928583,22814
2020-10-10,Texas,48,829738,3517,17019,64,6830631,84601,790060,4230,6040571,80371
2020-10-10,Utah,49,84697,1390,512,4,890719,10550,84644,1354,806075,9196
2020-10-10,Vermont,50,1857,11,58,0,171179,740,1857,11,169322,729
2020-10-10,Virgin Islands,78,1325,1,20,0,21758,0,1324,0,20434,0
2020-10-10,Virginia,51,157905,1256,3354,10,2247176,18945,157905,1256,2089271,17689
2020-10-10,Washington,53,97223,386,2289,1,2037946,21475,92560,642,1945386,20833
2020-10-10,West Virginia,54,17913,206,381,5,628006,10383,17913,206,610093,10177
2020-10-10,Wisconsin,55,155752,2921,1470,17,1685908,14615,155602,2971,1530306,11644
2020-10-10,Wyoming,56,7455,120,54,0,110631,120,7455,120,103176,0
2020-10-11,Alabama,01,165342,816,2664,0,1229759,5814,165342,816,1064417,4998
2020-10-11,Alaska,02,10608,258,56,0,502997,3744,9712,250,493285,3494
2020-10-11,Arizona,04,225575,590,5759,0,1571069,10162,225575,597,1345494,9565
2020-10-11,Arkansas,05,92833,613,1569,17,1151185,8997,92833,613,1058352,8384
2020-10-11,California,06,857076,2774,16581,13,16047004,168559,846579,3803,15200425,164756
2020-10-11,Colorado,08,78752,705,2134,13,1022564,10391,78461,819,944103,9572
2020-10-11,Connecticut,09,60038,0,4530,0,1796539,0,60038,0,1736501,0
2020-10-11,Delaware,10,22130,132,654,1,310570,2925,22130,132,288440,2793
2020-10-11,District of Columbia,11,15984,66,637,1,436167,7068,15984,66,420183,7002
2020-10-11,Florida,12,734483,5570,15363,178,5541455,32213,725415,5414,4816040,26799
2020-10-11,Georgia,13,336586,1235,7246,23,3151039,18480,331409,1140,2819630,17340
2020-10-11,Guam,66,4047,22,61,1,54971,155,3078,22,51893,133
2020-10-11,Hawaii,15,13633,101,168,1,308722,71,13569,71,295153,0
2020-10-11,Idaho,16,48155,228,508,0,338770,2980,47701,613,291069,2367
2020-10-11,Illinois,17,322985,2702,9245,10,6310720,64047,322188,2727,5988532,61320
2020-10-11,Indiana,18,137359,1570,3789,7,1486182,11543,134981,1570,1351201,9973
2020-10-11,Iowa,19,99941,842,1462,2,819460,5382,95346,1075,724114,4307
2020-10-11,Kansas,20,67231,38,769,1,560189,0,65807,0,494382,0
2020-10-11,Kentucky,21,82358,728,1295,2,1548025,847,80292,847,1467733,0
2020-10-11,Louisiana,22,174587,1181,5655,20,2488868,38781,174587,1181,2314281,37600
2020-10-11,Maine,23,5723,27,143,0,491109,27,5723,27,485386,0
2020-10-11,Maryland,24,131853,684,3999,4,1731844,12042,131357,562,1600487,11480
2020-10-11,Massachusetts,25,138903,563,9604,17,2414084,15790,138903,563,2275181,15227
2020-10-11,Michigan,26,149448,42,7221,0,4010309,0,149464,0,3860845,0
2020-10-11,Minnesota,27,112321,1440,2194,10,1578724,17621,112268,1440,1466456,16181
2020-10-11,Mississippi,28,104932,294,3101,5,809587,294,104932,294,704655,0
2020-10-11,Missouri,29,148481,282,2483,0,1447667,0,144230,0,1303437,0
2020-10-11,Montana,30,18733,615,210,1,390258,1609,18702,585,371556,1024
2020-10-11,Nebraska,31,52382,495,525,0,508921,4489,51887,743,457034,3746
2020-10-11,Nevada,32,85922,459,1663,4,738304,3361,85779,380,652525,2981
2020-10-11,New Hampshire,33,9143,51,456,1,292451,0,9092,0,283359,0
2020-10-11,New Jersey,34,215416,751,16174,3,3914772,751,213628,751,3701144,0
2020-10-11,New Mexico,35,32983,261,911,4,997373,7721,32983,261,964390,7460
2020-10-11,New York,36,479013,1143,32879,4,12039573,118254,474286,1143,11565287,117111
2020-10-11,North Carolina,37,231564,1605,3791,5,3388250,37435,231471,1719,3156779,35716
2020-10-11,North Dakota,38,27269,637,343,3,259036,1850,27265,637,231771,1213
2020-10-11,Northern Mariana Islands,69,77,0,2,0,15198,0,77,0,15121,0
2020-10-11,Ohio,39,168749,1291,4999,2,3623321,39464,168749,1291,3454572,38173
2020-10-11,Oklahoma,40,99387,766,1098,3,1339905,766,99387,766,1240518,0
2020-10-11,Oregon,41,37263,338,600,0,741233,4635,37262,327,703971,4308
2020-10-11,Pennsylvania,42,176820,1016,8426,5,2205861,15371,172216,1166,2033645,14205
2020-10-11,Puerto Rico,72,53671,307,730,2,332748,218,26776,218,305972,0
2020-10-11,Rhode Island,44,26294,0,1130,0,377850,3999,26750,170,351100,3829
2020-10-11,South Carolina,45,157406,785,3552,1,1484658,14347,157406,785,1327252,13562
2020-10-11,South Dakota,46,28564,617,286,0,218111,1626,28564,617,189547,1009
2020-10-11,Tennessee,47,211426,1833,2738,9,3172361,31129,214717,2068,2957644,29061
2020-10-11,Texas,48,832730,2992,17047,28,6887551,56920,792478,2418,6095073,54502
2020-10-11,Utah,49,85844,1147,518,6,896766,6047,85844,1200,810922,4847
2020-10-11,Vermont,50,1868,11,58,0,172826,1647,1868,11,170958,1636
2020-10-11,Virgin Islands,78,1325,0,20,0,21945,187,1325,1,20620,186
2020-10-11,Virginia,51,158716,811,3358,4,2265905,18729,158716,811,2107189,17918
2020-10-11,Washington,53,97527,304,2289,0,2061438,23492,93035,475,1968403,23017
2020-10-11,West Virginia,54,18128,215,382,1,633942,5936,18128,215,615814,5721
2020-10-11,Wisconsin,55,158426,2674,1477,7,1696192,10284,158315,2713,1537877,7571
2020-10-11,Wyoming,56,7611,156,54,0,110787,156,7611,156,103176,0
2020-10-12,Alabama,01,166076,734,2665,1,1234463,4704,166076,734,1068387,3970
2020-10-12,Alaska,02,10805,197,56,0,505927,2930,9903,191,496024,2739
2020-10-12,Arizona,04,226072,497,5759,0,1579111,8042,226050,475,1353061,7567
2020-10-12,Arkansas,05,93487,654,1586,17,1159683,8498,93487,654,1066196,7844
2020-10-12,California,06,859959,2883,16594,13,16191341,144337,850028,3449,15341313,140888
2020-10-12,Colorado,08,79499,747,2144,10,1028709,6145,79037,576,949672,5569
2020-10-12,Connecticut,09,61377,1339,4532,2,1896944,100405,61377,1339,1835567,99066
2020-10-12,Delaware,10,22289,159,656,2,314281,3711,22289,159,291992,3552
2020-10-12,District of Columbia,11,16022,38,637,0,438819,2652,16022,38,422797,2614
2020-10-12,Florida,12,736016,1533,15411,48,5558193,16738,726934,1519,4831259,15219
2020-10-12,Georgia,13,339577,2991,7259,13,3168126,17087,332311,902,2835815,16185
2020-10-12,Guam,66,4139,92,61,0,55690,719,3170,92,52520,627
2020-10-12,Hawaii,15,13675,42,168,0,308823,101,13670,101,295153,0
2020-10-12,Idaho,16,48663,508,511,3,340623,1853,48066,365,292557,1488
2020-10-12,Illinois,17,325755,2770,9258,13,6358299,47579,324930,2742,6033369,44837
2020-10-12,Indiana,18,138933,1574,3795,6,1495852,9670,136555,1574,1359297,8096
2020-10-12,Iowa,19,100451,510,1481,19,822140,2680,95809,463,726331,2217
2020-10-12,Kansas,20,69158,1927,774,5,572081,11892,67862,2055,504219,9837
2020-10-12,Kentucky,21,83074,716,1300,5,1576416,28391,80930,638,1495486,27753
2020-10-12,Louisiana,22,174647,60,5669,14,2492265,3397,174647,60,2317618,3337
2020-10-12,Maine,23,5752,29,143,0,491138,29,5752,29,485386,0
2020-10-12,Maryland,24,132357,504,4003,4,1742435,10591,131861,504,1610574,10087
2020-10-12,Massachusetts,25,139663,760,9617,13,2432880,18796,139663,760,2293217,18036
2020-10-12,Michigan,26,151284,1836,7227,6,4061097,50788,151396,1932,3909701,48856
2020-10-12,Minnesota,27,113492,1171,2197,3,1589752,11028,113439,1171,1476313,9857
2020-10-12,Mississippi,28,105228,296,3101,0,809883,296,105228,296,704655,0
2020-10-12,Missouri,29,149460,979,2484,1,1447667,0,144230,0,1303437,0
2020-10-12,Montana,30,19205,472,212,2,400458,10200,19125,423,381333,9777
2020-10-12,Nebraska,31,52839,457,529,4,511938,3017,52382,495,459556,2522
2020-10-12,Nevada,32,86433,511,1670,7,741168,2864,86348,569,654820,2295
2020-10-12,New Hampshire,33,9208,65,456,0,293576,1125,9143,51,284433,1074
2020-10-12,New Jersey,34,215885,469,16175,1,3971597,56825,214097,469,3757500,56356
2020-10-12,New Mexico,35,33362,379,915,4,1002906,5533,33362,379,969544,5154
2020-10-12,New York,36,480045,1032,32896,17,12131366,91793,475315,1029,11656051,90764
2020-10-12,North Carolina,37,233059,1495,3799,8,3417814,29564,232747,1276,3185067,28288
2020-10-12,North Dakota,38,27742,473,350,7,260339,1303,27737,472,232602,831
2020-10-12,Northern Mariana Islands,69,77,0,2,0,15198,0,77,0,15121,0
2020-10-12,Ohio,39,170179,1430,5005,6,3661924,38603,170179,1430,3491745,37173
2020-10-12,Oklahoma,40,100184,797,1104,6,1340702,797,100184,797,1240518,0
2020-10-12,Oregon,41,37472,209,600,0,745255,4022,37467,205,707788,3817
2020-10-12,Pennsylvania,42,177844,1024,8444,18,2218010,12149,173304,1088,2044706,11061
2020-10-12,Puerto Rico,72,54234,563,735,5,332976,228,27004,228,305972,0
2020-10-12,Rhode Island,44,26294,0,1130,0,379100,1250,26831,81,352269,1169
2020-10-12,South Carolina,45,158055,649,3559,7,1497817,13159,158055,649,1339762,12510
2020-10-12,South Dakota,46,28925,361,288,2,219244,1133,28925,361,190319,772
2020-10-12,Tennessee,47,214245,2819,2745,7,3211720,39359,217682,2965,2994038,36394
2020-10-12,Texas,48,836787,4057,17073,26,6951394,63843,795126,2648,6156268,61195
2020-10-12,Utah,49,86879,1035,524,6,900997,4231,86832,988,814165,3243
2020-10-12,Vermont,50,1876,8,58,0,173715,889,1876,8,171839,881
2020-10-12,Virgin Islands,78,1325,0,20,0,21945,0,1325,0,20620,0
2020-10-12,Virginia,51,159570,854,3361,3,2281091,15186,159570,854,2121521,14332
2020-10-12,Washington,53,98265,738,2292,3,2061438,0,93035,0,1968403,0
2020-10-12,West Virginia,54,18281,153,385,3,639434,5492,18281,153,621153,5339
2020-10-12,Wisconsin,55,160655,2229,1488,11,1706023,9831,160331,2016,1545692,7815
2020-10-12,Wyoming,56,7802,191,54,0,110978,191,7802,191,103176,0
2020-10-13,Alabama,01,167193,1117,2665,0,1241317,6854,167193,1117,1074124,5737
2020-10-13,Alaska,02,10960,155,56,0,514789,8862,10059,156,504730,8706
2020-10-13,Arizona,04,226749,677,5767,8,1586081,6970,226734,684,1359347,6286
2020-10-13,Arkansas,05,94167,680,1611,25,1167481,7798,94167,680,1073314,7118
2020-10-13,California,06,863614,3655,16650,56,16333717,142376,852406,2378,15481311,139998
2020-10-13,Colorado,08,80414,915,2181,37,1037975,9266,80085,1048,957890,8218
2020-10-13,Connecticut,09,61697,320,4533,1,1910348,13404,61697,320,1848651,13084
2020-10-13,Delaware,10,22394,105,659,3,315752,1471,22394,105,293358,1366
2020-10-13,District of Columbia,11,16068,46,637,0,443081,4262,16068,46,427013,4216
2020-10-13,Florida,12,738741,2725,15530,119,5584266,26073,729591,2657,4854675,23416
2020-10-13,Georgia,13,340758,1181,7282,23,3180548,12422,333304,993,2847244,11429
2020-10-13,Guam,66,4235,96,62,1,56368,678,3266,96,53102,582
2020-10-13,Hawaii,15,13736,61,172,4,308865,42,13712,42,295153,0
2020-10-13,Idaho,16,49987,1324,514,3,343003,2380,48663,597,294340,1783
2020-10-13,Illinois,17,329160,3405,9288,30,6414292,55993,327781,2851,6086511,53142
2020-10-13,Indiana,18,140505,1572,3822,27,1503923,8071,138104,1549,1365819,6522
2020-10-13,Iowa,19,101531,1080,1491,10,824869,2729,96338,529,728531,2200
2020-10-13,Kansas,20,69392,234,786,12,572081,0,67862,0,504219,0
2020-10-13,Kentucky,21,83967,893,1318,18,1602616,26200,81691,761,1520925,25439
2020-10-13,Louisiana,22,175329,682,5679,10,2512847,20582,175329,682,2337518,19900
2020-10-13,Maine,23,5780,28,143,0,514278,23140,5780,28,508498,23112
2020-10-13,Maryland,24,132839,482,4012,9,1751309,8874,132343,482,1618966,8392
2020-10-13,Massachusetts,25,140412,749,9630,13,2446741,13861,140412,749,2306329,13112
2020-10-13,Michigan,26,152842,1558,7257,30,4099559,38462,152862,1466,3946697,36996
2020-10-13,Minnesota,27,114627,1135,2204,7,1600861,11109,114574,1135,1486287,9974
2020-10-13,Mississippi,28,105941,713,3115,14,810596,713,105941,713,704655,0
2020-10-13,Missouri,29,150496,1036,2495,11,1447667,0,144230,0,1303437,0
2020-10-13,Montana,30,19682,477,217,5,409651,9193,19611,486,390040,8707
2020-10-13,Nebraska,31,53543,704,533,4,515493,3555,52839,457,462654,3098
2020-10-13,Nevada,32,86970,537,1677,7,743677,2509,86835,487,656842,2022
2020-10-13,New Hampshire,33,9279,71,456,0,297850,4274,9279,136,288571,4138
2020-10-13,New Jersey,34,216873,988,16182,7,3972585,988,215085,988,3757500,0
2020-10-13,New Mexico,35,33713,351,918,3,1011320,8414,33713,351,977607,8063
2020-10-13,New York,36,481436,1391,32905,9,12230436,99070,476708,1393,11753728,97677
2020-10-13,North Carolina,37,234842,1783,3849,50,3444583,26769,234481,1734,3210102,25035
2020-10-13,North Dakota,38,28250,508,362,12,261745,1406,28245,508,233500,898
2020-10-13,Northern Mariana Islands,69,77,0,2,0,15198,0,77,0,15121,0
2020-10-13,Ohio,39,171626,1447,5017,12,3698741,36817,171626,1447,3527115,35370
2020-10-13,Oklahoma,40,101493,1309,1119,15,1373716,33014,101493,1309,1272223,31705
2020-10-13,Oregon,41,37788,316,605,5,751277,6022,37780,313,713497,5709
2020-10-13,Pennsylvania,42,179673,1829,8458,14,2234739,16729,174646,1342,2060093,15387
2020-10-13,Puerto Rico,72,54540,306,738,3,333111,135,27139,135,305972,0
2020-10-13,Rhode Island,44,26960,666,1139,9,380694,1594,26960,129,353734,1465
2020-10-13,South Carolina,45,158883,828,3576,17,1511481,13664,158883,828,1352598,12836
2020-10-13,South Dakota,46,29339,414,288,0,220402,1158,29339,414,191063,744
2020-10-13,Tennessee,47,215423,1178,2768,23,3225624,13904,218829,1147,3006795,12757
2020-10-13,Texas,48,842261,5474,17165,92,7012023,60629,800415,5289,6211608,55340
2020-10-13,Utah,49,87825,946,524,0,909124,8127,87819,987,821305,7140
2020-10-13,Vermont,50,1886,10,58,0,174560,845,1886,10,172674,835
2020-10-13,Virgin Islands,78,1328,3,20,0,22062,117,1325,0,20737,117
2020-10-13,Virginia,51,160805,1235,3372,11,2302010,20919,160805,1235,2141205,19684
2020-10-13,Washington,53,99311,1046,2311,19,2123908,62470,94775,1740,2029133,60730
2020-10-13,West Virginia,54,18555,274,387,2,644666,5232,18555,274,626111,4958
2020-10-13,Wisconsin,55,164137,3482,1521,33,1720713,14690,163759,3428,1556954,11262
2020-10-13,Wyoming,56,7964,162,57,3,113843,2865,7964,162,105879,2703
2020-10-14,Alabama,01,167977,784,2706,41,1246453,5136,167977,784,1078476,4352
2020-10-14,Alaska,02,11103,143,60,4,517177,2388,10214,155,506963,2233
2020-10-14,Arizona,04,227660,911,5772,5,1594245,8164,227635,901,1366610,7263
2020-10-14,Arkansas,05,95246,1079,1634,23,1178353,10872,95246,1079,1083107,9793
2020-10-14,California,06,867094,3480,16752,102,16425487,91770,855072,2666,15570415,89104
2020-10-14,Colorado,08,81205,791,2186,5,1045267,7292,80777,692,964490,6600
2020-10-14,Connecticut,09,61861,164,4537,4,1918724,8376,61861,164,1856863,8212
2020-10-14,Delaware,10,22465,71,660,1,316823,1071,22465,71,294358,1000
2020-10-14,District of Columbia,11,16132,64,638,1,448262,5181,16132,64,432130,5117
2020-10-14,Florida,12,741624,2883,15594,64,5606014,21748,732399,2808,4873615,18940
2020-10-14,Georgia,13,342302,1544,7298,16,3204308,23760,334601,1297,2869707,22463
2020-10-14,Guam,66,4310,75,62,0,56894,526,3341,75,53553,451
2020-10-14,Hawaii,15,13834,98,182,10,308926,61,13773,61,295153,0
2020-10-14,Idaho,16,50534,547,520,6,345863,2860,49247,584,296616,2276
2020-10-14,Illinois,17,332124,2964,9335,47,6466961,52669,330643,2862,6136318,49807
2020-10-14,Indiana,18,141670,1165,3836,14,1511060,7137,139269,1165,1371791,5972
2020-10-14,Iowa,19,102905,1374,1505,14,829253,4384,97384,1046,731869,3338
2020-10-14,Kansas,20,70665,1273,838,52,579827,7746,69155,1293,510672,6453
2020-10-14,Kentucky,21,85278,1311,1325,7,1613841,11225,83013,1322,1530828,9903
2020-10-14,Louisiana,22,176209,880,5695,16,2519723,6876,176209,880,2343514,5996
2020-10-14,Maine,23,5816,36,143,0,520402,6124,5816,36,514586,6088
2020-10-14,Maryland,24,133413,574,4022,10,1760654,9345,132918,575,1627736,8770
2020-10-14,Massachusetts,25,140992,580,9647,17,2459860,13119,140992,580,2318868,12539
2020-10-14,Michigan,26,154409,1567,7270,13,4129412,29853,154455,1593,3974957,28260
2020-10-14,Minnesota,27,115996,1369,2233,29,1613411,12550,115943,1369,1497468,11181
2020-10-14,Mississippi,28,106817,876,3140,25,811472,876,106817,876,704655,0
2020-10-14,Missouri,29,154213,3717,2598,103,1352161,-95506,148679,4449,1203482,-99955
2020-10-14,Montana,30,20321,639,225,8,414579,4928,20210,599,394369,4329
2020-10-14,Nebraska,31,54467,924,536,3,519411,3918,53543,704,465868,3214
2020-10-14,Nevada,32,87527,557,1694,17,747418,3741,87314,479,660104,3262
2020-10-14,New Hampshire,33,9349,70,458,2,301619,3769,9349,70,292270,3699
2020-10-14,New Jersey,34,217812,939,16191,9,4036867,64282,216023,938,3820844,63344
2020-10-14,New Mexico,35,34290,577,921,3,1019029,7709,34290,577,984739,7132
2020-10-14,New York,36,482671,1235,32916,11,12342180,111744,477940,1232,11864240,110512
2020-10-14,North Carolina,37,236812,1970,3882,33,3467235,22652,236407,1926,3230828,20726
2020-10-14,North Dakota,38,28952,702,370,8,263233,1488,28947,702,234286,786
2020-10-14,Northern Mariana Islands,69,77,0,2,0,15533,335,77,0,15456,335
2020-10-14,Ohio,39,173665,2039,5033,16,3726652,27911,173665,2039,3552987,25872
2020-10-14,Oklahoma,40,102615,1122,1132,13,1385669,11953,102615,1122,1283054,10831
2020-10-14,Oregon,41,38175,387,609,4,761552,10275,38160,380,723392,9895
2020-10-14,Pennsylvania,42,180956,1283,8481,23,2250651,15912,175922,1276,2074729,14636
2020-10-14,Puerto Rico,72,55516,976,742,4,333601,490,27629,490,305972,0
2020-10-14,Rhode Island,44,27164,204,1147,8,383063,2369,27164,204,355899,2165
2020-10-14,South Carolina,45,159809,926,3593,17,1526565,15084,159809,926,1366756,14158
2020-10-14,South Dakota,46,30215,876,291,3,222321,1919,30215,876,192106,1043
2020-10-14,Tennessee,47,217140,1717,2801,33,3243821,18197,220538,1709,3023283,16488
2020-10-14,Texas,48,848153,5892,17276,111,7067676,55653,805082,4667,6262594,50986
2020-10-14,Utah,49,89018,1193,529,5,917021,7897,88963,1144,828058,6753
2020-10-14,Vermont,50,1889,3,58,0,175256,696,1889,3,173367,693
2020-10-14,Virgin Islands,78,1328,0,20,0,22187,125,1328,3,20859,122
2020-10-14,Virginia,51,161610,805,3381,9,2313940,11930,161610,805,2152330,11125
2020-10-14,Washington,53,100068,757,2319,8,2123908,0,94775,0,2029133,0
2020-10-14,West Virginia,54,18818,263,391,4,649465,4799,18818,263,630647,4536
2020-10-14,Wisconsin,55,167441,3304,1549,28,1735471,14758,167082,3323,1568389,11435
2020-10-14,Wyoming,56,8177,213,57,0,111026,-2817,8177,213,102849,-3030
2020-10-15,Alabama,01,169162,1185,2756,50,1254577,8124,169162,1185,1085415,6939
2020-10-15,Alaska,02,11268,165,61,1,519461,2284,10380,166,509081,2118
2020-10-15,Arizona,04,228748,1088,5789,17,1606089,11844,228748,1113,1377341,10731
2020-10-15,Arkansas,05,96524,1278,1645,11,1191223,12870,96524,1278,1094699,11592
2020-10-15,California,06,870380,3286,16839,87,16517812,92325,858401,3329,15659411,88996
2020-10-15,Colorado,08,82443,1238,2187,1,1056107,10840,81918,1141,974189,9699
2020-10-15,Connecticut,09,62028,167,4540,3,1934569,15845,62028,167,1872541,15678
2020-10-15,Delaware,10,22560,95,661,1,318633,1810,22560,95,296073,1715
2020-10-15,District of Columbia,11,16166,34,638,0,450614,2352,16166,34,434448,2318
2020-10-15,Florida,12,744980,3356,15735,141,5634218,28204,735685,3286,4898533,24918
2020-10-15,Georgia,13,344093,1791,7320,22,3229781,25473,336241,1640,2893540,23833
2020-10-15,Guam,66,4396,86,62,0,57465,571,3427,86,54038,485
2020-10-15,Hawaii,15,13922,88,183,1,309025,99,13872,99,295153,0
2020-10-15,Idaho,16,51471,937,521,1,348111,2248,49892,645,298219,1603
2020-10-15,Illinois,17,336211,4087,9392,57,6534047,67086,334658,4015,6199389,63071
2020-10-15,Indiana,18,143617,1947,3864,28,1521402,10342,141212,1943,1380190,8399
2020-10-15,Iowa,19,104232,1327,1516,11,835606,6353,98717,1333,736889,5020
2020-10-15,Kansas,20,70815,150,838,0,579827,0,69155,0,510672,0
2020-10-15,Kentucky,21,86410,1132,1341,16,1645379,31538,84195,1182,1561184,30356
2020-10-15,Louisiana,22,176952,743,5707,12,2546007,26284,176952,743,2369055,25541
2020-10-15,Maine,23,5836,20,144,1,526067,5665,5836,20,520231,5645
2020-10-15,Maryland,24,134042,629,4028,6,1770835,10181,133548,630,1637287,9551
2020-10-15,Massachusetts,25,141579,587,9672,25,2474616,14756,141579,587,2333037,14169
2020-10-15,Michigan,26,156926,2517,7304,34,4171989,42577,156913,2458,4015076,40119
2020-10-15,Minnesota,27,117159,1163,2252,19,1623517,10106,117106,1163,1506411,8943
2020-10-15,Mississippi,28,108139,1322,3152,12,812794,1322,108139,1322,704655,0
2020-10-15,Missouri,29,156142,1929,2531,-67,1359246,7085,150554,1875,1208692,5210
2020-10-15,Montana,30,21043,722,230,5,419832,5253,20933,723,398899,4530
2020-10-15,Nebraska,31,55428,961,546,10,523777,4366,54467,924,469310,3442
2020-10-15,Nevada,32,88081,554,1700,6,745344,-2074,87969,655,657375,-2729
2020-10-15,New Hampshire,33,9426,77,463,5,303576,1957,9426,77,294150,1880
2020-10-15,New Jersey,34,218783,971,16197,6,4070357,33490,216994,971,3853363,32519
2020-10-15,New Mexico,35,34958,668,922,1,1027392,8363,34958,668,992434,7695
2020-10-15,New York,36,484135,1464,32935,19,12475392,133212,479400,1460,11995992,131752
2020-10-15,North Carolina,37,239338,2526,3899,17,3500763,33528,238939,2532,3261824,30996
2020-10-15,North Dakota,38,29658,706,375,5,264761,1528,29653,706,235108,822
2020-10-15,Northern Mariana Islands,69,80,3,2,0,15533,0,77,0,15456,0
2020-10-15,Ohio,39,175843,2178,5038,5,3760979,34327,175843,2178,3585136,32149
2020-10-15,Oklahoma,40,103836,1221,1143,11,1398768,13099,103836,1221,1294932,11878
2020-10-15,Oregon,41,38536,361,613,4,769276,7724,38525,365,730751,7359
2020-10-15,Pennsylvania,42,182502,1546,8496,15,2266717,16066,177520,1598,2089197,14468
2020-10-15,Puerto Rico,72,56085,569,743,1,333919,318,27947,318,305972,0
2020-10-15,Rhode Island,44,27438,274,1149,2,386776,3713,27438,274,359338,3439
2020-10-15,South Carolina,45,161106,1297,3607,14,1546608,20043,161106,1297,1385502,18746
2020-10-15,South Dakota,46,31012,797,304,13,224239,1918,31012,797,193227,1121
2020-10-15,Tennessee,47,219355,2215,2836,35,3268663,24842,222827,2289,3045836,22553
2020-10-15,Texas,48,853949,5796,17362,86,7111890,44214,809808,4726,6302082,39488
2020-10-15,Utah,49,90488,1470,531,2,923932,6911,90461,1498,833471,5413
2020-10-15,Vermont,50,1903,14,58,0,175726,470,1903,14,173823,456
2020-10-15,Virgin Islands,78,1329,1,21,1,22365,178,1327,-1,21038,179
2020-10-15,Virginia,51,162941,1331,3388,7,2336626,22686,162941,1331,2173685,21355
2020-10-15,Washington,53,100838,770,2331,12,2146509,22601,95509,734,2051000,21867
2020-10-15,West Virginia,54,19082,264,393,2,656414,6949,19082,264,637332,6685
2020-10-15,Wisconsin,55,171480,4039,1568,19,1750966,15495,171122,4040,1579844,11455
2020-10-15,Wyoming,56,8375,198,57,0,116389,5363,8375,198,108014,5165
2020-10-16,Alabama,01,170374,1212,2786,30,1261832,7255,170374,1212,1091458,6043
2020-10-16,Alaska,02,11496,228,62,1,522664,3203,10601,221,512063,2982
2020-10-16,Arizona,04,229508,760,5806,17,1614467,8378,229486,738,1384981,7640
2020-10-16,Arkansas,05,97539,1015,1665,20,1203320,12097,97539,1015,1105781,11082
2020-10-16,California,06,874101,3721,16901,62,16621956,104144,861476,3075,15760480,101069
2020-10-16,Colorado,08,83712,1269,2196,9,1065484,9377,83230,1312,982254,8065
2020-10-16,Connecticut,09,62830,802,4542,2,1967633,33064,62830,802,1904803,32262
2020-10-16,Delaware,10,22724,164,662,1,321142,2509,22724,164,298418,2345
2020-10-16,District of Columbia,11,16255,89,641,3,455787,5173,16255,89,439532,5084
2020-10-16,Florida,12,748429,3449,15829,94,5664298,30080,739050,3365,4925248,26715
2020-10-16,Georgia,13,345879,1786,7382,62,3254270,24489,337850,1609,2916420,22880
2020-10-16,Guam,66,4507,111,64,2,58122,657,3538,111,54584,546
2020-10-16,Hawaii,15,14007,85,184,1,309115,90,13962,90,295153,0
2020-10-16,Idaho,16,52234,763,529,8,350972,2861,50610,718,300362,2143
2020-10-16,Illinois,17,341219,5008,9447,55,6622355,88308,339761,5103,6282594,83205
2020-10-16,Indiana,18,145915,2298,3887,23,1532949,11547,143495,2283,1389454,9264
2020-10-16,Iowa,19,105746,1514,1524,8,822775,-12831,99946,1229,722829,-14060
2020-10-16,Kansas,20,72509,1694,859,21,589189,9362,70855,1700,518334,7662
2020-10-16,Kentucky,21,87764,1354,1349,8,1666429,21050,85506,1311,1580923,19739
2020-10-16,Louisiana,22,177726,774,5727,20,2565652,19645,177726,774,2387926,18871
2020-10-16,Maine,23,5865,29,145,1,533641,7574,5865,29,527776,7545
2020-10-16,Maryland,24,134822,780,4032,4,1782457,11622,134329,781,1648128,10841
2020-10-16,Massachusetts,25,142346,767,9702,30,2489643,15027,142346,767,2347297,14260
2020-10-16,Michigan,26,159144,2218,7320,16,4225410,53421,159119,2206,4066291,51215
2020-10-16,Minnesota,27,119449,2290,2265,13,1646955,23438,119396,2290,1527559,21148
2020-10-16,Mississippi,28,109255,1116,3160,8,838799,26005,109255,1116,729544,24889
2020-10-16,Missouri,29,158764,2622,2550,19,1361263,2017,152571,2017,1208692,0
2020-10-16,Montana,30,21674,631,235,5,425462,5630,21595,662,403867,4968
2020-10-16,Nebraska,31,56724,1296,556,10,529266,5489,55428,961,473838,4528
2020-10-16,Nevada,32,88832,751,1707,7,747671,2327,88685,716,658986,1611
2020-10-16,New Hampshire,33,9514,88,465,2,305815,2239,9514,88,296301,2151
2020-10-16,New Jersey,34,219593,810,16202,5,4101399,31042,217804,810,3883595,30232
2020-10-16,New Mexico,35,35770,812,928,6,1035851,8459,35770,812,1000081,7647
2020-10-16,New York,36,485838,1703,32944,9,12611431,136039,481107,1707,12130324,134332
2020-10-16,North Carolina,37,242032,2694,3938,39,3539731,38968,241623,2684,3298108,36284
2020-10-16,North Dakota,38,30522,864,393,18,266863,2102,30517,864,236346,1238
2020-10-16,Northern Mariana Islands,69,80,0,2,0,15536,3,80,3,15456,0
2020-10-16,Ohio,39,177991,2148,5054,16,3803487,42508,177991,2148,3625496,40360
2020-10-16,Oklahoma,40,105308,1472,1154,11,1418148,19380,105308,1472,1312840,17908
2020-10-16,Oregon,41,38947,411,620,7,775189,5913,38935,410,736254,5503
2020-10-16,Pennsylvania,42,184185,1683,8524,28,2282130,15413,179086,1566,2103044,13847
2020-10-16,Puerto Rico,72,56412,327,758,15,334146,227,28174,227,305972,0
2020-10-16,Rhode Island,44,27691,253,1152,3,390177,3401,27691,253,362486,3148
2020-10-16,South Carolina,45,162253,1147,3615,8,1566317,19709,162253,1147,1404064,18562
2020-10-16,South Dakota,46,31805,793,307,3,226990,2751,31805,793,195185,1958
2020-10-16,Tennessee,47,220099,744,2847,11,3274513,5850,223493,666,3051020,5184
2020-10-16,Texas,48,859553,5604,17454,92,7211046,99156,815678,5870,6395368,93286
2020-10-16,Utah,49,91966,1478,539,8,925428,1496,91957,1496,833471,0
2020-10-16,Vermont,50,1915,12,58,0,176605,879,1915,12,174690,867
2020-10-16,Virgin Islands,78,1329,0,21,0,22504,139,1329,2,21175,137
2020-10-16,Virginia,51,164124,1183,3408,20,2356897,20271,164124,1183,2192773,19088
2020-10-16,Washington,53,101533,695,2338,7,2169192,22683,96185,676,2073007,22007
2020-10-16,West Virginia,54,19580,498,396,3,667579,11165,19580,498,647999,10667
2020-10-16,Wisconsin,55,175652,4172,1588,20,1765796,14830,175227,4105,1590569,10725
2020-10-16,Wyoming,56,8665,290,57,0,117419,1030,8665,290,108754,740
2020-10-17,Alabama,01,171662,1288,2788,2,1269761,7929,171662,1288,1098099,6641
2020-10-17,Alaska,02,11710,214,63,1,530500,7836,10811,210,519689,7626
2020-10-17,Arizona,04,230412,904,5824,18,1625846,11379,230407,921,1395439,10458
2020-10-17,Arkansas,05,98422,883,1684,19,1213237,9917,98422,883,1114815,9034
2020-10-17,California,06,876257,2156,16940,39,16756711,134755,864455,2979,15892256,131776
2020-10-17,Colorado,08,84804,1092,2199,3,1075777,10293,84369,1139,991408,9154
2020-10-17,Connecticut,09,62830,0,4542,0,1967633,0,62830,0,1904803,0
2020-10-17,Delaware,10,22942,218,664,2,324469,3327,22942,218,301527,3109
2020-10-17,District of Columbia,11,16334,79,641,0,462968,7181,16334,79,446634,7102
2020-10-17,Florida,12,752473,4044,15916,87,5694637,30339,743018,3968,4951619,26371
2020-10-17,Georgia,13,347468,1589,7429,47,3280668,26398,339384,1534,2941284,24864
2020-10-17,Guam,66,4507,0,64,0,58680,558,3617,79,55063,479
2020-10-17,Hawaii,15,14101,94,185,1,309200,85,14047,85,295153,0
2020-10-17,Idaho,16,52582,348,532,3,354136,3164,51704,1094,302432,2070
2020-10-17,Illinois,17,344787,3568,9474,27,6699844,77489,343390,3629,6356454,73860
2020-10-17,Indiana,18,148400,2485,3918,31,1545927,12978,145977,2482,1399950,10496
2020-10-17,Iowa,19,106698,952,1528,4,827884,5109,101103,1157,726781,3952
2020-10-17,Kansas,20,72616,107,859,0,589189,0,70855,0,518334,0
2020-10-17,Kentucky,21,88823,1059,1363,14,1687530,21101,86797,1291,1600733,19810
2020-10-17,Louisiana,22,177726,0,5727,0,2565652,0,177726,0,2387926,0
2020-10-17,Maine,23,5913,48,146,1,533689,48,5913,48,527776,0
2020-10-17,Maryland,24,135463,641,4036,4,1794904,12447,135127,798,1659777,11649
2020-10-17,Massachusetts,25,142930,584,9723,21,2502072,12429,142930,584,2359142,11845
2020-10-17,Michigan,26,159259,115,7323,3,4270757,45347,159119,0,4111638,45347
2020-10-17,Minnesota,27,121143,1694,2270,5,1661623,14668,121090,1694,1540533,12974
2020-10-17,Mississippi,28,110006,751,3171,11,839550,751,110006,751,729544,0
2020-10-17,Missouri,29,160654,1890,2645,95,1378663,17400,154928,2357,1223735,15043
2020-10-17,Montana,30,22284,610,240,5,428128,2666,22233,638,405895,2028
2020-10-17,Nebraska,31,57334,610,557,1,535347,6081,56714,1286,478633,4795
2020-10-17,Nevada,32,89848,1016,1709,2,755234,7563,89652,967,665582,6596
2020-10-17,New Hampshire,33,9625,111,466,1,311615,5800,9625,111,301990,5689
2020-10-17,New Jersey,34,220527,934,16204,2,4135796,34397,218738,934,3917058,33463
2020-10-17,New Mexico,35,36343,573,929,1,1046727,10876,36343,573,1010384,10303
2020-10-17,New York,36,487626,1788,32959,15,12771403,159972,482891,1784,12288512,158188
2020-10-17,North Carolina,37,244020,1988,3955,17,3582572,42841,243725,2102,3338847,40739
2020-10-17,North Dakota,38,31266,744,404,11,268672,1809,31261,744,237411,1065
2020-10-17,Northern Mariana Islands,69,86,6,2,0,15542,6,86,6,15456,0
2020-10-17,Ohio,39,180225,2234,5067,13,3854399,50912,180225,2234,3674174,48678
2020-10-17,Oklahoma,40,106503,1195,1168,14,1434035,15887,106503,1195,1327532,14692
2020-10-17,Oregon,41,39316,369,622,2,781643,6454,39316,381,742327,6073
2020-10-17,Pennsylvania,42,185670,1485,8535,11,2300793,18663,180943,1857,2119850,16806
2020-10-17,Puerto Rico,72,56650,238,761,3,334265,119,28293,119,305972,0
2020-10-17,Rhode Island,44,27691,0,1152,0,394774,4597,27978,287,366796,4310
2020-10-17,South Carolina,45,163214,961,3637,22,1585051,18734,163214,961,1421837,17773
2020-10-17,South Dakota,46,32611,806,315,8,229204,2214,32611,806,196593,1408
2020-10-17,Tennessee,47,222608,2509,2875,28,3305133,30620,226139,2646,3078994,27974
2020-10-17,Texas,48,863979,4426,17518,64,7274236,63190,820563,4885,6453673,58305
2020-10-17,Utah,49,93297,1331,541,2,941244,15816,93297,1340,847947,14476
2020-10-17,Vermont,50,1926,11,58,0,177333,728,1926,11,175407,717
2020-10-17,Virgin Islands,78,1335,6,21,0,22504,0,1329,0,21175,0
2020-10-17,Virginia,51,165238,1114,3422,14,2376550,19653,165238,1114,2211312,18539
2020-10-17,Washington,53,102054,521,2339,1,2194254,25062,96894,709,2097360,24353
2020-10-17,West Virginia,54,19801,221,399,3,672361,4782,19801,221,652560,4561
2020-10-17,Wisconsin,55,175652,0,1588,0,1765796,0,175227,0,1590569,0
2020-10-17,Wyoming,56,8816,151,57,0,117570,151,8816,151,108754,0
2020-10-18,Alabama,01,172626,964,2788,0,1274995,5234,172626,964,1102369,4270
2020-10-18,Alaska,02,11934,224,63,0,532711,2211,11021,210,521690,2001
2020-10-18,Arizona,04,231149,737,5827,3,1636210,10364,231149,742,1405061,9622
2020-10-18,Arkansas,05,99066,644,1704,20,1221654,8417,99066,644,1122588,7773
2020-10-18,California,06,878394,2137,16979,39,16892062,135351,867317,2862,16024745,132489
2020-10-18,Colorado,08,85803,999,2199,0,1085968,10191,85302,933,1000666,9258
2020-10-18,Connecticut,09,62830,0,4542,0,1967633,0,62830,0,1904803,0
2020-10-18,Delaware,10,23093,151,665,1,327296,2827,23093,151,304203,2676
2020-10-18,District of Columbia,11,16370,36,641,0,466805,3837,16370,36,450435,3801
2020-10-18,Florida,12,755012,2539,15966,50,5712864,18227,745492,2474,4967372,15753
2020-10-18,Georgia,13,348773,1305,7460,31,3298458,17790,340558,1174,2957900,16616
2020-10-18,Guam,66,4507,0,64,0,58968,288,3675,58,55293,230
2020-10-18,Hawaii,15,14183,82,186,1,309296,96,14143,96,295153,0
2020-10-18,Idaho,16,53092,510,532,0,356140,2004,52582,878,303558,1126
2020-10-18,Illinois,17,348870,4083,9491,17,6779140,79296,347635,4245,6431505,75051
2020-10-18,Indiana,18,150005,1605,3937,19,1555437,9510,147582,1605,1407855,7905
2020-10-18,Iowa,19,107334,636,1532,4,832536,4652,101960,857,730576,3795
2020-10-18,Kansas,20,72722,106,859,0,589189,0,70855,0,518334,0
2020-10-18,Kentucky,21,89538,715,1372,9,1688340,810,87607,810,1600733,0
2020-10-18,Louisiana,22,178869,1143,5750,23,2592598,26946,178869,1143,2413729,25803
2020-10-18,Maine,23,5939,26,146,0,533715,26,5939,26,527776,0
2020-10-18,Maryland,24,136149,686,4037,1,1806662,11758,135657,530,1671005,11228
2020-10-18,Massachusetts,25,143660,730,9737,14,2517646,15574,143660,730,2373986,14844
2020-10-18,Michigan,26,159337,78,7323,0,4270757,0,159119,0,4111638,0
2020-10-18,Minnesota,27,122865,1722,2287,17,1681318,19695,122812,1722,1558506,17973
2020-10-18,Mississippi,28,110239,233,3171,0,839550,0,110006,0,729544,0
2020-10-18,Missouri,29,162156,1502,2648,3,1386536,7873,156696,1768,1229840,6105
2020-10-18,Montana,30,22821,537,241,1,431134,3006,22821,588,408313,2418
2020-10-18,Nebraska,31,58068,734,557,0,539127,3780,57334,620,481793,3160
2020-10-18,Nevada,32,90374,526,1711,2,759508,4274,90261,609,669247,3665
2020-10-18,New Hampshire,33,9694,69,467,1,313364,1749,9694,69,303670,1680
2020-10-18,New Jersey,34,221802,1275,16211,7,4138871,3075,220013,1275,3918858,1800
2020-10-18,New Mexico,35,36788,445,934,5,1054891,8164,36788,445,1018103,7719
2020-10-18,New York,36,489016,1390,32972,13,12900166,128763,484281,1390,12415885,127373
2020-10-18,North Carolina,37,246116,2096,3961,6,3617258,34686,246028,2303,3371230,32383
2020-10-18,North Dakota,38,31983,717,409,5,270555,1883,31978,717,238577,1166
2020-10-18,Northern Mariana Islands,69,86,0,2,0,15542,0,86,0,15456,0
2020-10-18,Ohio,39,181787,1562,5067,0,3900649,46250,181787,1562,3718862,44688
2020-10-18,Oklahoma,40,107299,796,1171,3,1434831,796,107299,796,1327532,0
2020-10-18,Oregon,41,39532,216,622,0,785104,3461,39532,216,745572,3245
2020-10-18,Pennsylvania,42,186772,1102,8555,20,2314863,14070,182212,1269,2132651,12801
2020-10-18,Puerto Rico,72,57293,643,766,5,334683,418,28711,418,305972,0
2020-10-18,Rhode Island,44,27691,0,1152,0,398224,3450,28262,284,369962,3166
2020-10-18,South Carolina,45,163990,776,3650,13,1601263,16212,163990,776,1437273,15436
2020-10-18,South Dakota,46,33269,658,323,8,231047,1843,33269,658,197778,1185
2020-10-18,Tennessee,47,225126,2518,2884,9,3340819,35686,228744,2605,3112075,33081
2020-10-18,Texas,48,869362,5383,17541,23,7326919,52683,823779,3216,6503140,49467
2020-10-18,Utah,49,94394,1097,544,3,948245,7001,94394,1097,853851,5904
2020-10-18,Vermont,50,1937,11,58,0,178460,1127,1937,11,176523,1116
2020-10-18,Virgin Islands,78,1335,0,21,0,22852,348,1335,6,21517,342
2020-10-18,Virginia,51,166138,900,3433,11,2397078,20528,166138,900,2230940,19628
2020-10-18,Washington,53,102403,349,2339,0,2215090,20836,98201,1307,2116889,19529
2020-10-18,West Virginia,54,20081,280,399,0,680872,8511,20081,280,660791,8231
2020-10-18,Wisconsin,55,175652,0,1588,0,1765796,0,175227,0,1590569,0
2020-10-18,Wyoming,56,9025,209,57,0,117779,209,9025,209,108754,0
2020-10-19,Alabama,01,173485,859,2789,1,1281313,6318,173485,859,1107828,5459
2020-10-19,Alaska,02,12138,204,63,0,536223,3512,11225,204,524998,3308
2020-10-19,Arizona,04,231933,784,5830,3,1645001,8791,231897,748,1413104,8043
2020-10-19,Arkansas,05,99597,531,1714,10,1229721,8067,99597,531,1130124,7536
2020-10-19,California,06,882665,4271,16987,8,17042408,150346,870791,3474,16171617,146872
2020-10-19,Colorado,08,86727,924,2207,8,1095280,9312,86374,1072,1008906,8240
2020-10-19,Connecticut,09,64021,1191,4554,12,2039597,71964,64021,1191,1975576,70773
2020-10-19,Delaware,10,23196,103,666,1,329018,1722,23196,103,305822,1619
2020-10-19,District of Columbia,11,16395,25,641,0,469040,2235,16395,25,452645,2210
2020-10-19,Florida,12,756719,1707,16020,54,5729739,16875,747183,1691,4982556,15184
2020-10-19,Georgia,13,350654,1881,7479,19,3314279,15821,341310,752,2972969,15069
2020-10-19,Guam,66,4725,218,67,3,59549,581,3756,81,55793,500
2020-10-19,Hawaii,15,14218,35,186,0,309378,82,14225,82,295153,0
2020-10-19,Idaho,16,54123,1031,535,3,359107,2967,53092,510,306015,2457
2020-10-19,Illinois,17,352449,3579,9520,29,6827824,48684,350748,3113,6477076,45571
2020-10-19,Indiana,18,151588,1583,3960,23,1564722,9285,149166,1584,1415556,7701
2020-10-19,Iowa,19,108114,780,1548,16,835573,3037,102517,557,733056,2480
2020-10-19,Kansas,20,74616,1894,872,13,598394,9205,72968,2113,525426,7092
2020-10-19,Kentucky,21,90443,905,1381,9,1711919,23579,88247,640,1623672,22939
2020-10-19,Louisiana,22,179070,201,5766,16,2597464,4866,179070,201,2418394,4665
2020-10-19,Maine,23,5962,23,146,0,549477,15762,5962,23,543515,15739
2020-10-19,Maryland,24,136643,494,4041,4,1816722,10060,136154,497,1680568,9563
2020-10-19,Massachusetts,25,144488,828,9753,16,2535301,17655,144488,828,2390813,16827
2020-10-19,Michigan,26,164055,4718,7364,41,4335624,64867,164123,5004,4171501,59863
2020-10-19,Minnesota,27,124492,1627,2292,5,1694569,13251,124439,1627,1570130,11624
2020-10-19,Mississippi,28,110592,353,3171,0,840136,586,110592,586,729544,0
2020-10-19,Missouri,29,164249,2093,2660,12,1393100,6564,158101,1405,1234999,5159
2020-10-19,Montana,30,23503,682,242,1,442366,11232,23390,569,418976,10663
2020-10-19,Nebraska,31,58817,749,568,11,543213,4086,58068,734,485145,3352
2020-10-19,Nevada,32,90978,604,1714,3,763202,3694,90843,582,672359,3112
2020-10-19,New Hampshire,33,9746,52,468,1,314806,1442,9746,52,305060,1390
2020-10-19,New Jersey,34,222994,1192,16214,3,4217705,78834,221205,1192,3996500,77642
2020-10-19,New Mexico,35,37302,514,935,1,1061268,6377,37302,514,1023966,5863
2020-10-19,New York,36,490015,999,32990,18,12982175,82009,485279,998,12496896,81011
2020-10-19,North Carolina,37,247551,1435,3969,8,3648364,31106,247172,1144,3401192,29962
2020-10-19,North Dakota,38,32642,659,413,4,272737,2182,32637,659,240100,1523
2020-10-19,Northern Mariana Islands,69,86,0,2,0,15542,0,86,0,15456,0
2020-10-19,Ohio,39,183624,1837,5075,8,3941567,40918,183624,1837,3757943,39081
2020-10-19,Oklahoma,40,108073,774,1173,2,1435605,774,108073,774,1327532,0
2020-10-19,Oregon,41,39799,267,630,8,788509,3405,39794,262,748715,3143
2020-10-19,Pennsylvania,42,188442,1670,8562,7,2327281,12418,183315,1103,2143966,11315
2020-10-19,Puerto Rico,72,57950,657,768,2,335110,427,29138,427,305972,0
2020-10-19,Rhode Island,44,28347,656,1159,7,399326,1102,28347,85,370979,1017
2020-10-19,South Carolina,45,164609,619,3661,11,1610200,8937,164609,619,1445591,8318
2020-10-19,South Dakota,46,33836,567,323,0,232450,1403,33836,567,198614,836
2020-10-19,Tennessee,47,228267,3141,2896,12,3383392,42573,232061,3317,3151331,39256
2020-10-19,Texas,48,874057,4695,17564,23,7384043,57124,825673,1894,6558370,55230
2020-10-19,Utah,49,95572,1178,547,3,954879,6634,95562,1168,859317,5466
2020-10-19,Vermont,50,1946,9,58,0,179597,1137,1946,9,177651,1128
2020-10-19,Virgin Islands,78,1335,0,21,0,22852,0,1335,0,21517,0
2020-10-19,Virginia,51,166828,690,3457,24,2408500,11422,166828,690,2241672,10732
2020-10-19,Washington,53,103323,920,2357,18,2230785,15695,98201,0,2132584,15695
2020-10-19,West Virginia,54,20293,212,399,0,687990,7118,20293,212,667697,6906
2020-10-19,Wisconsin,55,183177,7525,1624,36,1886955,121159,183142,7915,1703813,113244
2020-10-19,Wyoming,56,9311,286,57,0,118065,286,9311,286,108754,0
2020-10-20,Alabama,01,174528,1043,2805,16,1287087,5774,174528,1043,1112559,4731
2020-10-20,Alaska,02,12349,211,63,0,546525,10302,11456,231,535069,10071
2020-10-20,Arizona,04,232939,1006,5837,7,1652612,7611,232937,1040,1419675,6571
2020-10-20,Arkansas,05,100441,844,1728,14,1237675,7954,100441,844,1137234,7110
2020-10-20,California,06,887093,4428,17067,80,17189070,146662,874077,3286,16314993,143376
2020-10-20,Colorado,08,87966,1239,2212,5,1101775,6495,87582,1208,1014193,5287
2020-10-20,Connecticut,09,64455,434,4559,5,2054262,14665,64455,434,1989807,14231
2020-10-20,Delaware,10,23325,129,668,2,330726,1708,23325,129,307401,1579
2020-10-20,District of Columbia,11,16445,50,642,1,473807,4767,16445,50,457362,4717
2020-10-20,Florida,12,760381,3662,16104,84,5758297,28558,750739,3556,5007558,25002
2020-10-20,Georgia,13,351990,1336,7494,15,3327836,13557,342438,1128,2985398,12429
2020-10-20,Guam,66,4855,130,67,0,60506,957,3886,130,56620,827
2020-10-20,Hawaii,15,14302,84,188,2,309415,37,14262,37,295153,0
2020-10-20,Idaho,16,55153,1030,541,6,361402,2295,53790,698,307612,1597
2020-10-20,Illinois,17,356151,3702,9562,42,6886901,59077,354462,3714,6532439,55363
2020-10-20,Indiana,18,153088,1500,4008,48,1572350,7628,150664,1498,1421686,6130
2020-10-20,Iowa,19,109210,1096,1576,28,837718,2145,103011,494,734707,1651
2020-10-20,Kansas,20,74883,267,902,30,598394,0,72968,0,525426,0
2020-10-20,Kentucky,21,91731,1288,1403,22,1720328,8409,89544,1297,1630784,7112
2020-10-20,Louisiana,22,179769,699,5772,6,2616457,18993,179769,699,2436688,18294
2020-10-20,Maine,23,5989,27,146,0,554094,4617,5989,27,548105,4590
2020-10-20,Maryland,24,137229,586,4050,9,1824905,8183,136744,590,1688161,7593
2020-10-20,Massachusetts,25,145464,976,9758,5,2552694,17393,145464,976,2407230,16417
2020-10-20,Michigan,26,165949,1894,7386,22,4385791,50167,165994,1871,4219797,48296
2020-10-20,Minnesota,27,125584,1092,2299,7,1700265,5696,125531,1092,1574734,4604
2020-10-20,Mississippi,28,111322,730,3202,31,840866,730,111322,730,729544,0
2020-10-20,Missouri,29,164891,642,2668,8,1394624,1524,159625,1524,1234999,0
2020-10-20,Montana,30,24201,698,252,10,445021,2655,24093,703,420928,1952
2020-10-20,Nebraska,31,59409,592,575,7,546669,3456,58817,749,487852,2707
2020-10-20,Nevada,32,91679,701,1728,14,766312,3110,91499,656,674813,2454
2020-10-20,New Hampshire,33,9828,82,468,0,316091,1285,9828,82,306263,1203
2020-10-20,New Jersey,34,223982,988,16227,13,4235300,17595,222193,988,4013107,16607
2020-10-20,New Mexico,35,37896,594,942,7,1070481,9213,37896,594,1032585,8619
2020-10-20,New York,36,491216,1201,32998,8,13072715,90540,486480,1201,12586235,89339
2020-10-20,North Carolina,37,249158,1607,4018,49,3671793,23429,248750,1578,3423043,21851
2020-10-20,North Dakota,38,33671,1029,417,4,274572,1835,33666,1029,240906,806
2020-10-20,Northern Mariana Islands,69,88,2,2,0,15811,269,88,2,15723,267
2020-10-20,Ohio,39,185639,2015,5083,8,3979414,37847,185639,2015,3793775,35832
2020-10-20,Oklahoma,40,109548,1475,1191,18,1467010,31405,109548,1475,1357462,29930
2020-10-20,Oregon,41,40149,350,636,6,795317,6808,40136,342,755181,6466
2020-10-20,Pennsylvania,42,189988,1546,8591,29,2340511,13230,184872,1557,2155639,11673
2020-10-20,Puerto Rico,72,58643,693,769,1,335557,447,29585,447,305972,0
2020-10-20,Rhode Island,44,28649,302,1164,5,401055,1729,28649,302,372406,1427
2020-10-20,South Carolina,45,165493,884,3696,35,1619922,9722,165493,884,1454429,8838
2020-10-20,South Dakota,46,34457,621,330,7,234726,2276,34457,621,200269,1655
2020-10-20,Tennessee,47,229794,1527,2924,28,3396736,13344,233569,1508,3163167,11836
2020-10-20,Texas,48,879939,5882,17644,80,7444326,60283,833557,7884,6610769,52399
2020-10-20,Utah,49,96643,1071,552,5,959942,5063,96643,1081,863299,3982
2020-10-20,Vermont,50,1956,10,58,0,179713,116,1956,10,177757,106
2020-10-20,Virgin Islands,78,1337,2,21,0,22852,0,1335,0,21517,0
2020-10-20,Virginia,51,167754,926,3485,28,2422481,13981,167754,926,2254727,13055
2020-10-20,Washington,53,103845,522,2380,23,2244336,13551,98661,460,2145675,13091
2020-10-20,West Virginia,54,20519,226,408,9,691809,3819,20519,226,671290,3593
2020-10-20,Wisconsin,55,187898,4721,1660,36,1900711,13756,187828,4686,1712883,9070
2020-10-20,Wyoming,56,9526,215,61,4,118280,215,9526,215,108754,0
2020-10-21,Alabama,01,175674,1146,2828,23,1295035,7948,174528,0,1120507,7948
2020-10-21,Alaska,02,12559,210,64,1,547140,615,11680,224,535460,391
2020-10-21,Arizona,04,233948,1009,5854,17,1662704,10092,233912,975,1428792,9117
2020-10-21,Arkansas,05,101596,1155,1751,23,1248949,11274,101596,1155,1147353,10119
2020-10-21,California,06,890153,3060,17189,122,17293139,104069,877784,3707,16415355,100362
2020-10-21,Colorado,08,89245,1279,2220,8,1110243,8468,88849,1267,1021394,7201
2020-10-21,Connecticut,09,64871,416,4567,8,2070126,15864,64871,416,2005255,15448
2020-10-21,Delaware,10,23375,50,670,2,331480,754,23375,50,308105,704
2020-10-21,District of Columbia,11,16498,53,642,0,476443,2636,16498,53,459945,2583
2020-10-21,Florida,12,762525,2144,16209,105,5760403,2106,752845,2106,5007558,0
2020-10-21,Georgia,13,353449,1459,7523,29,3338315,10479,343750,1312,2994565,9167
2020-10-21,Guam,66,4937,82,69,2,61243,737,3968,82,57275,655
2020-10-21,Hawaii,15,14379,77,202,14,309503,88,14350,88,295153,0
2020-10-21,Idaho,16,55922,769,551,10,363972,2570,54663,873,309309,1697
2020-10-21,Illinois,17,360160,4009,9622,60,6953692,66791,358804,4342,6594888,62449
2020-10-21,Indiana,18,154822,1734,4023,15,1581109,8759,152396,1732,1428713,7027
2020-10-21,Iowa,19,110444,1234,1594,18,842542,4824,104190,1179,738352,3645
2020-10-21,Kansas,20,76299,1416,952,50,605509,7115,74456,1488,531053,5627
2020-10-21,Kentucky,21,93110,1379,1424,21,1728638,8310,90996,1452,1637642,6858
2020-10-21,Louisiana,22,181132,1363,5790,18,2631404,14947,181132,1363,2450272,13584
2020-10-21,Maine,23,6027,38,146,0,560810,6716,6027,38,554783,6678
2020-10-21,Maryland,24,137720,491,4058,8,1832007,7102,137236,492,1694771,6610
2020-10-21,Massachusetts,25,146166,702,9780,22,2565472,12778,146166,702,2419306,12076
2020-10-21,Michigan,26,167857,1908,7420,34,4420831,35040,167872,1878,4252959,33162
2020-10-21,Minnesota,27,126644,1060,2334,35,1708514,8249,126591,1060,1581923,7189
2020-10-21,Mississippi,28,112123,801,3223,21,841667,801,112123,801,729544,0
2020-10-21,Missouri,29,167435,2544,2716,48,1407874,13250,160869,1244,1247005,12006
2020-10-21,Montana,30,24818,617,276,24,447994,2973,24712,619,423282,2354
2020-10-21,Nebraska,31,60308,899,586,11,549922,3253,59409,592,490513,2661
2020-10-21,Nevada,32,92193,514,1735,7,769613,3301,92064,565,677549,2736
2020-10-21,New Hampshire,33,9917,89,469,1,318292,2201,9917,89,308375,2112
2020-10-21,New Jersey,34,225012,1030,16245,18,4264123,28823,223223,1030,4040900,27793
2020-10-21,New Mexico,35,38715,819,950,8,1078087,7606,38715,819,1039372,6787
2020-10-21,New York,36,493245,2029,33005,7,13197504,124789,488506,2026,12708998,122763
2020-10-21,North Carolina,37,251010,1852,4063,45,3692043,20250,250592,1842,3441451,18408
2020-10-21,North Dakota,38,34170,499,427,10,275596,1024,34165,499,241431,525
2020-10-21,Northern Mariana Islands,69,88,0,2,0,15811,0,88,0,15723,0
2020-10-21,Ohio,39,188005,2366,5149,66,4011513,32099,188005,2366,3823508,29733
2020-10-21,Oklahoma,40,110855,1307,1210,19,1478225,11215,110855,1307,1367370,9908
2020-10-21,Oregon,41,40458,309,638,2,799935,4618,40443,307,759492,4311
2020-10-21,Pennsylvania,42,191347,1359,8629,38,2353833,13322,186297,1425,2167536,11897
2020-10-21,Puerto Rico,72,58830,187,774,5,335689,132,29717,132,305972,0
2020-10-21,Rhode Island,44,29123,474,1169,5,404680,3625,29123,474,375557,3151
2020-10-21,South Carolina,45,166357,864,3708,12,1633549,13627,166357,864,1467192,12763
2020-10-21,South Dakota,46,35044,587,333,3,236250,1524,35044,587,201206,937
2020-10-21,Tennessee,47,232100,2306,2946,22,3416255,19519,235861,2292,3180394,17227
2020-10-21,Texas,48,886403,6464,17743,99,7474874,30548,838809,5252,6636065,25296
2020-10-21,Utah,49,98037,1394,558,6,966892,6950,98006,1363,868886,5587
2020-10-21,Vermont,50,1971,15,58,0,180694,981,1971,15,178723,966
2020-10-21,Virgin Islands,78,1337,0,21,0,23105,253,1337,2,21768,251
2020-10-21,Virginia,51,168772,1018,3515,30,2442510,20029,168772,1018,2273738,19011
2020-10-21,Washington,53,104624,779,2384,4,2252788,8452,99150,489,2153638,7963
2020-10-21,West Virginia,54,20734,215,413,5,696597,4788,20734,215,675863,4573
2020-10-21,Wisconsin,55,192225,4327,1707,47,1910755,10044,192191,4363,1718564,5681
2020-10-21,Wyoming,56,9848,322,61,0,121670,3390,9848,322,111822,3068
2020-10-22,Alabama,01,177064,1390,2843,15,1302817,7782,177064,2536,1125753,5246
2020-10-22,Alaska,02,12790,231,64,0,548709,1569,11919,239,536790,1330
2020-10-22,Arizona,04,234914,966,5859,5,1673903,11199,234906,994,1438997,10205
2020-10-22,Arkansas,05,102798,1202,1772,21,1262040,13091,102798,1202,1159242,11889
2020-10-22,California,06,896424,6271,17266,77,17358770,65631,880724,2940,16478046,62691
2020-10-22,Colorado,08,90639,1394,2224,4,1120200,9957,90222,1373,1029978,8584
2020-10-22,Connecticut,09,65373,502,4569,2,2092263,22137,65373,502,2026890,21635
2020-10-22,Delaware,10,23528,153,670,0,333059,1579,23528,153,309531,1426
2020-10-22,District of Columbia,11,16537,39,642,0,479435,2992,16537,39,462898,2953
2020-10-22,Florida,12,768083,5558,16266,57,5812154,51751,758306,5461,5053848,46290
2020-10-22,Georgia,13,355156,1707,7547,24,3367534,29219,345535,1785,3021999,27434
2020-10-22,Guam,66,5025,88,70,1,62287,1044,4056,88,58231,956
2020-10-22,Hawaii,15,14478,99,205,3,309580,77,14427,77,295153,0
2020-10-22,Idaho,16,56944,1022,560,9,366607,2635,55650,987,310957,1648
2020-10-22,Illinois,17,365120,4960,9663,41,7034669,80977,363746,4942,6670923,76035
2020-10-22,Indiana,18,157678,2856,4065,42,1594365,13256,155246,2850,1439119,10406
2020-10-22,Iowa,19,112242,1798,1617,23,848270,5728,105625,1435,742645,4293
2020-10-22,Kansas,20,76546,247,952,0,605509,0,74456,0,531053,0
2020-10-22,Kentucky,21,94582,1472,1439,15,1758052,29414,92299,1303,1665753,28111
2020-10-22,Louisiana,22,181904,772,5799,9,2651160,19756,181904,772,2469256,18984
2020-10-22,Maine,23,6064,37,146,0,567382,6572,6064,37,561318,6535
2020-10-22,Maryland,24,138473,753,4070,12,1843355,11348,137979,743,1705376,10605
2020-10-22,Massachusetts,25,147215,1049,9810,30,2583501,18029,147215,1049,2436286,16980
2020-10-22,Michigan,26,170102,2245,7465,45,4468863,48032,170076,2204,4298787,45828
2020-10-22,Minnesota,27,128205,1561,2354,20,1722897,14383,128152,1561,1594745,12822
2020-10-22,Mississippi,28,113081,958,3231,8,842625,958,113081,958,729544,0
2020-10-22,Missouri,29,169311,1876,2734,18,1432472,24598,162723,1854,1269749,22744
2020-10-22,Montana,30,25736,918,279,3,452846,4852,25640,928,427206,3924
2020-10-22,Nebraska,31,61285,977,589,3,554539,4617,60308,899,494231,3718
2020-10-22,Nevada,32,93028,835,1736,1,774095,4482,92853,789,681242,3693
2020-10-22,New Hampshire,33,9994,77,470,1,323173,4881,9994,77,313179,4804
2020-10-22,New Jersey,34,226174,1162,16263,18,4297612,33489,224385,1162,4073227,32327
2020-10-22,New Mexico,35,39377,662,953,3,1089150,11063,39377,662,1049773,10401
2020-10-22,New York,36,494874,1629,33022,17,13332845,135341,490134,1628,12842711,133713
2020-10-22,North Carolina,37,253418,2408,4110,47,3727675,35632,252992,2400,3474683,33232
2020-10-22,North Dakota,38,35057,887,436,9,277692,2096,35052,887,242640,1209
2020-10-22,Northern Mariana Islands,69,88,0,2,0,15811,0,88,0,15723,0
2020-10-22,Ohio,39,190430,2425,5161,12,4055125,43612,190430,2425,3864695,41187
2020-10-22,Oklahoma,40,112483,1628,1221,11,1491088,12863,112483,1628,1378605,11235
2020-10-22,Oregon,41,40825,367,647,9,806001,6066,40810,367,765191,5699
2020-10-22,Pennsylvania,42,193401,2054,8660,31,2373439,19606,188360,2063,2185079,17543
2020-10-22,Puerto Rico,72,59037,207,783,9,335776,87,29804,87,305972,0
2020-10-22,Rhode Island,44,29594,471,1173,4,408302,3622,29594,471,378708,3151
2020-10-22,South Carolina,45,167485,1128,3755,47,1649351,15802,167485,1128,1481866,14674
2020-10-22,South Dakota,46,36017,973,347,14,238446,2196,36017,973,202429,1223
2020-10-22,Tennessee,47,234079,1979,2983,37,3436334,20079,237907,2046,3198427,18033
2020-10-22,Texas,48,891656,5253,17760,17,7532717,57843,845100,6291,6687617,51552
2020-10-22,Utah,49,99563,1526,563,5,976126,9234,99549,1543,876577,7691
2020-10-22,Vermont,50,1987,16,58,0,181677,983,1987,16,179690,967
2020-10-22,Virgin Islands,78,1343,6,21,0,23254,149,1343,6,21911,143
2020-10-22,Virginia,51,170104,1332,3524,9,2462742,20232,170104,1332,2292638,18900
2020-10-22,Washington,53,105364,740,2389,5,2276453,23665,99874,724,2176579,22941
2020-10-22,West Virginia,54,21057,323,418,5,705151,8554,21057,323,684094,8231
2020-10-22,Wisconsin,55,195853,3628,1730,23,1926469,15714,195823,3632,1730646,12082
2020-10-22,Wyoming,56,10119,271,68,7,121941,271,10119,271,111822,0
2020-10-23,Alabama,01,180916,3852,2859,16,1314774,11957,180916,3852,1133858,8105
2020-10-23,Alaska,02,13067,277,64,0,552746,4037,12167,248,540579,3789
2020-10-23,Arizona,04,235910,996,5865,6,1686863,12960,235882,976,1450981,11984
2020-10-23,Arkansas,05,104135,1337,1782,10,1274297,12257,104135,1337,1170162,10920
2020-10-23,California,06,902325,5901,17316,50,17483293,124523,886865,6141,16596428,118382
2020-10-23,Colorado,08,92067,1428,2233,9,1130901,10701,91572,1350,1039329,9351
2020-10-23,Connecticut,09,66052,679,4577,8,2115744,23481,66052,679,2049692,22802
2020-10-23,Delaware,10,23687,159,678,8,335112,2053,23687,159,311425,1894
2020-10-23,District of Columbia,11,16609,72,642,0,485753,6318,16609,72,469144,6246
2020-10-23,Florida,12,771772,3689,16339,73,5855896,43742,761924,3618,5093972,40124
2020-10-23,Georgia,13,357319,2163,7584,37,3407623,40089,347759,2224,3059864,37865
2020-10-23,Guam,66,5110,85,70,0,62906,619,4141,85,58765,534
2020-10-23,Hawaii,15,14617,139,208,3,309682,102,14529,102,295153,0
2020-10-23,Idaho,16,58083,1139,568,8,369667,3060,56600,950,313067,2110
2020-10-23,Illinois,17,370134,5014,9704,41,7118051,83382,368746,5000,6749305,78382
2020-10-23,Indiana,18,160145,2467,4092,27,1605596,11231,157713,2467,1447883,8764
2020-10-23,Iowa,19,113596,1354,1629,12,852949,4679,106874,1249,746075,3430
2020-10-23,Kansas,20,78122,1576,975,23,616262,10753,76230,1774,540032,8979
2020-10-23,Kentucky,21,96043,1461,1462,23,1777204,19152,93748,1449,1683456,17703
2020-10-23,Louisiana,22,182603,699,5820,21,2671238,20078,182603,699,2488635,19379
2020-10-23,Maine,23,6095,31,146,0,574283,6901,6095,31,568188,6870
2020-10-23,Maryland,24,139185,712,4078,8,1855294,11939,138691,712,1716603,11227
2020-10-23,Massachusetts,25,148285,1070,9830,20,2599364,15863,148285,1070,2451079,14793
2020-10-23,Michigan,26,172128,2026,7485,20,4525886,57023,172122,2046,4353764,54977
2020-10-23,Minnesota,27,129916,1711,2367,13,1734245,11348,129863,1711,1604382,9637
2020-10-23,Mississippi,28,113876,795,3238,7,843420,795,113876,795,729544,0
2020-10-23,Missouri,29,171871,2560,2764,30,1439316,6844,164534,1811,1274782,5033
2020-10-23,Montana,30,26600,864,283,4,461000,8154,26503,863,434497,7291
2020-10-23,Nebraska,31,62511,1226,594,5,559308,4769,61285,977,498023,3792
2020-10-23,Nevada,32,94044,1016,1739,3,780647,6552,93666,813,686981,5739
2020-10-23,New Hampshire,33,10112,118,471,1,326151,2978,10112,118,316039,2860
2020-10-23,New Jersey,34,227219,1045,16273,10,4337985,40373,225430,1045,4112555,39328
2020-10-23,New Mexico,35,40168,791,960,7,1099484,10334,40168,791,1059316,9543
2020-10-23,New York,36,496510,1636,33038,16,13474353,141508,491771,1637,12982582,139871
2020-10-23,North Carolina,37,255534,2116,4140,30,3763315,35640,255708,2716,3507607,32924
2020-10-23,North Dakota,38,35944,887,445,9,279702,2010,35939,887,243763,1123
2020-10-23,Northern Mariana Islands,69,88,0,2,0,15811,0,88,0,15723,0
2020-10-23,Ohio,39,192948,2518,5184,23,4101393,46268,192948,2518,3908445,43750
2020-10-23,Oklahoma,40,113856,1373,1234,13,1511552,20464,113856,1373,1397696,19091
2020-10-23,Oregon,41,41357,532,651,4,815201,9200,41348,538,773853,8662
2020-10-23,Pennsylvania,42,195659,2258,8695,35,2391447,18008,190579,2219,2200868,15789
2020-10-23,Puerto Rico,72,60984,1947,791,8,336928,1152,30956,1152,305972,0
2020-10-23,Rhode Island,44,30118,524,1177,4,412850,4548,30118,524,382732,4024
2020-10-23,South Carolina,45,168549,1064,3777,22,1667501,18150,168549,1064,1498952,17086
2020-10-23,South Dakota,46,37202,1185,356,9,241002,2556,37202,1185,203800,1371
2020-10-23,Tennessee,47,237607,3528,3043,60,3478495,42161,241513,3606,3236982,38555
2020-10-23,Texas,48,899313,7657,17873,113,7611586,78869,851572,6472,6760014,72397
2020-10-23,Utah,49,101574,2011,567,4,984137,8011,101509,1960,882628,6051
2020-10-23,Vermont,50,2016,29,58,0,182943,1266,2016,29,180927,1237
2020-10-23,Virgin Islands,78,1346,3,21,0,23435,181,1346,3,22089,178
2020-10-23,Virginia,51,171284,1180,3539,15,2483341,20599,171284,1180,2312057,19419
2020-10-23,Washington,53,106189,825,2396,7,2296275,19822,100525,651,2195750,19171
2020-10-23,West Virginia,54,21392,335,422,4,710357,5206,21392,335,688965,4871
2020-10-23,Wisconsin,55,200479,4626,1776,46,1944538,18069,200466,4643,1744072,13426
2020-10-23,Wyoming,56,10545,426,68,0,124231,2290,10545,426,113686,1864
2020-10-24,Alabama,01,183276,2360,2866,7,1322198,7424,183276,2360,1138922,5064
2020-10-24,Alaska,02,13439,372,64,0,552746,0,12523,356,540223,-356
2020-10-24,Arizona,04,236898,988,5870,5,1698966,12103,236772,890,1462194,11213
2020-10-24,Arkansas,05,105318,1183,1797,15,1287123,12826,105318,1183,1181805,11643
2020-10-24,California,06,906644,4319,17345,29,17609179,125886,892810,5945,16716369,119941
2020-10-24,Colorado,08,93989,1922,2241,8,1144155,13254,93400,1828,1050755,11426
2020-10-24,Connecticut,09,66052,0,4577,0,2115744,0,66052,0,2049692,0
2020-10-24,Delaware,10,23847,160,680,2,337276,2164,23847,160,313429,2004
2020-10-24,District of Columbia,11,16706,97,642,0,491553,5800,16706,97,474847,5703
2020-10-24,Florida,12,776243,4471,16416,77,5928115,72219,766305,4381,5161810,67838
2020-10-24,Georgia,13,359001,1682,7625,41,3426110,18487,349605,1846,3076505,16641
2020-10-24,Guam,66,5144,34,72,2,63240,334,4175,34,59065,300
2020-10-24,Hawaii,15,14706,89,211,3,309822,140,14669,140,295153,0
2020-10-24,Idaho,16,58964,881,573,5,372818,3151,57673,1073,315145,2078
2020-10-24,Illinois,17,376034,5900,9765,61,7201568,83517,374907,6161,6826661,77356
2020-10-24,Indiana,18,162886,2741,4118,26,1618331,12735,160454,2741,1457877,9994
2020-10-24,Iowa,19,114952,1356,1634,5,859419,6470,108514,1640,750905,4830
2020-10-24,Kansas,20,78177,55,975,0,616262,0,76230,0,540032,0
2020-10-24,Kentucky,21,97501,1458,1469,7,1799931,22727,95480,1732,1704451,20995
2020-10-24,Louisiana,22,182603,0,5820,0,2671238,0,182603,0,2488635,0
2020-10-24,Maine,23,6137,42,146,0,574325,42,6137,42,568188,0
2020-10-24,Maryland,24,139859,674,4091,13,1866927,11633,139487,796,1727440,10837
2020-10-24,Massachusetts,25,149488,1203,9839,9,2618607,19243,149488,1203,2469119,18040
2020-10-24,Michigan,26,175385,3257,7522,37,4579991,54105,175612,3490,4404379,50615
2020-10-24,Minnesota,27,132175,2259,2381,14,1744115,9870,132122,2259,1611993,7611
2020-10-24,Mississippi,28,115088,1212,3255,17,844632,1212,115088,1212,729544,0
2020-10-24,Missouri,29,173746,1875,2854,90,1450015,10699,167452,2918,1282563,7781
2020-10-24,Montana,30,27149,549,295,12,464032,3032,27142,639,436890,2393
2020-10-24,Nebraska,31,63215,704,603,9,564275,4967,62510,1225,501765,3742
2020-10-24,Nevada,32,94935,891,1746,7,783707,3060,94812,1146,688895,1914
2020-10-24,New Hampshire,33,10238,126,473,2,329057,2906,10238,126,318819,2780
2020-10-24,New Jersey,34,229128,1909,16281,8,4339894,1909,227339,1909,4112555,0
2020-10-24,New Mexico,35,41040,872,965,5,1109095,9611,41040,872,1068055,8739
2020-10-24,New York,36,498568,2058,33049,11,13631293,156940,493832,2061,13137461,154879
2020-10-24,North Carolina,37,258439,2905,4170,30,3809077,45762,258292,2584,3550785,43178
2020-10-24,North Dakota,38,36879,935,453,8,281668,1966,36874,935,244794,1031
2020-10-24,Northern Mariana Islands,69,88,0,2,0,15811,0,88,0,15723,0
2020-10-24,Ohio,39,195806,2858,5206,22,4149769,48376,195806,2858,3953963,45518
2020-10-24,Oklahoma,40,115685,1829,1245,11,1532709,21157,115685,1829,1417024,19328
2020-10-24,Oregon,41,41739,382,654,3,821142,5941,41739,391,779403,5550
2020-10-24,Pennsylvania,42,197370,1711,8721,26,2407679,16232,192622,2043,2215057,14189
2020-10-24,Puerto Rico,72,61280,296,794,3,337044,116,31072,116,305972,0
2020-10-24,Rhode Island,44,30118,0,1177,0,416075,3225,30583,465,385492,2760
2020-10-24,South Carolina,45,169341,792,3793,16,1679084,11583,169341,792,1509743,10791
2020-10-24,South Dakota,46,38141,939,366,10,243680,2678,38141,939,205539,1739
2020-10-24,Tennessee,47,240191,2584,3067,24,3505140,26645,244087,2574,3261053,24071
2020-10-24,Texas,48,906638,7325,17998,125,7710195,98609,858071,6499,6852124,92110
2020-10-24,Utah,49,103137,1563,568,1,992734,8597,103117,1608,889617,6989
2020-10-24,Vermont,50,2043,27,58,0,184670,1727,2043,27,182627,1700
2020-10-24,Virgin Islands,78,1346,0,21,0,23435,0,1346,0,22089,0
2020-10-24,Virginia,51,172372,1088,3578,39,2500546,17205,172372,1088,2328174,16117
2020-10-24,Washington,53,106772,583,2396,0,2318931,22656,101345,820,2217586,21836
2020-10-24,West Virginia,54,21712,320,422,0,715690,5333,21712,320,693978,5013
2020-10-24,Wisconsin,55,205139,4660,1804,28,1962769,18231,205139,4673,1757630,13558
2020-10-24,Wyoming,56,10805,260,68,0,124491,260,10805,260,113686,0
2020-10-25,Alabama,01,184355,1079,2866,0,1329140,6942,184355,1079,1144785,5863
2020-10-25,Alaska,02,13968,529,64,0,559969,7223,13041,518,546928,6705
2020-10-25,Arizona,04,238200,1302,5874,4,1711869,12903,238163,1391,1473706,11512
2020-10-25,Arkansas,05,106115,797,1812,15,1295235,8112,106115,797,1189120,7315
2020-10-25,California,06,909344,2700,17358,13,17787885,178706,898029,5219,16889856,173487
2020-10-25,Colorado,08,95742,1753,2244,3,1156234,12079,95089,1689,1061145,10390
2020-10-25,Connecticut,09,66052,0,4577,0,2115744,0,66052,0,2049692,0
2020-10-25,Delaware,10,23961,114,681,1,339341,2065,23961,114,315380,1951
2020-10-25,District of Columbia,11,16767,61,642,0,496232,4679,16767,61,479465,4618
2020-10-25,Florida,12,778628,2385,16428,12,5942740,14625,768653,2348,5174087,12277
2020-10-25,Georgia,13,360344,1343,7626,1,3445032,18922,350923,1318,3094109,17604
2020-10-25,Guam,66,5185,41,72,0,63494,254,4216,41,59278,213
2020-10-25,Hawaii,15,14823,117,211,0,309911,89,14758,89,295153,0
2020-10-25,Idaho,16,59344,380,574,1,375527,2709,58694,1021,316833,1688
2020-10-25,Illinois,17,380065,4031,9788,23,7273665,72097,378969,4062,6894696,68035
2020-10-25,Indiana,18,165038,2152,4130,12,1629468,11137,162607,2153,1466861,8984
2020-10-25,Iowa,19,116238,1286,1635,1,863361,3942,109657,1143,753704,2799
2020-10-25,Kansas,20,78241,64,975,0,616262,0,76230,0,540032,0
2020-10-25,Kentucky,21,98730,1229,1472,3,1801393,1462,96942,1462,1704451,0
2020-10-25,Louisiana,22,183575,972,5837,17,2697507,26269,183575,972,2513932,25297
2020-10-25,Maine,23,6201,64,146,0,574389,64,6201,64,568188,0
2020-10-25,Maryland,24,140770,911,4096,5,1878929,12002,140279,792,1738650,11210
2020-10-25,Massachusetts,25,150565,1077,9864,25,2635607,17000,150565,1077,2485042,15923
2020-10-25,Michigan,26,175515,130,7522,0,4579991,0,175612,0,4404379,0
2020-10-25,Minnesota,27,133855,1680,2402,21,1770733,26618,133802,1680,1636931,24938
2020-10-25,Mississippi,28,115088,0,3255,0,844632,0,115088,0,729544,0
2020-10-25,Missouri,29,175243,1497,2857,3,1458840,8825,169495,2043,1289345,6782
2020-10-25,Montana,30,27880,731,298,3,465607,1575,27880,738,437727,837
2020-10-25,Nebraska,31,63797,582,604,1,567426,3151,63215,705,504211,2446
2020-10-25,Nevada,32,95798,863,1748,2,787869,4162,95703,891,692166,3271
2020-10-25,New Hampshire,33,10328,90,473,0,331561,2504,10328,90,321233,2414
2020-10-25,New Jersey,34,230257,1129,16285,4,4385882,45988,228468,1129,4157414,44859
2020-10-25,New Mexico,35,41863,823,967,2,1118844,9749,41863,823,1076981,8926
2020-10-25,New York,36,500201,1633,33059,10,13752123,120830,495464,1632,13256659,119198
2020-10-25,North Carolina,37,260128,1689,4183,13,3844453,35376,260099,1807,3584354,33569
2020-10-25,North Dakota,38,37724,845,461,8,283410,1742,37719,845,245691,897
2020-10-25,Northern Mariana Islands,69,88,0,2,0,15811,0,88,0,15723,0
2020-10-25,Ohio,39,198115,2309,5206,0,4199457,49688,198115,2309,4001342,47379
2020-10-25,Oklahoma,40,116736,1051,1249,4,1533760,1051,116736,1051,1417024,0
2020-10-25,Oregon,41,42101,362,654,0,825250,4108,42101,362,783149,3746
2020-10-25,Pennsylvania,42,198756,1386,8730,9,2424265,16586,194288,1666,2229977,14920
2020-10-25,Puerto Rico,72,62503,1223,801,7,337709,665,31737,665,305972,0
2020-10-25,Rhode Island,44,30118,0,1177,0,418420,2345,30857,274,387563,2071
2020-10-25,South Carolina,45,170678,1337,3802,9,1706414,27330,170678,1337,1535736,25993
2020-10-25,South Dakota,46,39203,1062,375,9,245930,2250,39203,1062,206727,1188
2020-10-25,Tennessee,47,243508,3317,3105,38,3546736,41596,247587,3500,3299149,38096
2020-10-25,Texas,48,910573,3935,18042,44,7762242,52047,862375,4304,6899867,47743
2020-10-25,Utah,49,105053,1916,572,4,1001239,8505,104882,1765,896357,6740
2020-10-25,Vermont,50,2073,30,58,0,185607,937,2073,30,183534,907
2020-10-25,Virgin Islands,78,1346,0,21,0,23435,0,1346,0,22089,0
2020-10-25,Virginia,51,173371,999,3579,1,2521816,21270,173371,999,2348445,20271
2020-10-25,Washington,53,107270,498,2396,0,2360387,41456,102913,1568,2257474,39888
2020-10-25,West Virginia,54,21906,194,423,1,723207,7517,21906,194,701301,7323
2020-10-25,Wisconsin,55,208917,3778,1814,10,1976943,14174,208917,3778,1768026,10396
2020-10-25,Wyoming,56,11041,236,68,0,124727,236,11041,236,113686,0
2020-10-26,Alabama,01,185322,967,2866,0,1334315,5175,185322,967,1148993,4208
2020-10-26,Alaska,02,14316,348,64,0,570844,10875,13391,350,557453,10525
2020-10-26,Arizona,04,239193,993,5875,1,1720285,8416,238964,801,1481321,7615
2020-10-26,Arkansas,05,106727,612,1833,21,1302162,6927,106727,612,1195435,6315
2020-10-26,California,06,913699,4355,17398,40,17982829,194944,901010,2981,17081819,191963
2020-10-26,Colorado,08,97686,1944,2255,11,1175350,19116,97300,2211,1078050,16905
2020-10-26,Connecticut,09,68099,2047,4589,12,2207937,92193,68099,2047,2139838,90146
2020-10-26,Delaware,10,24168,207,685,4,342071,2730,24168,207,317903,2523
2020-10-26,District of Columbia,11,16812,45,642,0,498190,1958,16812,45,481378,1913
2020-10-26,Florida,12,782005,3377,16448,20,5974725,31985,771989,3336,5202736,28649
2020-10-26,Georgia,13,364275,3931,7644,18,3461388,16356,351881,958,3109507,15398
2020-10-26,Guam,66,5305,120,76,4,64454,960,4336,120,60118,840
2020-10-26,Hawaii,15,14858,35,211,0,310030,119,14877,119,295153,0
2020-10-26,Idaho,16,60400,1056,582,8,377823,2296,59344,650,318479,1646
2020-10-26,Illinois,17,385084,5019,9811,23,7330929,57264,383698,4729,6947231,52535
2020-10-26,Indiana,18,167010,1972,4143,13,1638232,8764,164581,1974,1473651,6790
2020-10-26,Iowa,19,117198,960,1657,22,866323,2962,110404,747,755919,2215
2020-10-26,Kansas,20,80473,2232,976,1,625931,9669,78676,2446,547255,7223
2020-10-26,Kentucky,21,99965,1235,1480,8,1824845,23452,97866,924,1726979,22528
2020-10-26,Louisiana,22,183802,227,5854,17,2702566,5059,183802,227,2518764,4832
2020-10-26,Maine,23,6254,53,146,0,588653,14264,6254,53,582399,14211
2020-10-26,Maryland,24,141334,564,4099,3,1888371,9442,140844,565,1747527,8877
2020-10-26,Massachusetts,25,151777,1212,9881,17,2655689,20082,151777,1212,2503912,18870
2020-10-26,Michigan,26,179624,4109,7551,29,4652388,72397,179669,4057,4472719,68340
2020-10-26,Minnesota,27,135425,1570,2406,4,1784312,13579,135372,1570,1648940,12009
2020-10-26,Mississippi,28,115763,675,3263,8,845307,675,115763,675,729544,0
2020-10-26,Missouri,29,177733,2490,2869,12,1465949,7109,171022,1527,1294927,5582
2020-10-26,Montana,30,28580,700,304,6,476325,10718,28501,621,447824,10097
2020-10-26,Nebraska,31,64506,709,609,5,569834,2408,63797,582,506037,1826
2020-10-26,Nevada,32,96330,532,1751,3,791321,3452,96178,475,695143,2977
2020-10-26,New Hampshire,33,10397,69,475,2,333115,1554,10397,69,322718,1485
2020-10-26,New Jersey,34,231473,1216,16292,7,4455234,69352,229684,1216,4225550,68136
2020-10-26,New Mexico,35,42586,723,976,9,1124922,6078,42586,723,1082336,5355
2020-10-26,New York,36,501393,1192,33073,14,13834240,82117,496655,1191,13337585,80926
2020-10-26,North Carolina,37,262159,2031,4200,17,3872913,28460,261742,1643,3611171,26817
2020-10-26,North Dakota,38,38246,522,466,5,284478,1068,38241,522,246237,546
2020-10-26,Northern Mariana Islands,69,92,4,2,0,15815,4,92,4,15723,0
2020-10-26,Ohio,39,200231,2116,5217,11,4235663,36206,200231,2116,4035432,34090
2020-10-26,Oklahoma,40,117399,663,1251,2,1534423,663,117399,663,1417024,0
2020-10-26,Oregon,41,42454,353,657,3,830284,5034,42436,335,787848,4699
2020-10-26,Pennsylvania,42,201248,2492,8737,7,2437125,12860,195695,1407,2241430,11453
2020-10-26,Puerto Rico,72,63135,632,804,3,338170,461,32198,461,305972,0
2020-10-26,Rhode Island,44,31024,906,1184,7,419892,1472,31024,167,388868,1305
2020-10-26,South Carolina,45,171501,823,3823,21,1733232,26818,171501,823,1561731,25995
2020-10-26,South Dakota,46,39741,538,375,0,247094,1164,39741,538,207353,626
2020-10-26,Tennessee,47,245760,2252,3132,27,3569435,22699,249866,2279,3319569,20420
2020-10-26,Texas,48,917167,6594,18077,35,7809150,46908,867075,4700,6942075,42208
2020-10-26,Utah,49,106083,1030,575,3,1006802,5563,106083,1201,900719,4362
2020-10-26,Vermont,50,2083,10,58,0,186058,451,2083,10,183975,441
2020-10-26,Virgin Islands,78,1348,2,21,0,23617,182,1348,2,22269,180
2020-10-26,Virginia,51,174275,904,3581,2,2537269,15453,174275,904,2362994,14549
2020-10-26,Washington,53,108393,1123,2428,32,2360387,0,102913,0,2257474,0
2020-10-26,West Virginia,54,22223,317,424,1,736376,13169,22223,317,714153,12852
2020-10-26,Wisconsin,55,212116,3199,1825,11,1989820,12877,211928,3011,1777892,9866
2020-10-26,Wyoming,56,11477,436,77,9,125163,436,11477,436,113686,0
2020-10-27,Alabama,01,186437,1115,2892,26,1339885,5570,186437,1115,1153448,4455
2020-10-27,Alaska,02,14699,383,66,2,577429,6585,13779,388,563650,6197
2020-10-27,Arizona,04,240158,965,5891,16,1730162,9877,240122,1158,1490040,8719
2020-10-27,Arkansas,05,107679,952,1857,24,1310854,8692,107679,952,1203175,7740
2020-10-27,California,06,918627,4928,17478,80,18127049,144220,904198,3188,17222851,141032
2020-10-27,Colorado,08,99111,1425,2265,10,1183754,8404,98733,1433,1085021,6971
2020-10-27,Connecticut,09,68637,538,4595,6,2221034,13097,68637,538,2152397,12559
2020-10-27,Delaware,10,24249,81,686,1,343141,1070,24249,81,318892,989
2020-10-27,District of Columbia,11,16906,94,644,2,502538,4348,16906,94,485632,4254
2020-10-27,Florida,12,786303,4298,16504,56,5991638,16913,776215,4226,5215423,12687
2020-10-27,Georgia,13,365498,1223,7661,17,3474891,13503,353372,1491,3121519,12012
2020-10-27,Guam,66,5387,82,76,0,65045,591,4418,82,60627,509
2020-10-27,Hawaii,15,14920,62,214,3,310067,37,14914,37,295153,0
2020-10-27,Idaho,16,61282,882,588,6,380532,2709,60041,697,320491,2012
2020-10-27,Illinois,17,389088,4004,9860,49,7393003,62074,387698,4000,7005305,58074
2020-10-27,Indiana,18,168996,1986,4194,51,1646542,8310,166564,1983,1479978,6327
2020-10-27,Iowa,19,118852,1654,1680,23,869020,2697,111261,857,757759,1840
2020-10-27,Kansas,20,80761,288,979,3,625931,0,78676,0,547255,0
2020-10-27,Kentucky,21,101700,1735,1493,13,1836688,11843,99637,1771,1737051,10072
2020-10-27,Louisiana,22,184724,922,5872,18,2723277,20711,184724,922,2538553,19789
2020-10-27,Maine,23,6311,57,146,0,595786,7133,6311,57,589475,7076
2020-10-27,Maryland,24,142237,903,4108,9,1898094,9723,141741,897,1756353,8826
2020-10-27,Massachusetts,25,153037,1260,9888,7,2669651,13962,153037,1260,2516614,12702
2020-10-27,Michigan,26,182284,2660,7585,34,4693470,41082,182344,2675,4511126,38407
2020-10-27,Minnesota,27,137589,2164,2421,15,1792078,7766,137536,2164,1654542,5602
2020-10-27,Mississippi,28,116617,854,3283,20,846161,854,116617,854,729544,0
2020-10-27,Missouri,29,179457,1724,2912,43,1474405,8456,172717,1695,1301688,6761
2020-10-27,Montana,30,29422,842,309,5,481322,4997,29346,845,451976,4152
2020-10-27,Nebraska,31,65376,870,623,14,572760,2926,64499,702,508261,2224
2020-10-27,Nevada,32,97138,808,1757,6,794921,3600,96908,730,698013,2870
2020-10-27,New Hampshire,33,10530,133,475,0,334409,1294,10531,134,323878,1160
2020-10-27,New Jersey,34,233120,1647,16306,14,4484813,29579,231331,1647,4253482,27932
2020-10-27,New Mexico,35,43169,583,980,4,1129419,4497,43169,583,1086250,3914
2020-10-27,New York,36,503387,1994,33092,19,13945858,111618,498646,1991,13447212,109627
2020-10-27,North Carolina,37,264334,2175,4236,36,3890764,17851,263883,2141,3626881,15710
2020-10-27,North Dakota,38,39135,889,481,15,286196,1718,39130,889,247066,829
2020-10-27,Northern Mariana Islands,69,92,0,2,0,16085,270,92,0,15993,270
2020-10-27,Ohio,39,202740,2509,5239,22,4282604,46941,202740,2509,4079864,44432
2020-10-27,Oklahoma,40,118409,1010,1273,22,1564476,30053,118409,1010,1446067,29043
2020-10-27,Oregon,41,42821,367,665,8,836995,6711,42808,372,794187,6339
2020-10-27,Pennsylvania,42,203520,2272,8760,23,2452969,15844,198446,2751,2254523,13093
2020-10-27,Puerto Rico,72,63497,362,808,4,338433,263,32461,263,305972,0
2020-10-27,Rhode Island,44,31445,421,1188,4,423469,3577,31445,421,392024,3156
2020-10-27,South Carolina,45,172579,1078,3842,19,1745026,11794,172579,1078,1572447,10716
2020-10-27,South Dakota,46,40730,989,375,0,249165,2071,40730,989,208435,1082
2020-10-27,Tennessee,47,247688,1928,3176,44,3586241,16806,251774,1908,3334467,14898
2020-10-27,Texas,48,924458,7291,18155,78,7883440,74290,874367,7292,7009073,66998
2020-10-27,Utah,49,107246,1163,579,4,1013395,6593,107228,1145,906167,5448
2020-10-27,Vermont,50,2113,30,58,0,186291,233,2113,30,184178,203
2020-10-27,Virgin Islands,78,1351,3,21,0,23659,42,1351,3,22308,39
2020-10-27,Virginia,51,175409,1134,3600,19,2555585,18316,175409,1134,2380176,17182
2020-10-27,Washington,53,108966,573,2438,10,2372596,12209,103500,587,2269096,11622
2020-10-27,West Virginia,54,22706,483,432,8,743737,7361,22706,483,721031,6878
2020-10-27,Wisconsin,55,217447,5331,1896,71,2006587,16767,217429,5501,1789158,11266
2020-10-27,Wyoming,56,11806,329,77,0,125492,329,11806,329,113686,0
2020-10-28,Alabama,01,187706,1269,2911,19,1347632,7747,187706,1269,1159926,6478
2020-10-28,Alaska,02,15053,354,67,1,580599,3170,14131,352,566468,2818
2020-10-28,Arizona,04,241259,1101,5906,15,1736979,6817,241165,1043,1495814,5774
2020-10-28,Arkansas,05,108640,961,1875,18,1320831,9977,108640,961,1212191,9016
2020-10-28,California,06,922680,4053,17541,63,18223596,96547,908713,4515,17314883,92032
2020-10-28,Colorado,08,100614,1503,2277,12,1191858,8104,100208,1475,1091650,6629
2020-10-28,Connecticut,09,69127,490,4604,9,2235373,14339,69127,490,2166246,13849
2020-10-28,Delaware,10,24392,143,688,2,344939,1798,24392,143,320547,1655
2020-10-28,District of Columbia,11,16973,67,644,0,505407,2869,16973,67,488434,2802
2020-10-28,Florida,12,790418,4115,16570,66,6030177,38539,780220,4005,5249957,34534
2020-10-28,Georgia,13,367126,1628,7692,31,3495407,20516,355025,1653,3140382,18863
2020-10-28,Guam,66,5435,48,77,1,65664,619,4466,48,61198,571
2020-10-28,Hawaii,15,14975,55,212,-2,310131,64,14978,64,295153,0
2020-10-28,Idaho,16,62197,915,600,12,382784,2252,60923,882,321861,1370
2020-10-28,Illinois,17,395204,6116,9912,52,7463755,70752,393808,6110,7069947,64642
2020-10-28,Indiana,18,171566,2570,4227,33,1657090,10548,169112,2548,1487978,8000
2020-10-28,Iowa,19,120911,2059,1691,11,873362,4342,113042,1781,760320,2561
2020-10-28,Kansas,20,83485,2724,1007,28,633033,7102,82045,3369,550988,3733
2020-10-28,Kentucky,21,103685,1985,1509,16,1847286,10598,101494,1857,1745792,8741
2020-10-28,Louisiana,22,185822,1098,5890,18,2738401,15124,185822,1098,2552579,14026
2020-10-28,Maine,23,6387,76,146,0,603303,7517,6387,76,596916,7441
2020-10-28,Maryland,24,142918,681,4115,7,1905952,7858,142425,684,1763527,7174
2020-10-28,Massachusetts,25,154218,1181,9924,36,2688340,18689,154218,1181,2534122,17508
2020-10-28,Michigan,26,185818,3534,7606,21,4748002,54532,185934,3590,4562068,50942
2020-10-28,Minnesota,27,139497,1908,2440,19,1801504,9426,139444,1908,1662060,7518
2020-10-28,Mississippi,28,117617,1000,3302,19,881604,35443,117617,1000,763987,34443
2020-10-28,Missouri,29,181877,2420,2940,28,1481236,6831,174632,1915,1306604,4916
2020-10-28,Montana,30,30051,629,326,17,484470,3148,29966,620,454504,2528
2020-10-28,Nebraska,31,66545,1169,629,6,577023,4263,65376,877,511647,3386
2020-10-28,Nevada,32,97824,686,1767,10,798250,3329,97479,571,700771,2758
2020-10-28,New Hampshire,33,10641,111,478,3,336063,1654,10641,110,325422,1544
2020-10-28,New Jersey,34,234790,1670,16324,18,4523611,38798,232997,1666,4290614,37132
2020-10-28,New Mexico,35,43826,657,991,11,1141186,11767,43826,657,1097360,11110
2020-10-28,New York,36,505416,2029,33107,15,14075518,129660,500677,2031,13574841,127629
2020-10-28,North Carolina,37,266566,2232,4275,39,3923042,32278,266136,2253,3656906,30025
2020-10-28,North Dakota,38,39912,777,493,12,287524,1328,39907,777,247617,551
2020-10-28,Northern Mariana Islands,69,92,0,2,0,16085,0,92,0,15993,0
2020-10-28,Ohio,39,205347,2607,5256,17,4314037,31433,205347,2607,4108690,28826
2020-10-28,Oklahoma,40,119152,743,1286,13,1575866,11390,119152,743,1456714,10647
2020-10-28,Oregon,41,43228,407,673,8,841049,4054,43228,420,797821,3634
2020-10-28,Pennsylvania,42,205852,2332,8789,29,2469920,16951,200674,2228,2269246,14723
2020-10-28,Puerto Rico,72,63587,90,813,5,338499,66,32527,66,305972,0
2020-10-28,Rhode Island,44,31944,499,1192,4,426355,2886,31944,499,394411,2387
2020-10-28,South Carolina,45,173491,912,3876,34,1753781,8755,173491,912,1580290,7843
2020-10-28,South Dakota,46,42000,1270,384,9,251296,2131,42000,1270,209296,861
2020-10-28,Tennessee,47,250269,2581,3209,33,3608613,22372,254220,2446,3354393,19926
2020-10-28,Texas,48,932206,7748,18251,96,7933477,50037,879994,5627,7053483,44410
2020-10-28,Utah,49,108863,1617,588,9,1019962,6567,108803,1575,911159,4992
2020-10-28,Vermont,50,2120,7,58,0,187037,746,2120,7,184917,739
2020-10-28,Virgin Islands,78,1353,2,21,0,23945,286,1353,2,22592,284
2020-10-28,Virginia,51,176754,1345,3616,16,2575759,20174,176754,1345,2399005,18829
2020-10-28,Washington,53,109865,899,2454,16,2362595,-10001,104027,527,2258568,-10528
2020-10-28,West Virginia,54,23064,358,436,4,748959,5222,23064,358,725895,4864
2020-10-28,Wisconsin,55,221578,4131,1953,57,2016720,10133,221559,4130,1795161,6003
2020-10-28,Wyoming,56,12146,340,77,0,125832,340,12146,340,113686,0
2020-10-29,Alabama,01,189149,1443,2914,3,1355047,7415,189149,1443,1165898,5972
2020-10-29,Alaska,02,15417,364,72,5,584268,3669,14481,350,569787,3319
2020-10-29,Arizona,04,242510,1251,5920,14,1751307,14328,242480,1315,1508827,13013
2020-10-29,Arkansas,05,109712,1072,1894,19,1333414,12583,109712,1072,1223702,11511
2020-10-29,California,06,926893,4213,17567,26,18323771,100175,912904,4191,17410867,95984
2020-10-29,Colorado,08,102665,2051,2295,18,1203209,11351,102014,1806,1101195,9545
2020-10-29,Connecticut,09,70446,1319,4609,5,2257892,22519,70446,1319,2187446,21200
2020-10-29,Delaware,10,24553,161,689,1,346423,1484,24553,161,321870,1323
2020-10-29,District of Columbia,11,17074,101,645,1,509864,4457,17074,101,492790,4356
2020-10-29,Florida,12,794616,4198,16647,77,6068498,38321,784331,4111,5284167,34210
2020-10-29,Georgia,13,368840,1714,7737,45,3516162,20755,356848,1823,3159314,18932
2020-10-29,Guam,66,5518,83,79,2,66385,721,4549,83,61836,638
2020-10-29,Hawaii,15,15046,71,214,2,310192,61,15039,61,295153,0
2020-10-29,Idaho,16,63195,998,618,18,385806,3022,61785,862,324021,2160
2020-10-29,Illinois,17,401622,6418,9963,51,7546811,83056,400171,6363,7146640,76693
2020-10-29,Indiana,18,175190,3624,4260,33,1671093,14003,172730,3618,1498363,10385
2020-10-29,Iowa,19,123232,2321,1705,14,878864,5502,114982,1940,763882,3562
2020-10-29,Kansas,20,83838,353,1008,1,633033,0,82045,0,550988,0
2020-10-29,Kentucky,21,105517,1832,1524,15,1857453,10167,103305,1811,1754148,8356
2020-10-29,Louisiana,22,186216,394,5908,18,2751797,13396,186216,394,2565581,13002
2020-10-29,Maine,23,6467,80,146,0,611912,8609,6467,80,605445,8529
2020-10-29,Maryland,24,143875,957,4127,12,1916848,10896,143387,962,1773461,9934
2020-10-29,Massachusetts,25,155564,1346,9951,27,2706776,18436,155564,1346,2551212,17090
2020-10-29,Michigan,26,189926,4108,7651,45,4800717,52715,190043,4109,4610674,48606
2020-10-29,Minnesota,27,142364,2867,2472,32,1820395,18891,142311,2867,1678084,16024
2020-10-29,Mississippi,28,118587,970,3310,8,922851,41247,118587,970,804264,40277
2020-10-29,Missouri,29,184847,2970,2978,38,1490617,9381,177693,3061,1312924,6320
2020-10-29,Montana,30,30932,881,339,13,487607,3137,30853,887,456754,2250
2020-10-29,Nebraska,31,68150,1605,641,12,580729,3706,66545,1169,514184,2537
2020-10-29,Nevada,32,98814,990,1770,3,798618,368,98554,1075,700064,-707
2020-10-29,New Hampshire,33,10768,127,482,4,338508,2445,10768,127,327740,2318
2020-10-29,New Jersey,34,236340,1550,16332,8,4572531,48920,234547,1550,4337984,47370
2020-10-29,New Mexico,35,44904,1078,994,3,1153185,11999,44904,1078,1108281,10921
2020-10-29,New York,36,507913,2497,33128,21,14243871,168353,503176,2499,13740695,165854
2020-10-29,North Carolina,37,269419,2853,4307,32,3961343,38301,269021,2885,3692322,35416
2020-10-29,North Dakota,38,41135,1223,504,11,289520,1996,41130,1223,248390,773
2020-10-29,Northern Mariana Islands,69,92,0,2,0,16085,0,92,0,15993,0
2020-10-29,Ohio,39,208937,3590,5275,19,4365090,51053,208937,3590,4156153,47463
2020-10-29,Oklahoma,40,120193,1041,1306,20,1586185,10319,120193,1041,1465992,9278
2020-10-29,Oregon,41,43793,565,674,1,848795,7746,43793,565,805002,7181
2020-10-29,Pennsylvania,42,208087,2235,8828,39,2485704,15784,202876,2202,2282828,13582
2020-10-29,Puerto Rico,72,64798,1211,814,1,339251,752,33279,752,305972,0
2020-10-29,Rhode Island,44,32312,368,1195,3,429340,2985,32312,368,397028,2617
2020-10-29,South Carolina,45,174591,1100,3889,13,1773742,19961,174591,1100,1599151,18861
2020-10-29,South Dakota,46,43000,1000,403,19,253514,2218,43000,1000,210514,1218
2020-10-29,Tennessee,47,252727,2458,3229,20,3637643,29030,256880,2660,3380763,26370
2020-10-29,Texas,48,939292,7086,18372,121,8005112,71635,886820,6826,7118292,64809
2020-10-29,Utah,49,110666,1803,598,10,1029872,9910,110640,1837,919232,8073
2020-10-29,Vermont,50,2141,21,58,0,188102,1065,2141,21,185961,1044
2020-10-29,Virgin Islands,78,1353,0,21,0,23945,0,1353,0,22592,0
2020-10-29,Virginia,51,178183,1429,3636,20,2596604,20845,178183,1429,2418421,19416
2020-10-29,Washington,53,110748,883,2463,9,2383332,20737,104743,716,2278589,20021
2020-10-29,West Virginia,54,23466,402,443,7,759646,10687,23466,402,736180,10285
2020-10-29,Wisconsin,55,226712,5134,2008,55,2030170,13450,226705,5146,1803465,8304
2020-10-29,Wyoming,56,12507,361,87,10,129462,3630,12507,361,116955,3269
2020-10-30,Alabama,01,190496,1347,2932,18,1363465,8418,190496,1347,1172969,7071
2020-10-30,Alaska,02,15803,386,76,4,586323,2055,14858,377,571465,1678
2020-10-30,Arizona,04,244099,1589,5934,14,1764784,13477,244045,1565,1520739,11912
2020-10-30,Arkansas,05,110874,1162,1900,6,1345040,11626,110874,1162,1234166,10464
2020-10-30,California,06,931826,4933,17627,60,18444523,120752,916918,4014,17527605,116738
2020-10-30,Colorado,08,104927,2262,2302,7,1214467,11258,104426,2412,1110041,8846
2020-10-30,Connecticut,09,71207,761,4616,7,2288584,30692,71207,761,2217377,29931
2020-10-30,Delaware,10,24751,198,704,15,348527,2104,24751,198,323776,1906
2020-10-30,District of Columbia,11,17144,70,646,1,514130,4266,17144,70,496986,4196
2020-10-30,Florida,12,800208,5592,16719,72,6073881,5383,789714,5383,5284167,0
2020-10-30,Georgia,13,370157,1317,7768,31,3559307,43145,358225,1377,3201082,41768
2020-10-30,Guam,66,5597,79,80,1,67029,644,4628,79,62401,565
2020-10-30,Hawaii,15,15145,99,215,1,310269,77,15116,77,295153,0
2020-10-30,Idaho,16,64175,980,627,9,388785,2979,62746,961,326039,2018
2020-10-30,Illinois,17,410141,8519,10012,49,7643468,96657,408660,8489,7234808,88168
2020-10-30,Indiana,18,178372,3182,4286,26,1684783,13690,175893,3163,1508890,10527
2020-10-30,Iowa,19,125973,2741,1714,9,884252,5388,117185,2203,767067,3185
2020-10-30,Kansas,20,86768,2930,1029,21,642782,9749,85181,3136,557601,6613
2020-10-30,Kentucky,21,107620,2103,1543,19,1892860,35407,105242,1937,1787618,33470
2020-10-30,Louisiana,22,186649,433,5919,11,2763671,11874,186649,433,2577022,11441
2020-10-30,Maine,23,6570,103,146,0,623413,11501,6570,103,616843,11398
2020-10-30,Maryland,24,144800,925,4137,10,1926518,9670,144314,927,1782204,8743
2020-10-30,Massachusetts,25,157146,1582,9975,24,2727118,20342,157146,1582,2569972,18760
2020-10-30,Michigan,26,193360,3434,7664,13,4862083,61366,193388,3345,4668695,58021
2020-10-30,Minnesota,27,145519,3155,2491,19,1836799,16404,145465,3154,1691334,13250
2020-10-30,Mississippi,28,119336,749,3328,18,923600,749,119336,749,804264,0
2020-10-30,Missouri,29,187830,2983,3014,36,1499282,8665,180200,2507,1319082,6158
2020-10-30,Montana,30,31995,1063,368,29,492629,5022,31916,1063,460713,3959
2020-10-30,Nebraska,31,69645,1495,646,5,586098,5369,68150,1605,517948,3764
2020-10-30,Nevada,32,100038,1224,1777,7,803585,4967,99786,1232,703799,3735
2020-10-30,New Hampshire,33,10884,116,482,0,338696,188,10884,116,327812,72
2020-10-30,New Jersey,34,238316,1976,16339,7,4574507,1976,236523,1976,4337984,0
2020-10-30,New Mexico,35,45909,1005,1007,13,1161887,8702,45909,1005,1115978,7697
2020-10-30,New York,36,510171,2258,33143,15,14390756,146885,505431,2255,13885325,144630
2020-10-30,North Carolina,37,272231,2812,4354,47,4005791,44448,271830,2809,3733961,41639
2020-10-30,North Dakota,38,42488,1353,517,13,291938,2418,42483,1353,249455,1065
2020-10-30,Northern Mariana Islands,69,92,0,2,0,16085,0,92,0,15993,0
2020-10-30,Ohio,39,212782,3845,5291,16,4413936,48846,212782,3845,4201154,45001
2020-10-30,Oklahoma,40,121495,1302,1326,20,1601775,15590,121495,1302,1480280,14288
2020-10-30,Oregon,41,44388,595,677,3,854938,6143,44389,596,810549,5547
2020-10-30,Pennsylvania,42,210586,2499,8860,32,2503500,17796,205517,2641,2297983,15155
2020-10-30,Puerto Rico,72,65743,945,820,6,339825,574,33853,574,305972,0
2020-10-30,Rhode Island,44,32874,562,1201,6,432876,3536,32874,562,400002,2974
2020-10-30,South Carolina,45,175594,1003,3896,7,1788360,14618,175594,1003,1612766,13615
2020-10-30,South Dakota,46,44559,1559,415,12,256656,3142,44559,1559,212097,1583
2020-10-30,Tennessee,47,255332,2605,3307,78,3662089,24446,259488,2608,3402601,21838
2020-10-30,Texas,48,945948,6656,18477,105,8080012,74900,893451,6631,7186561,68269
2020-10-30,Utah,49,112932,2266,601,3,1039515,9643,112932,2292,926583,7351
2020-10-30,Vermont,50,2155,14,58,0,188683,581,2155,14,186528,567
2020-10-30,Virgin Islands,78,1362,9,21,0,24219,274,1362,9,22857,265
2020-10-30,Virginia,51,179639,1456,3643,7,2619752,23148,179639,1456,2440113,21692
2020-10-30,Washington,53,111893,1145,2468,5,2405352,22020,105557,814,2299795,21206
2020-10-30,West Virginia,54,23990,524,451,8,769302,9656,23990,524,745312,9132
2020-10-30,Wisconsin,55,232092,5380,2034,26,2049123,18953,232062,5357,1817061,13596
2020-10-30,Wyoming,56,13028,521,87,0,129983,521,13028,521,116955,0
2020-10-31,Alabama,01,192285,1789,2967,35,1374243,10778,192285,1789,1181958,8989
2020-10-31,Alaska,02,16247,444,77,1,604207,17884,15312,454,588895,17430
2020-10-31,Arizona,04,245962,1863,5979,45,1777369,12585,245946,1901,1531423,10684
2020-10-31,Arkansas,05,112190,1316,1925,25,1355680,10640,112190,1316,1243490,9324
2020-10-31,California,06,935248,3422,17661,34,18602317,157794,922005,5087,17680312,152707
2020-10-31,Colorado,08,107844,2917,2309,7,1229406,14939,107350,2924,1122056,12015
2020-10-31,Connecticut,09,71207,0,4616,0,2288584,0,71207,0,2217377,0
2020-10-31,Delaware,10,24951,200,708,4,350728,2201,24951,200,325777,2001
2020-10-31,District of Columbia,11,17266,122,646,0,514252,122,17266,122,496986,0
2020-10-31,Florida,12,802539,2331,16760,41,6126792,52911,791997,2283,5334795,50628
2020-10-31,Georgia,13,372631,2474,7790,22,3586394,27087,360790,2565,3225604,24522
2020-10-31,Guam,66,5650,53,80,0,67452,423,4681,53,62771,370
2020-10-31,Hawaii,15,15207,62,218,3,310369,100,15216,100,295153,0
2020-10-31,Idaho,16,64797,622,630,3,391890,3105,63810,1064,328080,2041
2020-10-31,Illinois,17,416557,6416,10030,18,7736104,92636,416559,7899,7319545,84737
2020-10-31,Indiana,18,181837,3465,4332,46,1699008,14225,179358,3465,1519650,10760
2020-10-31,Iowa,19,128798,2825,1716,2,890432,6180,119755,2570,770677,3610
2020-10-31,Kansas,20,86771,3,1029,0,642782,0,85181,0,557601,0
2020-10-31,Kentucky,21,109244,1624,1551,8,1912810,19950,107219,1977,1805591,17973
2020-10-31,Louisiana,22,186649,0,5919,0,2763671,0,186649,0,2577022,0
2020-10-31,Maine,23,6668,98,147,1,623511,98,6668,98,616843,0
2020-10-31,Maryland,24,145593,793,4147,10,1938672,12154,145281,967,1793391,11187
2020-10-31,Massachusetts,25,158576,1430,9991,16,2745378,18260,158576,1430,2586802,16830
2020-10-31,Michigan,26,197164,3804,7699,35,4911592,49509,197406,4018,4714186,45491
2020-10-31,Minnesota,27,148526,3007,2511,20,1854258,17459,148472,3007,1705786,14452
2020-10-31,Mississippi,28,120160,824,3334,6,924424,824,120160,824,804264,0
2020-10-31,Missouri,29,189925,2095,3090,76,1510155,10873,183186,2986,1326969,7887
2020-10-31,Montana,30,32801,806,377,9,498915,6286,32801,885,466114,5401
2020-10-31,Nebraska,31,70732,1087,652,6,591018,4920,69645,1495,521373,3425
2020-10-31,Nevada,32,100844,806,1779,2,808487,4902,100763,977,707724,3925
2020-10-31,New Hampshire,33,11084,200,483,1,345085,6389,11084,200,334001,6189
2020-10-31,New Jersey,34,239679,1363,16350,11,4656106,81599,237886,1363,4418220,80236
2020-10-31,New Mexico,35,46490,581,1018,11,1172720,10833,46490,581,1126230,10252
2020-10-31,New York,36,512223,2052,33152,9,14527718,136962,507480,2049,14020238,134913
2020-10-31,North Carolina,37,274805,2574,4400,46,4055156,49365,274635,2805,3780521,46560
2020-10-31,North Dakota,38,43921,1433,529,12,294064,2126,43916,1433,250148,693
2020-10-31,Northern Mariana Islands,69,92,0,2,0,16085,0,92,0,15993,0
2020-10-31,Ohio,39,215697,2915,5301,10,4471680,57744,215697,2915,4255983,54829
2020-10-31,Oklahoma,40,122762,1267,1337,11,1617394,15619,122762,1267,1494632,14352
2020-10-31,Oregon,41,44923,535,690,13,861949,7011,44921,532,817028,6479
2020-10-31,Pennsylvania,42,212816,2230,8883,23,2522661,19161,208027,2510,2314634,16651
2020-10-31,Puerto Rico,72,66128,385,822,2,340110,285,34138,285,305972,0
2020-10-31,Rhode Island,44,32874,0,1201,0,436561,3685,33408,534,403153,3151
2020-10-31,South Carolina,45,176612,1018,3935,39,1802050,13690,176612,1018,1625438,12672
2020-10-31,South Dakota,46,45992,1433,425,10,259532,2876,45992,1433,213540,1443
2020-10-31,Tennessee,47,256923,1591,3322,15,3671773,9684,260672,1184,3411101,8500
2020-10-31,Texas,48,953439,7491,18549,72,8154233,74221,900596,7145,7253637,67076
2020-10-31,Utah,49,114670,1738,604,3,1046819,7304,114656,1724,932163,5580
2020-10-31,Vermont,50,2179,24,58,0,189680,997,2179,24,187501,973
2020-10-31,Virgin Islands,78,1376,14,21,0,24430,211,1376,14,23054,197
2020-10-31,Virginia,51,181190,1551,3654,11,2639539,19787,181190,1551,2458349,18236
2020-10-31,Washington,53,112580,687,2468,0,2426385,21033,106573,1016,2319812,20017
2020-10-31,West Virginia,54,24460,470,457,6,778494,9192,24460,470,754034,8722
2020-10-31,Wisconsin,55,237870,5778,2092,58,2064506,15383,237870,5808,1826636,9575
2020-10-31,Wyoming,56,13298,270,87,0,130560,577,13298,270,117262,307
2020-11-01,Alabama,01,193985,1700,2973,6,1381326,7083,193985,1700,1187341,5383
2020-11-01,Alaska,02,16597,350,78,1,604207,0,15663,351,588544,-351
2020-11-01,Arizona,04,247484,1522,5981,2,1791644,14275,247473,1527,1544171,12748
2020-11-01,Arkansas,05,113057,867,1958,33,1355680,0,112190,0,1243490,0
2020-11-01,California,06,938883,3635,17671,10,18743315,140998,926534,4529,17816781,136469
2020-11-01,Colorado,08,110640,2796,2312,3,1243467,14061,109910,2560,1133557,11501
2020-11-01,Connecticut,09,71207,0,4616,0,2288584,0,71207,0,2217377,0
2020-11-01,Delaware,10,25126,175,710,2,352348,1620,25126,175,327222,1445
2020-11-01,District of Columbia,11,17369,103,646,0,525246,10994,17369,103,507877,10891
2020-11-01,Florida,12,807404,4865,16788,28,6175891,49099,796802,4805,5379089,44294
2020-11-01,Georgia,13,373700,1069,7792,2,3587586,1192,361982,1192,3225604,0
2020-11-01,Guam,66,5659,9,80,0,67563,111,4690,9,62873,102
2020-11-01,Hawaii,15,15287,80,218,0,310437,68,15284,68,295153,0
2020-11-01,Idaho,16,65272,475,631,1,394191,2301,64608,798,329583,1503
2020-11-01,Illinois,17,424860,8303,10091,61,7814562,78458,423539,6980,7391023,71478
2020-11-01,Indiana,18,184589,2752,4364,32,1709944,10936,182108,2750,1527836,8186
2020-11-01,Iowa,19,131097,2299,1733,17,897175,6743,121967,2212,775208,4531
2020-11-01,Kansas,20,86809,38,1029,0,642782,0,85181,0,557601,0
2020-11-01,Kentucky,21,110600,1356,1554,3,1914233,1423,108642,1423,1805591,0
2020-11-01,Louisiana,22,187720,1071,5926,7,2783118,19447,187720,1071,2595398,18376
2020-11-01,Maine,23,6715,47,147,0,623558,47,6715,47,616843,0
2020-11-01,Maryland,24,146627,1034,4152,5,1949180,10508,146145,864,1803035,9644
2020-11-01,Massachusetts,25,159707,1131,10013,22,2762094,16716,159707,1131,2602387,15585
2020-11-01,Michigan,26,197501,337,7700,1,4911592,0,197406,0,4714186,0
2020-11-01,Minnesota,27,150726,2200,2529,18,1869845,15587,150672,2200,1719173,13387
2020-11-01,Mississippi,28,120500,340,3348,14,924764,340,120500,340,804264,0
2020-11-01,Missouri,29,192141,2216,3091,1,1518716,8561,185535,2349,1333181,6212
2020-11-01,Montana,30,33495,694,378,1,501704,2789,33495,694,468209,2095
2020-11-01,Nebraska,31,71666,934,658,6,594432,3414,70732,1087,523700,2327
2020-11-01,Nevada,32,101594,750,1783,4,813190,4703,101479,716,711711,3987
2020-11-01,New Hampshire,33,11214,130,483,0,347135,2050,11214,130,335921,1920
2020-11-01,New Jersey,34,241422,1743,16354,4,4657849,1743,239629,1743,4418220,0
2020-11-01,New Mexico,35,47232,742,1026,8,1182514,9794,47232,742,1135282,9052
2020-11-01,New York,36,514482,2259,33174,22,14676653,148935,509735,2255,14166918,146680
2020-11-01,North Carolina,37,276706,1901,4405,5,4095365,40209,276692,2057,3818673,38152
2020-11-01,North Dakota,38,45048,1127,536,7,295793,1729,45043,1127,250750,602
2020-11-01,Northern Mariana Islands,69,96,4,2,0,16089,4,96,4,15993,0
2020-11-01,Ohio,39,219000,3303,5303,2,4524758,53078,219000,3303,4305758,49775
2020-11-01,Oklahoma,40,124111,1349,1345,8,1618743,1349,124111,1349,1494632,0
2020-11-01,Oregon,41,45419,496,691,1,867792,5843,45429,508,822363,5335
2020-11-01,Pennsylvania,42,214500,1684,8888,5,2537746,15085,209936,1909,2327810,13176
2020-11-01,Puerto Rico,72,66661,533,832,10,340513,403,34541,403,305972,0
2020-11-01,Rhode Island,44,32874,0,1201,0,439334,2773,33888,480,405446,2293
2020-11-01,South Carolina,45,178023,1411,3936,1,1827352,25302,178023,1411,1649329,23891
2020-11-01,South Dakota,46,47324,1332,437,12,262165,2633,47324,1332,214841,1301
2020-11-01,Tennessee,47,257658,735,3322,0,3683173,11400,261426,754,3421747,10646
2020-11-01,Texas,48,957789,4350,18582,33,8218245,64012,904855,4259,7313390,59753
2020-11-01,Utah,49,116510,1840,614,10,1053391,6572,116510,1854,936881,4718
2020-11-01,Vermont,50,2196,17,58,0,190108,428,2196,17,187912,411
2020-11-01,Virgin Islands,78,1376,0,21,0,24430,0,1376,0,23054,0
2020-11-01,Virginia,51,182392,1202,3655,1,2661376,21837,182392,1202,2478984,20635
2020-11-01,Washington,53,113109,529,2468,0,2450122,23737,107501,928,2342621,22809
2020-11-01,West Virginia,54,24883,423,457,0,787586,9092,24883,423,762703,8669
2020-11-01,Wisconsin,55,241423,3553,2110,18,2082628,18122,241423,3553,1841205,14569
2020-11-01,Wyoming,56,13723,425,87,0,130985,425,13723,425,117262,0
2020-11-02,Alabama,01,194892,907,2973,0,1385328,4002,194892,907,1190436,3095
2020-11-02,Alaska,02,16948,351,79,1,620170,15963,16007,344,604163,15619
2020-11-02,Arizona,04,248293,809,5982,1,1798521,6877,248139,666,1550382,6211
2020-11-02,Arkansas,05,113641,584,1985,27,1372367,16687,113641,1451,1258726,15236
2020-11-02,California,06,944141,5258,17700,29,18912501,169186,930628,4094,17981873,165092
2020-11-02,Colorado,08,112821,2181,2320,8,1256328,12861,112147,2237,1144181,10624
2020-11-02,Connecticut,09,73858,2651,4627,11,2367994,79410,73858,2651,2294136,76759
2020-11-02,Delaware,10,25311,185,710,0,354670,2322,25311,185,329359,2137
2020-11-02,District of Columbia,11,17438,69,647,1,528174,2928,17438,69,510736,2859
2020-11-02,Florida,12,812055,4651,16833,45,6200385,24494,801371,4569,5399014,19925
2020-11-02,Georgia,13,377261,3561,7810,18,3596700,9114,362921,939,3233779,8175
2020-11-02,Guam,66,5662,3,80,0,67664,101,4693,3,62971,98
2020-11-02,Hawaii,15,15359,72,218,0,310520,83,15367,83,295153,0
2020-11-02,Idaho,16,66249,977,641,10,396267,2076,65088,480,331179,1596
2020-11-02,Illinois,17,431281,6421,10115,24,7882680,68118,429761,6222,7452919,61896
2020-11-02,Indiana,18,187665,3076,4390,26,1722842,12898,185185,3077,1537657,9821
2020-11-02,Iowa,19,132697,1600,1755,22,900994,3819,123372,1405,777622,2414
2020-11-02,Kansas,20,90613,3804,1046,17,655267,12485,89227,4046,566040,8439
2020-11-02,Kentucky,21,111816,1216,1565,11,1943582,29349,109670,1028,1833912,28321
2020-11-02,Louisiana,22,187995,275,5934,8,2788484,5366,187995,275,2600489,5091
2020-11-02,Maine,23,6799,84,148,1,644435,20877,6799,84,637636,20793
2020-11-02,Maryland,24,147477,850,4155,3,1960445,11265,146995,850,1813450,10415
2020-11-02,Massachusetts,25,160549,842,10023,10,2776247,14153,160549,842,2615698,13311
2020-11-02,Michigan,26,204135,6634,7716,16,5008299,96707,204326,6920,4803973,89787
2020-11-02,Minnesota,27,153674,2948,2538,9,1892909,23064,153620,2948,1739289,20116
2020-11-02,Mississippi,28,120865,365,3348,0,958073,33309,120865,365,837208,32944
2020-11-02,Missouri,29,195938,3797,3101,10,1528098,9382,188186,2651,1339912,6731
2020-11-02,Montana,30,34317,822,387,9,508931,7227,34252,757,474679,6470
2020-11-02,Nebraska,31,72631,965,659,1,597204,2772,71666,934,525538,1838
2020-11-02,Nevada,32,102243,649,1785,2,816433,3243,102114,635,714319,2608
2020-11-02,New Hampshire,33,11320,106,483,0,348198,1063,11320,106,336878,957
2020-11-02,New Jersey,34,242790,1368,16357,3,4721797,63948,240997,1368,4480800,62580
2020-11-02,New Mexico,35,48104,872,1036,10,1191327,8813,48104,872,1143223,7941
2020-11-02,New York,36,516114,1632,33187,13,14772754,96101,511368,1633,14261386,94468
2020-11-02,North Carolina,37,278477,1771,4413,8,4127596,32231,278028,1336,3849568,30895
2020-11-02,North Dakota,38,46020,972,545,9,297447,1654,46015,972,251432,682
2020-11-02,Northern Mariana Islands,69,96,0,2,0,16089,0,96,0,15993,0
2020-11-02,Ohio,39,221909,2909,5340,37,4564903,40145,221909,2909,4342994,37236
2020-11-02,Oklahoma,40,125195,1084,1354,9,1619827,1084,125195,1084,1494632,0
2020-11-02,Oregon,41,45978,559,694,3,871900,4108,45978,549,825922,3559
2020-11-02,Pennsylvania,42,217243,2743,8893,5,2550660,12914,211996,2060,2338664,10854
2020-11-02,Puerto Rico,72,68172,1511,839,7,341377,864,35405,864,305972,0
2020-11-02,Rhode Island,44,34120,1246,1210,9,440626,1292,34120,232,406506,1060
2020-11-02,South Carolina,45,178917,894,3946,10,1842038,14686,178917,894,1663121,13792
2020-11-02,South Dakota,46,47850,526,438,1,263137,972,47850,526,215287,446
2020-11-02,Tennessee,47,260275,2617,3347,25,3720657,37484,264587,3161,3456070,34323
2020-11-02,Texas,48,965727,7938,18626,44,8291703,73458,909257,4402,7382446,69056
2020-11-02,Utah,49,117767,1257,614,0,1061170,7779,117706,1196,943464,6583
2020-11-02,Vermont,50,2219,23,58,0,190359,251,2219,23,188140,228
2020-11-02,Virgin Islands,78,1376,0,21,0,24519,89,1378,2,23141,87
2020-11-02,Virginia,51,183418,1026,3658,3,2677061,15685,183418,1026,2493643,14659
2020-11-02,Washington,53,114787,1678,2484,16,2469146,19024,108315,814,2360831,18210
2020-11-02,West Virginia,54,25235,352,458,1,794491,6905,25235,352,769256,6553
2020-11-02,Wisconsin,55,244974,3551,2117,7,2091546,8918,244928,3505,1846618,5413
2020-11-02,Wyoming,56,14167,444,87,0,134018,3033,14167,444,119851,2589
2020-11-03,Alabama,01,195929,1037,2987,14,1392351,7023,195929,1037,1196422,5986
2020-11-03,Alaska,02,17339,391,79,0,624755,4585,16390,383,608365,4202
2020-11-03,Arizona,04,249841,1548,6022,40,1809271,10750,249818,1679,1559453,9071
2020-11-03,Arkansas,05,114519,878,2003,18,1378181,5814,114519,878,1263662,4936
2020-11-03,California,06,949383,5242,17751,51,19074921,162420,934672,4044,18140249,158376
2020-11-03,Colorado,08,115364,2543,2337,17,1267145,10817,114709,2562,1152436,8255
2020-11-03,Connecticut,09,74843,985,4635,8,2367994,0,73858,0,2294136,0
2020-11-03,Delaware,10,25426,115,712,2,355667,997,25426,115,330241,882
2020-11-03,District of Columbia,11,17524,86,647,0,533419,5245,17524,86,515895,5159
2020-11-03,Florida,12,816692,4637,16889,56,6225760,25375,805924,4553,5419836,20822
2020-11-03,Georgia,13,378894,1633,7837,27,3618830,22130,364589,1668,3254241,20462
2020-11-03,Guam,66,5781,119,81,1,69028,1364,4812,119,64216,1245
2020-11-03,Hawaii,15,15441,82,218,0,310597,77,15444,77,295153,0
2020-11-03,Idaho,16,67504,1255,649,8,398739,2472,65845,757,332894,1715
2020-11-03,Illinois,17,437879,6598,10177,62,7965115,82435,436277,6516,7528838,75919
2020-11-03,Indiana,18,190555,2890,4439,49,1733575,10733,188066,2881,1545509,7852
2020-11-03,Iowa,19,134576,1879,1780,25,903136,2142,124464,1092,778672,1050
2020-11-03,Kansas,20,91072,459,1051,5,655267,0,89227,0,566040,0
2020-11-03,Kentucky,21,113457,1641,1578,13,1951791,8209,111379,1709,1840412,6500
2020-11-03,Louisiana,22,189148,1153,5951,17,2817860,29376,189148,1153,2628712,28223
2020-11-03,Maine,23,6926,127,148,0,647961,3526,6926,127,641035,3399
2020-11-03,Maryland,24,148249,772,4162,7,1967900,7455,147766,771,1820134,6684
2020-11-03,Massachusetts,25,161585,1036,10035,12,2790437,14190,161585,1036,2628852,13154
2020-11-03,Michigan,26,207799,3664,7758,42,5050490,42191,207763,3437,4842727,38754
2020-11-03,Minnesota,27,157150,3476,2553,15,1900013,7104,157096,3476,1742917,3628
2020-11-03,Mississippi,28,121509,644,3384,36,958717,644,121509,644,837208,0
2020-11-03,Missouri,29,198312,2374,3136,35,1539263,11165,190424,2238,1348839,8927
2020-11-03,Montana,30,35222,905,400,13,512524,3593,35159,907,477365,2686
2020-11-03,Nebraska,31,74060,1429,662,3,600064,2860,72620,954,527444,1906
2020-11-03,Nevada,32,103305,1062,1807,22,819896,3463,103025,911,716871,2552
2020-11-03,New Hampshire,33,11448,128,483,0,350194,1996,11448,128,338746,1868
2020-11-03,New Jersey,34,244614,1824,16371,14,4766659,44862,242825,1828,4523834,43034
2020-11-03,New Mexico,35,49240,1136,1045,9,1202347,11020,49240,1136,1153107,9884
2020-11-03,New York,36,518431,2317,33198,11,14900623,127869,513689,2321,14386934,125548
2020-11-03,North Carolina,37,280657,2180,4481,68,4157478,29882,280377,2349,3877101,27533
2020-11-03,North Dakota,38,47192,1172,561,16,299490,2043,47187,1172,252303,871
2020-11-03,Northern Mariana Islands,69,96,0,2,0,16089,0,96,0,15993,0
2020-11-03,Ohio,39,226138,4229,5373,33,4604715,39812,226138,4229,4378577,35583
2020-11-03,Oklahoma,40,126526,1331,1375,21,1647339,27512,126526,1331,1520813,26181
2020-11-03,Oregon,41,46460,482,701,7,877404,5504,46460,482,830944,5022
2020-11-03,Pennsylvania,42,220111,2868,8926,33,2569217,18557,214871,2875,2354346,15682
2020-11-03,Puerto Rico,72,68943,771,842,3,341722,345,35750,345,305972,0
2020-11-03,Rhode Island,44,34543,423,1212,2,443524,2898,34543,423,408981,2475
2020-11-03,South Carolina,45,179952,1035,3968,22,1855123,13085,179952,1035,1675171,12050
2020-11-03,South Dakota,46,48854,1004,446,8,265210,2073,48854,1004,216356,1069
2020-11-03,Tennessee,47,262053,1778,3419,72,3734564,13907,266357,1770,3468207,12137
2020-11-03,Texas,48,974228,8501,18722,96,8328869,37166,916773,7516,7412096,29650
2020-11-03,Utah,49,119375,1608,620,6,1068439,7269,119375,1669,949064,5600
2020-11-03,Vermont,50,2237,18,58,0,190127,-232,2237,18,187890,-250
2020-11-03,Virgin Islands,78,1385,9,22,1,24565,46,1385,7,23180,39
2020-11-03,Virginia,51,184679,1261,3666,8,2699771,22710,184679,1261,2515092,21449
2020-11-03,Washington,53,115608,821,2507,23,2470185,1039,109354,1039,2360831,0
2020-11-03,West Virginia,54,25593,358,469,11,800408,5917,25593,358,774815,5559
2020-11-03,Wisconsin,55,251227,6253,2179,62,2112994,21448,251032,6104,1861962,15344
2020-11-03,Wyoming,56,14619,452,93,6,135336,1318,14619,452,120717,866
2020-11-04,Alabama,01,197777,1848,3006,19,1401274,8923,197777,1848,1203497,7075
2020-11-04,Alaska,02,17750,411,79,0,627758,3003,16798,408,610960,2595
2020-11-04,Arizona,04,250853,1012,6059,37,1818497,9226,250633,815,1567864,8411
2020-11-04,Arkansas,05,115812,1293,2026,23,1389797,11616,115812,1293,1273985,10323
2020-11-04,California,06,954624,5241,17818,67,19181012,106091,940010,5338,18241002,100753
2020-11-04,Colorado,08,118356,2992,2366,29,1279847,12702,117637,2928,1162210,9774
2020-11-04,Connecticut,09,75373,530,4645,10,2401877,33883,75373,1515,2326504,32368
2020-11-04,Delaware,10,25534,108,712,0,356664,997,25534,108,331130,889
2020-11-04,District of Columbia,11,17601,77,647,0,537091,3672,17601,77,519490,3595
2020-11-04,Florida,12,821115,4423,16921,32,6247167,21407,810256,4332,5436911,17075
2020-11-04,Georgia,13,382113,3219,8303,466,3647278,28448,366452,1863,3280826,26585
2020-11-04,Guam,66,5872,91,84,3,69756,728,4903,91,64853,637
2020-11-04,Hawaii,15,15591,150,218,0,310684,87,15531,87,295153,0
2020-11-04,Idaho,16,68791,1287,665,16,401774,3035,67024,1179,334750,1856
2020-11-04,Illinois,17,445537,7658,10239,62,8036972,71857,443815,7538,7593157,64319
2020-11-04,Indiana,18,194261,3706,4464,25,1748496,14921,191764,3698,1556732,11223
2020-11-04,Iowa,19,137315,2739,1801,21,908054,4918,126740,2276,781314,2642
2020-11-04,Kansas,20,93967,2895,1087,36,663680,8413,92215,2988,571465,5425
2020-11-04,Kentucky,21,115426,1969,1593,15,1999654,47863,113009,1630,1886645,46233
2020-11-04,Louisiana,22,190164,1016,5975,24,2825919,8059,190164,1016,2635755,7043
2020-11-04,Maine,23,7077,151,150,2,657250,9289,7077,151,650173,9138
2020-11-04,Maryland,24,149232,983,4172,10,1979067,11167,148766,1000,1830301,10167
2020-11-04,Massachusetts,25,163299,1714,10062,27,2812539,22102,163299,1714,2649240,20388
2020-11-04,Michigan,26,212126,4327,7783,25,5093676,43186,212160,4397,4881516,38789
2020-11-04,Minnesota,27,160977,3827,2584,31,1920465,20452,160923,3827,1759542,16625
2020-11-04,Mississippi,28,122275,766,3397,13,959483,766,122275,766,837208,0
2020-11-04,Missouri,29,201515,3203,3166,30,1546955,7692,193023,2599,1353932,5093
2020-11-04,Montana,30,36012,790,404,4,517288,4764,35955,796,481333,3968
2020-11-04,Nebraska,31,75888,1828,673,11,603890,3826,74060,1440,529830,2386
2020-11-04,Nevada,32,104514,1209,1816,9,823543,3647,104093,1068,719450,2579
2020-11-04,New Hampshire,33,11563,115,484,1,351136,942,11563,115,339573,827
2020-11-04,New Jersey,34,247057,2443,16391,20,4769091,2432,245257,2432,4523834,0
2020-11-04,New Mexico,35,50251,1011,1059,14,1218805,16458,50251,1011,1168554,15447
2020-11-04,New York,36,520557,2126,33222,24,15034157,133534,515815,2126,14518342,131408
2020-11-04,North Carolina,37,283280,2623,4535,54,4184258,26780,282802,2425,3901456,24355
2020-11-04,North Dakota,38,48306,1114,573,12,301089,1599,48301,1114,252788,485
2020-11-04,Northern Mariana Islands,69,96,0,2,0,16089,0,96,0,15993,0
2020-11-04,Ohio,39,230209,4071,5428,55,4644416,39701,230209,4071,4414207,35630
2020-11-04,Oklahoma,40,127772,1246,1392,17,1657117,9778,127772,1246,1529345,8532
2020-11-04,Oregon,41,47049,589,707,6,882954,5550,47049,589,835905,4961
2020-11-04,Pennsylvania,42,222883,2772,8967,41,2591931,22714,217666,2795,2374265,19919
2020-11-04,Puerto Rico,72,69020,77,850,8,341779,57,35807,57,305972,0
2020-11-04,Rhode Island,44,35122,579,1214,2,447021,3497,35122,579,411899,2918
2020-11-04,South Carolina,45,180870,918,3985,17,1865888,10765,180870,918,1685018,9847
2020-11-04,South Dakota,46,49791,937,460,14,266796,1586,49791,937,217005,649
2020-11-04,Tennessee,47,265407,3354,3446,27,3760384,25820,269802,3445,3490582,22375
2020-11-04,Texas,48,984900,10672,18870,148,8404187,75318,926400,9627,7477787,65691
2020-11-04,Utah,49,121563,2188,625,5,1073952,5513,121485,2110,952467,3403
2020-11-04,Vermont,50,2267,30,58,0,191087,960,2267,30,188820,930
2020-11-04,Virgin Islands,78,1388,3,23,1,24746,181,1388,3,23358,178
2020-11-04,Virginia,51,185836,1157,3677,11,2715175,15404,185836,1157,2529339,14247
2020-11-04,Washington,53,117091,1483,2526,19,2495151,24966,110011,657,2385140,24309
2020-11-04,West Virginia,54,25987,394,472,3,806208,5800,25987,394,780221,5406
2020-11-04,Wisconsin,55,257365,6138,2237,58,2129582,16588,257287,6255,1872295,10333
2020-11-04,Wyoming,56,15044,425,105,12,135761,425,15044,425,120717,0
2020-11-05,Alabama,01,199158,1381,3026,20,1408999,7725,199158,1381,1209841,6344
2020-11-05,Alaska,02,18064,314,79,0,781826,154068,17111,313,764715,153755
2020-11-05,Arizona,04,252843,1990,6087,28,1826629,8132,252768,2135,1573861,5997
2020-11-05,Arkansas,05,117360,1548,2037,11,1402973,13176,117360,1548,1285613,11628
2020-11-05,California,06,960884,6260,17866,48,19266363,85351,944576,4566,18321787,80785
2020-11-05,Colorado,08,122170,3814,2383,17,1294480,14633,121006,3369,1173474,11264
2020-11-05,Connecticut,09,77060,1687,4656,11,2459921,58044,77060,1687,2382861,56357
2020-11-05,Delaware,10,25753,219,716,4,358386,1722,25753,219,332633,1503
2020-11-05,District of Columbia,11,17682,81,650,3,540502,3411,17682,81,522820,3330
2020-11-05,Florida,12,827372,6257,16960,39,6291105,43938,816376,6120,5474729,37818
2020-11-05,Georgia,13,384531,2418,8359,56,3672160,24882,368368,1916,3303792,22966
2020-11-05,Guam,66,5973,101,84,0,70467,711,5004,101,65463,610
2020-11-05,Hawaii,15,15683,92,218,0,310839,155,15686,155,295153,0
2020-11-05,Idaho,16,70005,1214,673,8,404810,3036,68314,1290,336496,1746
2020-11-05,Illinois,17,455528,9991,10334,95,8122987,86015,453750,9935,7669237,76080
2020-11-05,Indiana,18,198684,4423,4511,47,1761947,13451,196176,4412,1565771,9039
2020-11-05,Iowa,19,142795,5480,1814,13,916404,8350,130732,3992,785672,4358
2020-11-05,Kansas,20,94427,460,1087,0,663680,0,92215,0,571465,0
2020-11-05,Kentucky,21,117654,2228,1611,18,2028170,28516,115277,2268,1912893,26248
2020-11-05,Louisiana,22,190845,681,5995,20,2847666,21747,190845,681,2656821,21066
2020-11-05,Maine,23,7260,183,150,0,667850,10600,7260,183,660590,10417
2020-11-05,Maryland,24,150424,1192,4182,10,1990023,10956,149964,1198,1840059,9758
2020-11-05,Massachusetts,25,165161,1862,10085,23,2837094,24555,165161,1862,2671933,22693
2020-11-05,Michigan,26,218136,6010,7833,50,5154882,61206,218263,6103,4936619,55103
2020-11-05,Minnesota,27,164919,3942,2609,25,1941496,21031,164865,3942,1776631,17089
2020-11-05,Mississippi,28,123887,1612,3405,8,961095,1612,123887,1612,837208,0
2020-11-05,Missouri,29,205036,3521,3197,31,1557001,10046,196576,3553,1360425,6493
2020-11-05,Montana,30,37024,1012,409,5,520024,2736,36968,1013,483056,1723
2020-11-05,Nebraska,31,78012,2124,678,5,608304,4414,75888,1828,532416,2586
2020-11-05,Nevada,32,105706,1192,1825,9,829573,6030,105360,1267,724213,4763
2020-11-05,New Hampshire,33,11808,245,486,2,356358,5222,11808,245,344550,4977
2020-11-05,New Jersey,34,249019,1962,16403,12,4818052,48961,247219,1962,4570833,46999
2020-11-05,New Mexico,35,51110,859,1082,23,1230205,11400,51110,859,1179095,10541
2020-11-05,New York,36,523559,3002,33247,25,15195176,161019,518812,2997,14676364,158022
2020-11-05,North Carolina,37,286210,2930,4572,37,4226942,42684,285661,2859,3941281,39825
2020-11-05,North Dakota,38,49842,1536,601,28,302970,1881,49837,1536,253133,345
2020-11-05,Northern Mariana Islands,69,96,0,2,0,16089,0,96,0,15993,0
2020-11-05,Ohio,39,235170,4961,5461,33,4695806,51390,235170,4961,4460636,46429
2020-11-05,Oklahoma,40,129873,2101,1413,21,1673557,16440,129873,2101,1543684,14339
2020-11-05,Oregon,41,47839,790,710,3,889027,6073,47839,790,841188,5283
2020-11-05,Pennsylvania,42,225698,2815,9009,42,2611902,19971,220566,2900,2391336,17071
2020-11-05,Puerto Rico,72,69416,396,855,5,342073,294,36101,294,305972,0
2020-11-05,Rhode Island,44,35750,628,1222,8,450428,3407,35750,628,414678,2779
2020-11-05,South Carolina,45,181639,769,3992,7,1873285,7397,181639,769,1691646,6628
2020-11-05,South Dakota,46,51151,1360,482,22,269136,2340,51151,1360,217985,980
2020-11-05,Tennessee,47,267557,2150,3474,28,3780132,19748,271771,1969,3508361,17779
2020-11-05,Texas,48,993873,8973,19000,130,8483728,79541,934994,8594,7548734,70947
2020-11-05,Utah,49,124366,2803,632,7,1086344,12392,124292,2807,962052,9585
2020-11-05,Vermont,50,2303,36,58,0,192027,940,2303,36,189724,904
2020-11-05,Virgin Islands,78,1388,0,23,0,24904,158,1388,0,23516,158
2020-11-05,Virginia,51,187202,1366,3688,11,2733990,18815,187202,1366,2546788,17449
2020-11-05,Washington,53,118459,1368,2542,16,2519494,24343,111480,1469,2408014,22874
2020-11-05,West Virginia,54,26547,560,480,8,817092,10884,26547,560,790545,10324
2020-11-05,Wisconsin,55,263640,6275,2273,36,2145384,15802,263571,6284,1881813,9518
2020-11-05,Wyoming,56,15409,365,105,0,138213,2452,15409,365,122804,2087
2020-11-06,Alabama,01,200714,1556,3049,23,1417716,8717,200714,1556,1217002,7161
2020-11-06,Alaska,02,18589,525,79,0,781301,-525,17618,507,763683,-1032
2020-11-06,Arizona,04,254961,2118,6111,24,1848745,22116,254764,1996,1593981,20120
2020-11-06,Arkansas,05,119230,1870,2056,19,1417494,14521,119230,1870,1298264,12651
2020-11-06,California,06,967597,6713,17939,73,19396349,129986,951094,6518,18445255,123468
2020-11-06,Colorado,08,125397,3227,2404,21,1310846,16366,124469,3463,1186377,12903
2020-11-06,Connecticut,09,78125,1065,4671,15,2489604,29683,78125,1065,2411479,28618
2020-11-06,Delaware,10,26035,282,716,0,360881,2495,26035,282,334846,2213
2020-11-06,District of Columbia,11,17792,110,652,2,546323,5821,17792,110,528531,5711
2020-11-06,Florida,12,832617,5245,17013,53,6325976,34871,821526,5150,5504450,29721
2020-11-06,Georgia,13,387202,2671,8389,30,3691733,19573,370106,1738,3321627,17835
2020-11-06,Guam,66,6046,73,89,5,71104,637,5077,73,66027,564
2020-11-06,Hawaii,15,15816,133,218,0,310938,99,15785,99,295153,0
2020-11-06,Idaho,16,71496,1491,685,12,408235,3425,69579,1265,338656,2160
2020-11-06,Illinois,17,466884,11356,10412,78,8215129,92142,465540,11790,7749589,80352
2020-11-06,Indiana,18,203332,4648,4547,36,1777105,15158,200823,4647,1576282,10511
2020-11-06,Iowa,19,146267,3472,1828,14,922017,5613,133510,2778,788507,2835
2020-11-06,Kansas,20,99605,5178,1172,85,676320,12640,97633,5418,578687,7222
2020-11-06,Kentucky,21,119952,2298,1621,10,2196876,168706,117505,2228,2079371,166478
2020-11-06,Louisiana,22,191715,870,6016,21,2866476,18810,191715,870,2674761,17940
2020-11-06,Maine,23,7444,184,150,0,676065,8215,7444,184,668621,8031
2020-11-06,Maryland,24,151964,1540,4194,12,2003170,13147,151505,1541,1851665,11606
2020-11-06,Massachusetts,25,167274,2113,10123,38,2857859,20765,167274,2113,2690585,18652
2020-11-06,Michigan,26,222423,4287,7883,50,5207467,52585,222509,4246,4984958,48339
2020-11-06,Minnesota,27,170361,5442,2645,36,1963849,22353,170307,5442,1793542,16911
2020-11-06,Mississippi,28,124854,967,3419,14,962062,967,124854,967,837208,0
2020-11-06,Missouri,29,210054,5018,3217,20,1567231,10230,200507,3931,1366724,6299
2020-11-06,Montana,30,38012,988,420,11,523596,3572,37947,979,485649,2593
2020-11-06,Nebraska,31,80693,2681,705,27,614043,5739,78012,2124,536031,3615
2020-11-06,Nevada,32,107258,1552,1846,21,835414,5841,106922,1562,728492,4279
2020-11-06,New Hampshire,33,12012,204,488,2,358730,2372,12012,204,346718,2168
2020-11-06,New Jersey,34,251180,2161,16416,13,4863436,45384,249380,2161,4614056,43223
2020-11-06,New Mexico,35,52394,1284,1088,6,1238575,8370,52394,1284,1186181,7086
2020-11-06,New York,36,526767,3208,33267,20,15355881,160705,522021,3209,14833860,157496
2020-11-06,North Carolina,37,289124,2914,4608,36,4277376,50434,288569,2908,3988807,47526
2020-11-06,North Dakota,38,51607,1765,618,17,305665,2695,51602,1765,254063,930
2020-11-06,Northern Mariana Islands,69,98,2,2,0,16091,2,98,2,15993,0
2020-11-06,Ohio,39,240178,5008,5494,33,4700814,5008,240178,5008,4460636,0
2020-11-06,Oklahoma,40,131751,1878,1429,16,1689601,16044,131751,1878,1557850,14166
2020-11-06,Oregon,41,48608,769,716,6,897602,8575,48608,769,848994,7806
2020-11-06,Pennsylvania,42,229346,3648,9052,43,2632316,20414,223950,3384,2408366,17030
2020-11-06,Puerto Rico,72,70519,1103,862,7,342876,803,36904,803,305972,0
2020-11-06,Rhode Island,44,36380,630,1224,2,453647,3219,36380,630,417267,2589
2020-11-06,South Carolina,45,182872,1233,4005,13,1897097,23812,182872,1233,1714225,22579
2020-11-06,South Dakota,46,52639,1488,510,28,272190,3054,52639,1488,219551,1566
2020-11-06,Tennessee,47,269292,1735,3508,34,3791407,11275,273144,1373,3518263,9902
2020-11-06,Texas,48,1003869,9996,19125,125,8553766,70038,942539,7545,7611227,62493
2020-11-06,Utah,49,127294,2928,649,17,1096628,10284,127279,2987,969349,7297
2020-11-06,Vermont,50,2326,23,58,0,192728,701,2326,23,190402,678
2020-11-06,Virgin Islands,78,1390,2,23,0,25118,214,1390,2,23728,212
2020-11-06,Virginia,51,188770,1568,3682,-6,2758354,24364,188770,1568,2569584,22796
2020-11-06,Washington,53,120123,1664,2552,10,2541074,21580,112550,1070,2428524,20510
2020-11-06,West Virginia,54,27087,540,487,7,827059,9967,27087,540,799972,9427
2020-11-06,Wisconsin,55,270074,6434,2340,67,2166439,21055,269982,6411,1896457,14644
2020-11-06,Wyoming,56,16405,996,105,0,140174,1961,16405,996,123769,965
2020-11-07,Alabama,01,202482,1768,3082,33,1427077,9361,202482,1768,1224595,7593
2020-11-07,Alaska,02,19194,605,79,0,780694,-607,18221,603,762473,-1210
2020-11-07,Arizona,04,257384,2423,6147,36,1865425,16680,257384,2620,1608041,14060
2020-11-07,Arkansas,05,120828,1598,2068,12,1429305,11811,120828,1598,1308477,10213
2020-11-07,California,06,972801,5204,17964,25,19565151,168802,956957,5863,18608194,162939
2020-11-07,Colorado,08,128611,3214,2417,13,1327974,17128,127967,3498,1200007,13630
2020-11-07,Connecticut,09,78125,0,4671,0,2489604,0,78125,0,2411479,0
2020-11-07,Delaware,10,26258,223,716,0,362931,2050,26258,223,336673,1827
2020-11-07,District of Columbia,11,17891,99,654,2,550585,4262,17891,99,532694,4163
2020-11-07,Florida,12,837069,4452,17099,86,6345029,19053,825906,4380,5519123,14673
2020-11-07,Georgia,13,389257,2055,8427,38,3715270,23537,371825,1719,3343445,21818
2020-11-07,Guam,66,6046,0,89,0,71507,403,5113,36,66394,367
2020-11-07,Hawaii,15,15939,123,219,1,311076,138,15923,138,295153,0
2020-11-07,Idaho,16,72528,1032,685,0,412887,4652,70909,1330,341978,3322
2020-11-07,Illinois,17,479061,12177,10498,86,8313547,98418,477978,12438,7835569,85980
2020-11-07,Indiana,18,208243,4911,4592,45,1794398,17293,205722,4899,1588676,12394
2020-11-07,Iowa,19,150639,4372,1842,14,928259,6242,137228,3718,791031,2524
2020-11-07,Kansas,20,99671,66,1166,-6,676320,0,97633,0,578687,0
2020-11-07,Kentucky,21,122021,2069,1640,19,2066810,-130066,119661,2156,1947149,-132222
2020-11-07,Louisiana,22,191715,0,6016,0,2866476,0,191715,0,2674761,0
2020-11-07,Maine,23,7603,159,152,2,676224,159,7603,159,668621,0
2020-11-07,Maryland,24,153198,1234,4201,7,2015314,12144,152915,1410,1862399,10734
2020-11-07,Massachusetts,25,169576,2302,10146,23,2881767,23908,169576,2302,2712191,21606
2020-11-07,Michigan,26,228706,6283,7943,60,5213961,6494,229003,6494,4984958,0
2020-11-07,Minnesota,27,175008,4647,2679,34,1983443,19594,174954,4647,1808489,14947
2020-11-07,Mississippi,28,125885,1031,3433,14,963093,1031,125885,1031,837208,0
2020-11-07,Missouri,29,213645,3591,3235,18,1578411,11180,205066,4559,1373345,6621
2020-11-07,Montana,30,38948,936,445,25,525176,1580,38948,1001,486228,579
2020-11-07,Nebraska,31,82395,1702,710,5,621532,7489,80693,2681,540839,4808
2020-11-07,Nevada,32,109326,2068,1851,5,842004,6590,108746,1824,733258,4766
2020-11-07,New Hampshire,33,12241,229,489,1,361706,2976,12241,229,349465,2747
2020-11-07,New Jersey,34,254382,3202,16425,9,4963630,100194,252582,3202,4711048,96992
2020-11-07,New Mexico,35,53671,1277,1104,16,1250724,12149,53671,1277,1197053,10872
2020-11-07,New York,36,530354,3587,33287,20,15519172,163291,525608,3587,14993564,159704
2020-11-07,North Carolina,37,291563,2439,4629,21,4324156,46780,291245,2676,4032911,44104
2020-11-07,North Dakota,38,53209,1602,633,15,307971,2306,53204,1602,254767,704
2020-11-07,Northern Mariana Islands,69,98,0,2,0,16091,0,98,0,15993,0
2020-11-07,Ohio,39,245727,5549,5506,12,4808908,108094,245727,5549,4563181,102545
2020-11-07,Oklahoma,40,136258,4507,1438,9,1703072,13471,131751,0,1571321,13471
2020-11-07,Oregon,41,49587,979,729,13,903099,5497,49587,979,853512,4518
2020-11-07,Pennsylvania,42,232582,3236,9089,37,2654106,21790,227985,4035,2426121,17755
2020-11-07,Puerto Rico,72,71532,1013,862,0,343539,663,37567,663,305972,0
2020-11-07,Rhode Island,44,36380,0,1224,0,460515,6868,37175,795,423340,6073
2020-11-07,South Carolina,45,184742,1870,4015,10,1944928,47831,184742,1870,1760186,45961
2020-11-07,South Dakota,46,53976,1337,523,13,274683,2493,53976,1337,220707,1156
2020-11-07,Tennessee,47,273603,4311,3556,48,3836617,45210,278215,5071,3558402,40139
2020-11-07,Texas,48,1009798,5929,19219,94,8634990,81224,950549,8010,7684441,73214
2020-11-07,Utah,49,130238,2944,658,9,1107994,11366,130235,2956,977759,8410
2020-11-07,Vermont,50,2347,21,59,1,193523,795,2347,21,191176,774
2020-11-07,Virgin Islands,78,1405,15,23,0,25118,0,1390,0,23728,0
2020-11-07,Virginia,51,190873,2103,3704,22,2782039,23685,190873,2103,2591166,21582
2020-11-07,Washington,53,121220,1097,2552,0,2568257,27183,114241,1691,2454016,25492
2020-11-07,West Virginia,54,27742,655,502,15,837704,10645,27742,655,809962,9990
2020-11-07,Wisconsin,55,277568,7494,2385,45,2185823,19384,277503,7521,1908320,11863
2020-11-07,Wyoming,56,16597,192,105,0,140366,192,16597,192,123769,0
2020-11-08,Alabama,01,203687,1205,3084,2,1433504,6427,203687,1205,1229817,5222
2020-11-08,Alaska,02,19712,518,79,0,780174,-520,18732,511,761442,-1031
2020-11-08,Arizona,04,259299,1915,6164,17,1879328,13903,259264,1880,1620064,12023
2020-11-08,Arkansas,05,121866,1038,2085,17,1438805,9500,121866,1038,1316939,8462
2020-11-08,California,06,978844,6043,17975,11,19724628,159477,964639,7682,18759989,151795
2020-11-08,Colorado,08,131870,3259,2421,4,1341956,13982,130984,3017,1210972,10965
2020-11-08,Connecticut,09,78125,0,4671,0,2489604,0,78125,0,2411479,0
2020-11-08,Delaware,10,26603,345,718,2,365279,2348,26603,345,338676,2003
2020-11-08,District of Columbia,11,18001,110,654,0,555449,4864,18001,110,537448,4754
2020-11-08,Florida,12,843889,6820,17120,21,6389831,44802,832525,6619,5557306,38183
2020-11-08,Georgia,13,390617,1360,8428,1,3733960,18690,373078,1253,3360882,17437
2020-11-08,Guam,66,6046,0,89,0,71996,489,5233,120,66763,369
2020-11-08,Hawaii,15,16066,127,220,1,311204,128,16051,128,295153,0
2020-11-08,Idaho,16,73212,684,691,6,415721,2834,72312,1403,343409,1431
2020-11-08,Illinois,17,488980,9919,10548,50,8404304,90757,487987,10009,7916317,80748
2020-11-08,Indiana,18,212895,4652,4629,37,1809940,15542,210374,4652,1599566,10890
2020-11-08,Iowa,19,155583,4944,1845,3,935839,7580,140541,3313,795298,4267
2020-11-08,Kansas,20,99805,134,1166,0,676320,0,97633,0,578687,0
2020-11-08,Kentucky,21,123195,1174,1641,1,2067987,1177,120838,1177,1947149,0
2020-11-08,Louisiana,22,192981,1266,6036,20,2892957,26481,192981,1266,2699976,25215
2020-11-08,Maine,23,7693,90,152,0,676314,90,7693,90,668621,0
2020-11-08,Maryland,24,154451,1253,4212,11,2026292,10978,153996,1081,1872296,9897
2020-11-08,Massachusetts,25,171399,1823,10166,20,2901920,20153,171399,1823,2730521,18330
2020-11-08,Michigan,26,229085,379,7944,1,5213961,0,229003,0,4984958,0
2020-11-08,Minnesota,27,180916,5908,2710,31,2004582,21139,180862,5908,1823720,15231
2020-11-08,Mississippi,28,126689,804,3443,10,963897,804,126689,804,837208,0
2020-11-08,Missouri,29,216654,3009,3238,3,1599615,21204,209197,4131,1390418,17073
2020-11-08,Montana,30,39679,731,456,11,526591,1415,39679,731,486912,684
2020-11-08,Nebraska,31,83969,1574,710,0,626287,4755,82395,1702,543892,3053
2020-11-08,Nevada,32,110308,982,1852,1,846248,4244,110022,1276,736226,2968
2020-11-08,New Hampshire,33,12488,247,489,0,362828,1122,12488,247,350340,875
2020-11-08,New Jersey,34,256395,2013,16429,4,4965643,2013,254595,2013,4711048,0
2020-11-08,New Mexico,35,54881,1210,1118,14,1262482,11758,54881,1210,1207601,10548
2020-11-08,New York,36,533784,3430,33314,27,15664814,145642,529036,3428,15135778,142214
2020-11-08,North Carolina,37,293431,1868,4630,1,4365061,40905,293339,2094,4071722,38811
2020-11-08,North Dakota,38,54310,1101,644,11,309498,1527,54305,1101,255193,426
2020-11-08,Northern Mariana Islands,69,98,0,2,0,16091,0,98,0,15993,0
2020-11-08,Ohio,39,250268,4541,5517,11,4868460,59552,250268,4541,4618192,55011
2020-11-08,Oklahoma,40,136258,0,1438,0,1707579,4507,136258,4507,1571321,0
2020-11-08,Oregon,41,50448,861,730,1,909301,6202,50448,861,858853,5341
2020-11-08,Pennsylvania,42,235162,2580,9093,4,2672529,18423,230894,2909,2441635,15514
2020-11-08,Puerto Rico,72,71715,183,872,10,344072,533,38100,533,305972,0
2020-11-08,Rhode Island,44,36380,0,1224,0,463584,3069,37743,568,425841,2501
2020-11-08,South Carolina,45,185688,946,4036,21,1959102,14174,185688,946,1773414,13228
2020-11-08,South Dakota,46,55404,1428,536,13,277035,2352,55404,1428,221631,924
2020-11-08,Tennessee,47,277073,3470,3561,5,3873139,36522,281851,3636,3591288,32886
2020-11-08,Texas,48,1016733,6935,19256,37,8734857,99867,956234,5685,7778623,94182
2020-11-08,Utah,49,132621,2383,659,1,1116732,8738,132621,2386,984111,6352
2020-11-08,Vermont,50,2392,45,59,0,194382,859,2392,45,191990,814
2020-11-08,Virgin Islands,78,1405,0,23,0,25417,299,1405,15,24012,284
2020-11-08,Virginia,51,192175,1302,3707,3,2803062,21023,192175,1302,2610887,19721
2020-11-08,Washington,53,122310,1090,2552,0,2592766,24509,116011,1770,2476755,22739
2020-11-08,West Virginia,54,28404,662,502,0,849461,11757,28404,662,821057,11095
2020-11-08,Wisconsin,55,281910,4342,2396,11,2198711,12888,281910,4407,1916801,8481
2020-11-08,Wyoming,56,17310,713,114,9,141079,713,17310,713,123769,0
2020-11-09,Alabama,01,204857,1170,3084,0,1437832,4328,204857,1170,1232975,3158
2020-11-09,Alaska,02,20185,473,79,0,767997,-12177,19196,464,748801,-12641
2020-11-09,Arizona,04,260646,1347,6164,0,1889905,10577,259699,435,1630206,10142
2020-11-09,Arkansas,05,122811,945,2108,23,1447466,8661,122811,945,1324655,7716
2020-11-09,California,06,985598,6754,18035,60,19918479,193851,971851,7212,18946628,186639
2020-11-09,Colorado,08,135747,3877,2438,17,1359195,17239,134537,3553,1224658,13686
2020-11-09,Connecticut,09,81463,3338,4698,27,2579578,89974,81463,3338,2498115,86636
2020-11-09,Delaware,10,26908,305,719,1,367580,2301,26908,305,340672,1996
2020-11-09,District of Columbia,11,18087,86,655,1,558814,3365,18087,86,540727,3279
2020-11-09,Florida,12,847813,3924,17178,58,6410130,20299,836370,3845,5573760,16454
2020-11-09,Georgia,13,392246,1629,8457,29,3749894,15934,374181,1103,3375713,14831
2020-11-09,Guam,66,6442,396,91,2,72954,958,5473,240,67481,718
2020-11-09,Hawaii,15,16124,58,220,0,311332,128,16179,128,295153,0
2020-11-09,Idaho,16,74713,1501,704,13,418504,2783,72961,649,345543,2134
2020-11-09,Illinois,17,500015,11035,10577,29,8469064,64760,498560,10573,7970504,54187
2020-11-09,Indiana,18,217028,4133,4664,35,1823029,13089,214509,4135,1608520,8954
2020-11-09,Iowa,19,159910,4327,1872,27,945621,9782,144922,4381,800699,5401
2020-11-09,Kansas,20,105298,5493,1181,15,689982,13662,103553,5920,586429,7742
2020-11-09,Kentucky,21,125332,2137,1655,14,2106069,38082,122567,1729,1983502,36353
2020-11-09,Louisiana,22,193372,391,6048,12,2898463,5506,193372,391,2705091,5115
2020-11-09,Maine,23,7888,195,153,1,698403,22089,7888,195,690515,21894
2020-11-09,Maryland,24,155824,1373,4221,9,2037645,11353,155371,1375,1882274,9978
2020-11-09,Massachusetts,25,172727,1328,10180,14,2916246,14326,172727,1328,2743519,12998
2020-11-09,Michigan,26,238136,9051,8008,64,5368310,154349,238308,9305,5130002,145044
2020-11-09,Minnesota,27,184842,3926,2729,19,2018855,14273,184788,3926,1834067,10347
2020-11-09,Mississippi,28,127205,516,3443,0,1001068,37171,127205,516,873863,36655
2020-11-09,Missouri,29,221874,5220,3241,3,1607875,8260,212441,3244,1395434,5016
2020-11-09,Montana,30,40118,439,463,7,540913,14322,40053,374,500860,13948
2020-11-09,Nebraska,31,85551,1582,714,4,630137,3850,83969,1574,546168,2276
2020-11-09,Nevada,32,111323,1015,1853,1,850941,4693,110982,960,739959,3733
2020-11-09,New Hampshire,33,12699,211,489,0,363544,716,12699,211,350845,505
2020-11-09,New Jersey,34,258453,2058,16440,11,5037287,71644,256653,2058,4780634,69586
2020-11-09,New Mexico,35,56289,1408,1130,12,1269523,7041,56289,1408,1213234,5633
2020-11-09,New York,36,536933,3149,33343,29,15776230,111416,532180,3144,15244050,108272
2020-11-09,North Carolina,37,295105,1674,4638,8,4399616,34555,294860,1521,4104756,33034
2020-11-09,North Dakota,38,55463,1153,649,5,310998,1500,55458,1153,255540,347
2020-11-09,Northern Mariana Islands,69,100,2,2,0,16093,2,100,2,15993,0
2020-11-09,Ohio,39,254974,4706,5524,7,4918126,49666,254974,4706,4663152,44960
2020-11-09,Oklahoma,40,138455,2197,1444,6,1709776,2197,138455,2197,1571321,0
2020-11-09,Oregon,41,51155,707,738,8,914677,5376,51155,707,863522,4669
2020-11-09,Pennsylvania,42,239724,4562,9098,5,2690152,17623,234296,3402,2455856,14221
2020-11-09,Puerto Rico,72,72196,481,882,10,344553,481,38581,481,305972,0
2020-11-09,Rhode Island,44,38009,1629,1233,9,465031,1447,38009,266,427022,1181
2020-11-09,South Carolina,45,186391,703,4041,5,1967225,8123,186391,703,1780834,7420
2020-11-09,South Dakota,46,56311,907,537,1,278803,1768,56311,907,222492,861
2020-11-09,Tennessee,47,282746,5673,3577,16,3928231,55092,287770,5919,3640461,49173
2020-11-09,Texas,48,1026477,9744,19298,42,8849942,115085,963019,6785,7886923,108300
2020-11-09,Utah,49,134868,2247,661,2,1125403,8671,134868,2247,990535,6424
2020-11-09,Vermont,50,2415,23,59,0,194794,412,2415,23,192379,389
2020-11-09,Virgin Islands,78,1405,0,23,0,25417,0,1405,0,24012,0
2020-11-09,Virginia,51,193477,1302,3713,6,2819087,16025,193477,1302,2625610,14723
2020-11-09,Washington,53,124560,2250,2577,25,2612198,19432,117331,1320,2494867,18112
2020-11-09,West Virginia,54,28805,401,530,28,857085,7624,28805,401,828280,7223
2020-11-09,Wisconsin,55,286446,4536,2421,25,2212898,14187,286380,4470,1926518,9717
2020-11-09,Wyoming,56,18010,700,114,0,145158,4079,18010,700,127148,3379
2020-11-10,Alabama,01,206567,1710,3120,36,1437719,-113,206567,1710,1231152,-1823
2020-11-10,Alaska,02,20715,530,87,8,828140,60143,19734,538,808406,59605
2020-11-10,Arizona,04,263445,2799,6198,34,1905430,15525,263133,3434,1642297,12091
2020-11-10,Arkansas,05,124235,1424,2112,4,1456243,8777,124235,1424,1332008,7353
2020-11-10,California,06,994341,8743,18073,38,20094641,176162,977218,5367,19117423,170795
2020-11-10,Colorado,08,139246,3499,2469,31,1374786,15591,138427,3890,1236359,11701
2020-11-10,Connecticut,09,82987,1524,4707,9,2602262,22684,82987,1524,2519275,21160
2020-11-10,Delaware,10,27112,204,722,3,369131,1551,27112,204,342019,1347
2020-11-10,District of Columbia,11,18173,86,657,2,561833,3019,18173,86,543660,2933
2020-11-10,Florida,12,852166,4353,17247,69,6434241,24111,840652,4282,5593589,19829
2020-11-10,Georgia,13,396498,4252,8507,50,3772524,22630,376054,1873,3396470,20757
2020-11-10,Guam,66,6623,181,92,1,73859,905,5654,181,68205,724
2020-11-10,Hawaii,15,16193,69,221,1,311395,63,16242,63,295153,0
2020-11-10,Idaho,16,76010,1297,720,16,420811,2307,74227,1266,346584,1041
2020-11-10,Illinois,17,512688,12673,10658,81,8571019,101955,511183,12623,8059836,89332
2020-11-10,Indiana,18,221894,4866,4731,67,1837630,14601,219338,4829,1618292,9772
2020-11-10,Iowa,19,163827,3917,1898,26,950191,4570,147656,2734,802535,1836
2020-11-10,Kansas,20,105760,462,1181,0,689982,0,103553,0,586429,0
2020-11-10,Kentucky,21,127472,2140,1674,19,2126356,20287,124646,2079,2001710,18208
2020-11-10,Louisiana,22,194702,1330,6058,10,2924923,26460,194702,1330,2730221,25130
2020-11-10,Maine,23,8060,172,156,3,704431,6028,8060,172,696371,5856
2020-11-10,Maryland,24,157149,1325,4233,12,2047847,10202,156709,1338,1891138,8864
2020-11-10,Massachusetts,25,174881,2154,10201,21,2932097,15851,174881,2154,2757216,13697
2020-11-10,Michigan,26,245005,6869,8095,87,5427625,59315,245252,6944,5182373,52371
2020-11-10,Minnesota,27,189735,4893,2752,23,2033885,15030,189681,4893,1844204,10137
2020-11-10,Mississippi,28,128138,933,3480,37,1002001,933,128138,933,873863,0
2020-11-10,Missouri,29,226372,4498,3375,134,1599170,-8705,216697,4256,1382473,-12961
2020-11-10,Montana,30,41219,1101,468,5,544566,3653,41151,1098,503415,2555
2020-11-10,Nebraska,31,87733,2182,741,27,633716,3579,85551,1582,548165,1997
2020-11-10,Nevada,32,112602,1279,1863,10,854534,3593,112304,1322,742230,2271
2020-11-10,New Hampshire,33,12919,220,489,0,368085,4541,12919,220,355166,4321
2020-11-10,New Jersey,34,262230,3777,16461,21,5041064,3777,260430,3777,4780634,0
2020-11-10,New Mexico,35,57547,1258,1144,14,1281951,12428,57547,1258,1224404,11170
2020-11-10,New York,36,540897,3964,33373,30,15904266,128036,536145,3965,15368121,124071
2020-11-10,North Carolina,37,298089,2984,4685,47,4429912,30296,297442,2582,4132470,27714
2020-11-10,North Dakota,38,56357,894,679,30,311882,884,56342,884,255540,0
2020-11-10,Northern Mariana Islands,69,100,0,2,0,16567,474,100,0,16467,474
2020-11-10,Ohio,39,261482,6508,5547,23,4964229,46103,261482,6508,4702747,39595
2020-11-10,Oklahoma,40,140157,1702,1451,7,1733198,23422,140157,1702,1593041,21720
2020-11-10,Oregon,41,51909,754,741,3,921216,6539,51909,754,869307,5785
2020-11-10,Pennsylvania,42,244046,4322,9156,58,2709442,19290,238657,4361,2470785,14929
2020-11-10,Puerto Rico,72,72471,275,889,7,344828,275,38856,275,305972,0
2020-11-10,Rhode Island,44,38798,789,1237,4,467877,2846,38798,789,429079,2057
2020-11-10,South Carolina,45,187738,1347,4062,21,1988512,21287,187738,1347,1800774,19940
2020-11-10,South Dakota,46,57334,1023,540,3,280699,1896,57334,1023,223365,873
2020-11-10,Tennessee,47,284725,1979,3639,62,3943804,15573,289749,1979,3654055,13594
2020-11-10,Texas,48,1038135,11658,19423,125,8901839,51897,974230,11211,7927609,40686
2020-11-10,Utah,49,137523,2655,672,11,1135628,10225,137385,2517,998243,7708
2020-11-10,Vermont,50,2462,47,59,0,195455,661,2462,47,192993,614
2020-11-10,Virgin Islands,78,1413,8,23,0,25487,70,1410,5,24077,65
2020-11-10,Virginia,51,194912,1435,3726,13,2837139,18052,194912,1435,2642227,16617
2020-11-10,Washington,53,126091,1531,2594,17,2627515,15317,118570,1239,2508945,14078
2020-11-10,West Virginia,54,29316,511,546,16,864043,6958,29316,511,834727,6447
2020-11-10,Wisconsin,55,293862,7416,2497,76,2233256,20358,293812,7432,1939444,12926
2020-11-10,Wyoming,56,19242,1232,127,13,146390,1232,19242,1232,127148,0
2020-11-11,Alabama,01,208637,2070,3201,81,1453872,16153,208637,2070,1245235,14083
2020-11-11,Alaska,02,21211,496,90,3,834590,6450,20221,487,814369,5963
2020-11-11,Arizona,04,265195,1750,6228,30,1915235,9805,265163,2030,1650072,7775
2020-11-11,Arkansas,05,126197,1962,2126,14,1469248,13005,126197,1962,1343051,11043
2020-11-11,California,06,999498,5157,18109,36,20222093,127452,984682,7464,19237411,119988
2020-11-11,Colorado,08,143553,4307,2481,12,1395052,20266,142402,3975,1252650,16291
2020-11-11,Connecticut,09,84741,1754,4716,9,2639205,36943,84741,1754,2554464,35189
2020-11-11,Delaware,10,27342,230,724,2,370625,1494,27342,230,343283,1264
2020-11-11,District of Columbia,11,18379,206,657,0,567072,5239,18379,206,548693,5033
2020-11-11,Florida,12,858004,5838,17299,52,6466981,32740,846321,5669,5620660,27071
2020-11-11,Georgia,13,398769,2271,8582,75,3786046,13522,377694,1640,3408352,11882
2020-11-11,Guam,66,6724,101,92,0,74549,690,5755,101,68794,589
2020-11-11,Hawaii,15,16309,116,221,0,311473,78,16320,78,295153,0
2020-11-11,Idaho,16,77536,1526,738,18,424391,3580,75428,1201,348963,2379
2020-11-11,Illinois,17,525072,12384,10805,147,8664483,93464,523840,12657,8140643,80807
2020-11-11,Indiana,18,226935,5041,4762,31,1853700,16070,224374,5036,1629326,11034
2020-11-11,Iowa,19,168457,4630,1927,29,958353,8162,151953,4297,806400,3865
2020-11-11,Kansas,20,110977,5217,1215,34,703647,13665,109225,5672,594422,7993
2020-11-11,Kentucky,21,130308,2836,1689,15,2129054,2698,127344,2698,2001710,0
2020-11-11,Louisiana,22,194702,0,6058,0,2924923,0,194702,0,2730221,0
2020-11-11,Maine,23,8202,142,158,2,704573,142,8202,142,696371,0
2020-11-11,Maryland,24,158836,1687,4249,16,2060836,12989,158423,1714,1902413,11275
2020-11-11,Massachusetts,25,177541,2660,10222,21,2952714,20617,177541,2660,2775173,17957
2020-11-11,Michigan,26,251499,6494,8137,42,5482476,54851,251872,6620,5230604,48231
2020-11-11,Minnesota,27,194626,4891,2810,58,2045316,11431,194570,4889,1850746,6542
2020-11-11,Mississippi,28,129394,1256,3497,17,1003257,1256,129394,1256,873863,0
2020-11-11,Missouri,29,230003,3631,3411,36,1627919,28749,220768,4071,1407151,24678
2020-11-11,Montana,30,42132,913,475,7,547728,3162,42070,919,505658,2243
2020-11-11,Nebraska,31,89942,2209,741,0,639462,5746,87733,2182,551729,3564
2020-11-11,Nevada,32,113856,1254,1877,14,859319,4785,113411,1107,745908,3678
2020-11-11,New Hampshire,33,13148,229,492,3,370830,2745,13148,229,357682,2516
2020-11-11,New Jersey,34,265295,3065,16476,15,5084793,43729,263495,3065,4821298,40664
2020-11-11,New Mexico,35,59034,1487,1158,14,1317248,35297,59034,1487,1258214,33810
2020-11-11,New York,36,545718,4821,33398,25,16068566,164300,540965,4820,15527601,159480
2020-11-11,North Carolina,37,300725,2636,4723,38,4460288,30376,300561,3119,4159727,27257
2020-11-11,North Dakota,38,57378,1021,691,12,313607,1725,57373,1031,256234,694
2020-11-11,Northern Mariana Islands,69,100,0,2,0,16567,0,100,0,16467,0
2020-11-11,Ohio,39,267356,5874,5623,76,5009783,45554,267356,5874,4742427,39680
2020-11-11,Oklahoma,40,142334,2177,1470,19,1748137,14939,142334,2177,1605803,12762
2020-11-11,Oregon,41,52770,861,746,5,928343,7127,52770,861,875573,6266
2020-11-11,Pennsylvania,42,248144,4098,9217,61,2732129,22687,243368,4711,2488761,17976
2020-11-11,Puerto Rico,72,72735,264,901,12,345092,264,39120,264,305972,0
2020-11-11,Rhode Island,44,39776,978,1243,6,471284,3407,39776,978,431508,2429
2020-11-11,South Carolina,45,188995,1257,4076,14,2000709,12197,188995,1257,1811714,10940
2020-11-11,South Dakota,46,58696,1362,567,27,283120,2421,58696,1362,224424,1059
2020-11-11,Tennessee,47,288311,3586,3727,88,3974023,30219,293381,3632,3680642,26587
2020-11-11,Texas,48,1050992,12857,19544,121,9007171,105332,985380,11150,8021791,94182
2020-11-11,Utah,49,139815,2292,678,6,1144013,8385,139720,2335,1004293,6050
2020-11-11,Vermont,50,2535,73,59,0,196281,826,2535,73,193746,753
2020-11-11,Virgin Islands,78,1413,0,23,0,25487,0,1410,0,24077,0
2020-11-11,Virginia,51,196506,1594,3741,15,2858627,21488,196506,1594,2662121,19894
2020-11-11,Washington,53,126886,795,2595,1,2644425,16910,120011,1441,2524414,15469
2020-11-11,West Virginia,54,30201,885,553,7,875117,11074,30201,885,844916,10189
2020-11-11,Wisconsin,55,301349,7487,2562,65,2251217,17961,301349,7537,1949868,10424
2020-11-11,Wyoming,56,19374,132,127,0,146613,223,19374,132,127239,91
2020-11-12,Alabama,01,210637,2000,3213,12,1455872,2000,210637,2000,1245235,0
2020-11-12,Alaska,02,21689,478,90,0,844666,10076,20702,481,823964,9595
2020-11-12,Arizona,04,266644,1449,6240,12,1930540,15305,266562,1399,1663978,13906
2020-11-12,Arkansas,05,128006,1809,2144,18,1482925,13677,128006,1809,1354919,11868
2020-11-12,California,06,1009187,9689,18141,32,20342072,119979,991609,6927,19350463,113052
2020-11-12,Colorado,08,149262,5709,2512,31,1400249,5197,147599,5197,1252650,0
2020-11-12,Connecticut,09,85899,1158,4726,10,2663481,24276,85899,1158,2577582,23118
2020-11-12,Delaware,10,27546,204,732,8,372234,1609,27546,204,344688,1405
2020-11-12,District of Columbia,11,18507,128,657,0,571530,4458,18507,128,553023,4330
2020-11-12,Florida,12,863611,5607,17371,72,6493713,26732,851825,5504,5641888,21228
2020-11-12,Georgia,13,401750,2981,8655,73,3807413,21367,380190,2496,3427223,18871
2020-11-12,Guam,66,6819,95,92,0,75449,900,5850,95,69599,805
2020-11-12,Hawaii,15,16403,94,221,0,311590,117,16437,117,295153,0
2020-11-12,Idaho,16,78877,1341,753,15,428367,3976,77121,1693,351246,2283
2020-11-12,Illinois,17,537860,12788,10855,50,8765100,100617,536542,12702,8228558,87915
2020-11-12,Indiana,18,233540,6605,4813,51,1876317,22617,230965,6591,1645352,16026
2020-11-12,Iowa,19,173401,4944,1947,20,964756,6403,155603,3650,809153,2753
2020-11-12,Kansas,20,111503,526,1215,0,700505,-3142,109225,0,591280,-3142
2020-11-12,Kentucky,21,132686,2378,1702,13,2167395,38341,129680,2336,2037715,36005
2020-11-12,Louisiana,22,198531,3829,6097,39,2958488,33565,198531,3829,2759957,29736
2020-11-12,Maine,23,8395,193,159,1,725560,20987,8395,193,717165,20794
2020-11-12,Maryland,24,160311,1475,4261,12,2071985,11149,159900,1477,1912085,9672
2020-11-12,Massachusetts,25,180189,2648,10242,20,2974611,21897,180189,2648,2794422,19249
2020-11-12,Michigan,26,258973,7474,8187,50,5549792,67316,259183,7311,5290609,60005
2020-11-12,Minnesota,27,201851,7225,2849,39,2070714,25398,201795,7225,1868919,18173
2020-11-12,Mississippi,28,130665,1271,3514,17,1004528,1271,130665,1271,873863,0
2020-11-12,Missouri,29,235341,5338,3441,30,1639564,11645,225371,4603,1414193,7042
2020-11-12,Montana,30,43084,952,478,3,557951,10223,43031,961,514920,9262
2020-11-12,Nebraska,31,92553,2611,768,27,644851,5389,89942,2209,554909,3180
2020-11-12,Nevada,32,115360,1504,1880,3,865363,6044,114880,1469,750483,4575
2020-11-12,New Hampshire,33,13470,322,495,3,375048,4218,13470,322,361578,3896
2020-11-12,New Jersey,34,268787,3492,16495,19,5124598,39805,266986,3491,4857612,36314
2020-11-12,New Mexico,35,60776,1742,1176,18,1330403,13155,60776,1742,1269627,11413
2020-11-12,New York,36,550516,4798,33424,26,16231193,162627,545762,4797,15685431,157830
2020-11-12,North Carolina,37,303931,3206,4730,7,4500774,40486,303454,2893,4197320,37593
2020-11-12,North Dakota,38,59179,1801,703,12,316394,2787,59173,1800,257221,987
2020-11-12,Northern Mariana Islands,69,100,0,2,0,16567,0,100,0,16467,0
2020-11-12,Ohio,39,274457,7101,5658,35,5066497,56714,274457,7101,4792040,49613
2020-11-12,Oklahoma,40,144691,2357,1481,11,1750494,2357,144691,2357,1605803,0
2020-11-12,Oregon,41,53879,1109,748,2,935877,7534,53879,1109,881998,6425
2020-11-12,Pennsylvania,42,254167,6023,9272,55,2755505,23376,248856,5488,2506649,17888
2020-11-12,Puerto Rico,72,74067,1332,909,8,346424,1332,40452,1332,305972,0
2020-11-12,Rhode Island,44,40764,988,1250,7,474414,3130,40764,988,433650,2142
2020-11-12,South Carolina,45,190490,1495,4084,8,2020945,20236,190490,1495,1830455,18741
2020-11-12,South Dakota,46,60716,2020,567,0,286088,2968,60716,2020,225372,948
2020-11-12,Tennessee,47,291482,3171,3751,24,3995978,21955,296725,3344,3699253,18611
2020-11-12,Texas,48,1060668,9676,19705,161,9033217,26046,993841,8461,8039376,17585
2020-11-12,Utah,49,143639,3824,689,11,1155716,11703,143639,3919,1012077,7784
2020-11-12,Vermont,50,2651,116,59,0,197619,1338,2651,116,194968,1222
2020-11-12,Virgin Islands,78,1413,0,23,0,25487,0,1410,0,24077,0
2020-11-12,Virginia,51,198027,1521,3758,17,2871201,12574,198027,1521,2673174,11053
2020-11-12,Washington,53,129672,2786,2619,24,2644425,0,120011,0,2524414,0
2020-11-12,West Virginia,54,30897,696,555,2,888299,13182,30897,696,857402,12486
2020-11-12,Wisconsin,55,309605,8256,2626,64,2274371,23154,309572,8223,1964799,14931
2020-11-12,Wyoming,56,20479,1105,127,0,149287,2674,20479,1105,128808,1569
2020-11-13,Alabama,01,213617,2980,3231,18,1474217,18345,213617,2980,1260600,15365
2020-11-13,Alaska,02,22282,593,91,1,844666,0,21286,584,823380,-584
2020-11-13,Arizona,04,270596,3952,6257,17,1949839,19299,269577,3015,1680262,16284
2020-11-13,Arkansas,05,130318,2312,2148,4,1497395,14470,130318,2312,1367077,12158
2020-11-13,California,06,1019052,9865,18218,77,20478500,136428,998502,6893,19479998,129535
2020-11-13,Colorado,08,155761,6499,2541,29,1423901,23652,154038,6439,1269863,17213
2020-11-13,Connecticut,09,88645,2746,4737,11,2706667,43186,88645,2746,2618022,40440
2020-11-13,Delaware,10,28016,470,734,2,375223,2989,28016,470,347207,2519
2020-11-13,District of Columbia,11,18666,159,657,0,577601,6071,18666,159,558935,5912
2020-11-13,Florida,12,870544,6933,17444,73,6522985,29272,858585,6760,5664400,22512
2020-11-13,Georgia,13,404577,2827,8678,23,3838550,31137,382505,2315,3456045,28822
2020-11-13,Guam,66,6893,74,93,1,76292,843,5924,74,70368,769
2020-11-13,Hawaii,15,16514,111,221,0,311687,97,16534,97,295153,0
2020-11-13,Idaho,16,80440,1563,756,3,431982,3615,78279,1158,353703,2457
2020-11-13,Illinois,17,553083,15223,10907,52,8871640,106540,551957,15415,8319683,91125
2020-11-13,Indiana,18,239139,5599,4863,50,1893070,16753,236565,5600,1656505,11153
2020-11-13,Iowa,19,178890,5489,1972,25,971644,6888,159635,4032,812009,2856
2020-11-13,Kansas,20,117282,5779,1256,41,706787,6282,115507,6282,591280,0
2020-11-13,Kentucky,21,135855,3169,1729,27,2196131,28736,132844,3164,2063287,25572
2020-11-13,Louisiana,22,201981,3450,6121,24,2992468,33980,201981,3450,2790487,30530
2020-11-13,Maine,23,8639,244,162,3,734410,8850,8639,244,725771,8606
2020-11-13,Maryland,24,162181,1870,4273,12,2084302,12317,161769,1869,1922533,10448
2020-11-13,Massachusetts,25,183095,2906,10265,23,2996729,22118,183095,2906,2813634,19212
2020-11-13,Michigan,26,268072,9099,8312,125,5623152,73360,268362,9179,5354790,64181
2020-11-13,Minnesota,27,207395,5544,2895,46,2095513,24799,207339,5544,1888174,19255
2020-11-13,Mississippi,28,131970,1305,3519,5,1005833,1305,131970,1305,873863,0
2020-11-13,Missouri,29,241236,5895,3452,11,1647747,8183,229376,4005,1418371,4178
2020-11-13,Montana,30,44297,1213,483,5,566544,8593,44244,1213,522300,7380
2020-11-13,Nebraska,31,94922,2369,789,21,650659,5808,92553,2611,558106,3197
2020-11-13,Nevada,32,117322,1962,1896,16,871005,5642,116737,1857,754268,3785
2020-11-13,New Hampshire,33,13929,459,498,3,378305,3257,13929,459,364376,2798
2020-11-13,New Jersey,34,272184,3397,16522,27,5169231,44633,270383,3397,4898848,41236
2020-11-13,New Mexico,35,62006,1230,1198,22,1348194,17791,62006,1230,1286188,16561
2020-11-13,New York,36,555917,5401,33452,28,16434914,203721,551163,5401,15883751,198320
2020-11-13,North Carolina,37,306498,2567,4749,19,4536767,35993,305233,1779,4231534,34214
2020-11-13,North Dakota,38,60608,1429,713,10,318738,2344,60602,1429,258136,915
2020-11-13,Northern Mariana Islands,69,100,0,2,0,16567,0,100,0,16467,0
2020-11-13,Ohio,39,282528,8071,5700,42,5132781,66284,282528,8071,4850253,58213
2020-11-13,Oklahoma,40,147358,2667,1493,12,1791023,40529,147358,2667,1643665,37862
2020-11-13,Oregon,41,54937,1058,759,11,943147,7270,54937,1058,888210,6212
2020-11-13,Pennsylvania,42,260001,5834,9306,34,2778371,22866,254387,5531,2523984,17335
2020-11-13,Puerto Rico,72,74734,667,914,5,347091,667,41119,667,305972,0
2020-11-13,Rhode Island,44,41529,765,1254,4,476930,2516,41529,765,435401,1751
2020-11-13,South Carolina,45,192101,1611,4101,17,2030994,10049,192101,1611,1838893,8438
2020-11-13,South Dakota,46,62327,1611,568,1,288661,2573,62327,1611,226334,962
2020-11-13,Tennessee,47,295135,3653,3814,63,4019449,23471,300458,3733,3718991,19738
2020-11-13,Texas,48,1073230,12562,19917,212,9153369,120152,1004983,11142,8148386,109010
2020-11-13,Utah,49,146155,2516,703,14,1164731,9015,145789,2150,1018942,6865
2020-11-13,Vermont,50,2743,92,59,0,198607,988,2743,92,195864,896
2020-11-13,Virgin Islands,78,1426,13,23,0,25487,0,1410,0,24077,0
2020-11-13,Virginia,51,199262,1235,3785,27,2881795,10594,199262,1235,2682533,9359
2020-11-13,Washington,53,132183,2511,2634,15,2694170,49745,123356,3345,2570814,46400
2020-11-13,West Virginia,54,31639,742,565,10,902293,13994,31639,742,870654,13252
2020-11-13,Wisconsin,55,318023,8418,2694,68,2293535,19164,318023,8451,1975512,10713
2020-11-13,Wyoming,56,21341,862,127,0,151549,2262,21341,862,130208,1400
2020-11-14,Alabama,01,215843,2226,3246,15,1487103,12886,215843,2226,1271260,10660
2020-11-14,Alaska,02,23029,747,92,1,862264,17598,22020,734,840244,16864
2020-11-14,Arizona,04,273400,2804,6300,43,1968659,18820,273053,3476,1695606,15344
2020-11-14,Arkansas,05,132166,1848,2159,11,1497395,0,130318,0,1367077,0
2020-11-14,California,06,1027016,7964,18254,36,20671596,193096,1008377,9875,19663219,183221
2020-11-14,Colorado,08,160459,4698,2554,13,1444324,20423,159234,5196,1285090,15227
2020-11-14,Connecticut,09,88645,0,4737,0,2706667,0,88645,0,2618022,0
2020-11-14,Delaware,10,28395,379,736,2,377364,2141,28395,379,348969,1762
2020-11-14,District of Columbia,11,18814,148,658,1,583319,5718,18814,148,564505,5570
2020-11-14,Florida,12,875088,4544,17488,44,6554952,31967,862990,4405,5691962,27562
2020-11-14,Georgia,13,407596,3019,8729,51,3865939,27389,384997,2492,3480942,24897
2020-11-14,Guam,66,6893,0,93,0,76757,465,5965,41,70792,424
2020-11-14,Hawaii,15,16619,105,221,0,311805,118,16652,118,295153,0
2020-11-14,Idaho,16,81625,1185,763,7,435863,3881,79798,1519,356065,2362
2020-11-14,Illinois,17,564086,11003,11098,191,8986010,114370,562985,11028,8423025,103342
2020-11-14,Indiana,18,247466,8327,4888,25,1917951,24881,244887,8322,1673064,16559
2020-11-14,Iowa,19,183557,4667,1985,13,979886,8242,163728,4093,816158,4149
2020-11-14,Kansas,20,117728,446,1256,0,706787,0,115507,0,591280,0
2020-11-14,Kentucky,21,138854,2999,1739,10,2217321,21190,136137,3293,2081184,17897
2020-11-14,Louisiana,22,201981,0,6121,0,2992468,0,201981,0,2790487,0
2020-11-14,Maine,23,8791,152,163,1,734562,152,8791,152,725771,0
2020-11-14,Maryland,24,164239,2058,4293,20,2098169,13867,164090,2321,1934079,11546
2020-11-14,Massachusetts,25,186142,3047,10293,28,3024727,27998,186142,3047,2838585,24951
2020-11-14,Michigan,26,275393,7321,8375,63,5692584,69432,275792,7430,5416792,62002
2020-11-14,Minnesota,27,216084,8689,2930,35,2119079,23566,216028,8689,1903051,14877
2020-11-14,Mississippi,28,133340,1370,3540,21,1007203,1370,133340,1370,873863,0
2020-11-14,Missouri,29,248400,7164,3463,11,1661030,13283,235722,6346,1425308,6937
2020-11-14,Montana,30,45919,1622,519,36,569694,3150,45886,1642,523808,1508
2020-11-14,Nebraska,31,96834,1912,790,1,655959,5300,94922,2369,561037,2931
2020-11-14,Nevada,32,119228,1906,1908,12,877838,6833,119006,2269,758832,4564
2020-11-14,New Hampshire,33,14311,382,499,1,381412,3107,14311,382,367101,2725
2020-11-14,New Jersey,34,276537,4353,16548,26,5210727,41496,274736,4353,4935991,37143
2020-11-14,New Mexico,35,63171,1165,1208,10,1360452,12258,63171,1165,1297281,11093
2020-11-14,New York,36,561308,5391,33477,25,16619076,184162,556551,5388,16062525,178774
2020-11-14,North Carolina,37,309703,3205,4783,34,4591525,54758,309118,3885,4282407,50873
2020-11-14,North Dakota,38,62878,2270,732,19,322228,3490,62872,2270,259356,1220
2020-11-14,Northern Mariana Islands,69,100,0,2,0,16567,0,100,0,16467,0
2020-11-14,Ohio,39,290243,7715,5714,14,5195015,62234,290243,7715,4904772,54519
2020-11-14,Oklahoma,40,150205,2847,1516,23,1803804,12781,150205,2847,1653599,9934
2020-11-14,Oregon,41,56018,1081,760,1,951565,8418,56018,1081,895547,7337
2020-11-14,Pennsylvania,42,264396,4395,9353,47,2798085,19714,259938,5551,2538147,14163
2020-11-14,Puerto Rico,72,75387,653,921,7,347744,653,41772,653,305972,0
2020-11-14,Rhode Island,44,41529,0,1254,0,480477,3547,42763,1234,437714,2313
2020-11-14,South Carolina,45,194014,1913,4110,9,2072140,41146,194014,1913,1878126,39233
2020-11-14,South Dakota,46,64182,1855,621,53,291823,3162,64182,1855,227641,1307
2020-11-14,Tennessee,47,299597,4462,3839,25,4054301,34852,305120,4662,3749181,30190
2020-11-14,Texas,48,1082980,9750,20035,118,9235382,82013,1014160,9177,8221222,72836
2020-11-14,Utah,49,151141,4986,712,9,1180724,15993,151141,5352,1029583,10641
2020-11-14,Vermont,50,2843,100,59,0,199626,1019,2843,100,196783,919
2020-11-14,Virgin Islands,78,1434,8,23,0,26069,582,1434,24,24635,558
2020-11-14,Virginia,51,200799,1537,3799,14,2905317,23522,200799,1537,2704518,21985
2020-11-14,Washington,53,133612,1429,2638,4,2722087,27917,125498,2142,2596589,25775
2020-11-14,West Virginia,54,32792,1153,574,9,915656,13363,32792,1153,882864,12210
2020-11-14,Wisconsin,55,323604,5581,2748,54,2312924,19389,323604,5581,1989320,13808
2020-11-14,Wyoming,56,21881,540,144,17,152089,540,21881,540,130208,0
2020-11-15,Alabama,01,217822,1979,3248,2,1493737,6634,217822,1979,1275915,4655
2020-11-15,Alaska,02,23688,659,92,0,867382,5118,22662,642,844720,4476
2020-11-15,Arizona,04,275523,2123,6302,2,1981831,13172,275436,2383,1706395,10789
2020-11-15,Arkansas,05,133040,874,2183,24,1519751,22356,133040,2722,1386711,19634
2020-11-15,California,06,1035981,8965,18265,11,20866785,195189,1019345,10968,19847440,184221
2020-11-15,Colorado,08,164408,3949,2574,20,1462983,18659,163417,4183,1299566,14476
2020-11-15,Connecticut,09,88645,0,4737,0,2706667,0,88645,0,2618022,0
2020-11-15,Delaware,10,28803,408,736,0,379815,2451,28803,408,351012,2043
2020-11-15,District of Columbia,11,18977,163,660,2,588620,5301,18977,163,569643,5138
2020-11-15,Florida,12,885193,10105,17517,29,6599305,44353,872810,9820,5726495,34533
2020-11-15,Georgia,13,409504,1908,8730,1,3887286,21347,386949,1952,3500337,19395
2020-11-15,Guam,66,6893,0,93,0,77376,619,6121,156,71255,463
2020-11-15,Hawaii,15,16619,0,221,0,311912,107,16759,107,295153,0
2020-11-15,Idaho,16,82545,920,763,0,439714,3851,81317,1519,358397,2332
2020-11-15,Illinois,17,574722,10636,11170,72,9070841,84831,573616,10631,8497225,74200
2020-11-15,Indiana,18,254172,6706,4910,22,1938289,20338,251597,6710,1686692,13628
2020-11-15,Iowa,19,186314,2757,1989,4,988601,8715,167282,3554,821319,5161
2020-11-15,Kansas,20,117851,123,1256,0,706787,0,115507,0,591280,0
2020-11-15,Kentucky,21,140267,1413,1742,3,2218770,1449,137586,1449,2081184,0
2020-11-15,Louisiana,22,204513,2532,6132,11,3029596,37128,204513,2532,2825083,34596
2020-11-15,Maine,23,8944,153,165,2,734715,153,8944,153,725771,0
2020-11-15,Maryland,24,166317,2078,4302,9,2110466,12297,165930,1840,1944536,10457
2020-11-15,Massachusetts,25,188275,2133,10329,36,3042924,18197,188275,2133,2854649,16064
2020-11-15,Michigan,26,275892,499,8378,3,5692584,0,275792,0,5416792,0
2020-11-15,Minnesota,27,223637,7553,2961,31,2151282,32203,223581,7553,1927701,24650
2020-11-15,Mississippi,28,134309,969,3543,3,1008172,969,134309,969,873863,0
2020-11-15,Missouri,29,249608,1208,3463,0,1669473,8443,239451,3729,1430022,4714
2020-11-15,Montana,30,47158,1239,525,6,572561,2867,47158,1272,525403,1595
2020-11-15,Nebraska,31,98161,1327,791,1,661243,5284,96834,1912,564409,3372
2020-11-15,Nevada,32,120744,1516,1913,5,882523,4685,120183,1177,762340,3508
2020-11-15,New Hampshire,33,14671,360,499,0,384752,3340,14671,360,370081,2980
2020-11-15,New Jersey,34,281075,4538,16566,18,5339070,128343,279274,4538,5059796,123805
2020-11-15,New Mexico,35,64201,1030,1215,7,1372867,12415,64201,1030,1308666,11385
2020-11-15,New York,36,564952,3644,33508,31,16752278,133202,560200,3649,16192078,129553
2020-11-15,North Carolina,37,312406,2703,4830,47,4632609,41084,312235,3117,4320374,37967
2020-11-15,North Dakota,38,63802,924,742,10,323660,1432,63796,924,259864,508
2020-11-15,Northern Mariana Islands,69,100,0,2,0,16567,0,100,0,16467,0
2020-11-15,Ohio,39,298096,7853,5722,8,5262026,67011,298096,7853,4963930,59158
2020-11-15,Oklahoma,40,154128,3923,1528,12,1807727,3923,154128,3923,1653599,0
2020-11-15,Oregon,41,56880,862,762,2,957979,6414,56880,862,901099,5552
2020-11-15,Pennsylvania,42,269043,4647,9385,32,2824633,26548,265137,5199,2559496,21349
2020-11-15,Puerto Rico,72,76094,707,935,14,348451,707,42479,707,305972,0
2020-11-15,Rhode Island,44,41529,0,1254,0,483583,3106,43442,679,440141,2427
2020-11-15,South Carolina,45,195507,1493,4112,2,2090589,18449,195507,1493,1895082,16956
2020-11-15,South Dakota,46,65381,1199,644,23,294114,2291,65381,1199,228733,1092
2020-11-15,Tennessee,47,305211,5614,3856,17,4100329,46028,310937,5817,3789392,40211
2020-11-15,Texas,48,1090348,7368,20110,75,9371443,136061,1020721,6561,8350722,129500
2020-11-15,Utah,49,153808,2667,718,6,1189268,8544,153808,2667,1035460,5877
2020-11-15,Vermont,50,2889,46,59,0,200304,678,2889,46,197415,632
2020-11-15,Virgin Islands,78,1434,0,23,0,26069,0,1434,0,24635,0
2020-11-15,Virginia,51,201960,1161,3800,1,2939243,33926,201960,1161,2737283,32765
2020-11-15,Washington,53,135365,1753,2638,0,2748782,26695,127731,2233,2621051,24462
2020-11-15,West Virginia,54,33659,867,582,8,926879,11223,33659,867,893220,10356
2020-11-15,Wisconsin,55,329924,6320,2759,11,2331163,18239,329924,6320,2001239,11919
2020-11-15,Wyoming,56,22494,613,144,0,152702,613,22494,613,130208,0
2020-11-16,Alabama,01,219232,1410,3249,1,1501190,7453,219232,1410,1281958,6043
2020-11-16,Alaska,02,24268,580,92,0,872347,4965,23240,578,849107,4387
2020-11-16,Arizona,04,277179,1656,6302,0,1995236,13405,276912,1476,1718324,11929
2020-11-16,Arkansas,05,134348,1308,2225,42,1531206,11455,134348,1308,1396858,10147
2020-11-16,California,06,1047360,11379,18304,39,21068894,202109,1029235,9890,20039659,192219
2020-11-16,Colorado,08,168890,4482,2605,31,1481306,18323,167713,4296,1313593,14027
2020-11-16,Connecticut,09,93284,4639,4759,22,2793152,86485,93284,4639,2699868,81846
2020-11-16,Delaware,10,29200,397,736,0,382909,3094,29200,397,353709,2697
2020-11-16,District of Columbia,11,19064,87,660,0,590352,1732,19064,87,571288,1645
2020-11-16,Florida,12,889856,4663,17558,41,6625477,26172,877340,4530,5748137,21642
2020-11-16,Georgia,13,410581,1077,8740,10,3900708,13422,387930,981,3512778,12441
2020-11-16,Guam,66,7144,251,99,6,78133,757,6175,54,71958,703
2020-11-16,Hawaii,15,16711,92,221,0,312006,94,16853,94,295153,0
2020-11-16,Idaho,16,83906,1361,773,10,442233,2519,82245,928,359988,1591
2020-11-16,Illinois,17,586569,11847,11217,47,9161453,90612,585248,11632,8576205,78980
2020-11-16,Indiana,18,259318,5146,4936,26,1952202,13913,256744,5147,1695458,8766
2020-11-16,Iowa,19,189597,3283,2023,34,992851,4250,169353,2071,823498,2179
2020-11-16,Kansas,20,124697,6846,1266,10,733756,26969,122741,7234,611015,19735
2020-11-16,Kentucky,21,142277,2010,1750,8,2265659,46889,139097,1511,2126562,45378
2020-11-16,Louisiana,22,205059,546,6139,7,3037236,7640,205059,546,2832177,7094
2020-11-16,Maine,23,9117,173,165,0,756172,21457,9117,173,747055,21284
2020-11-16,Maryland,24,168041,1724,4309,7,2123275,12809,167656,1726,1955619,11083
2020-11-16,Massachusetts,25,190439,2164,10340,11,3060081,17157,190439,2164,2869642,14993
2020-11-16,Michigan,26,288543,12651,8437,59,5808470,115886,288954,13162,5519516,102724
2020-11-16,Minnesota,27,231074,7437,2973,12,2176285,25003,231018,7437,1945267,17566
2020-11-16,Mississippi,28,134898,589,3545,2,1041889,33717,134898,589,906991,33128
2020-11-16,Missouri,29,255942,6334,3485,22,1678572,9099,243169,3718,1435403,5381
2020-11-16,Montana,30,48101,943,528,3,573334,773,48027,869,525307,-96
2020-11-16,Nebraska,31,101601,3440,805,14,664980,3737,98161,1327,566819,2410
2020-11-16,Nevada,32,122441,1697,1919,6,887159,4636,122097,1914,765062,2722
2020-11-16,New Hampshire,33,15029,358,500,1,387608,2856,15029,358,372579,2498
2020-11-16,New Jersey,34,283294,2219,16580,14,5341289,2219,281493,2219,5059796,0
2020-11-16,New Mexico,35,65454,1253,1236,21,1386121,13254,65454,1253,1320667,12001
2020-11-16,New York,36,568450,3498,33540,32,16876843,124565,563690,3490,16313153,121075
2020-11-16,North Carolina,37,315314,2908,4843,13,4659829,27220,314207,1972,4345622,25248
2020-11-16,North Dakota,38,64891,1089,749,7,325491,1831,64885,1089,260606,742
2020-11-16,Northern Mariana Islands,69,102,2,2,0,16569,2,102,2,16467,0
2020-11-16,Ohio,39,305364,7268,5742,20,5318839,56813,305364,7268,5013475,49545
2020-11-16,Oklahoma,40,156857,2729,1538,10,1810456,2729,156857,2729,1653599,0
2020-11-16,Oregon,41,57646,766,772,10,962982,5003,57646,766,905336,4237
2020-11-16,Pennsylvania,42,275257,6214,9399,14,2843234,18601,269613,4476,2573621,14125
2020-11-16,Puerto Rico,72,76631,537,942,7,348988,537,43016,537,305972,0
2020-11-16,Rhode Island,44,43923,2394,1270,16,485400,1817,43923,481,441477,1336
2020-11-16,South Carolina,45,196617,1110,4143,31,2105533,14944,196617,1110,1908916,13834
2020-11-16,South Dakota,46,66278,897,644,0,296147,2033,66278,897,229869,1136
2020-11-16,Tennessee,47,312710,7499,3884,28,4161846,61517,318888,7951,3842958,53566
2020-11-16,Texas,48,1101719,11371,20157,47,9378611,7168,1027889,7168,8350722,0
2020-11-16,Utah,49,155779,1971,725,7,1198557,9289,155779,1971,1042778,7318
2020-11-16,Vermont,50,3008,119,59,0,201176,872,3008,119,198168,753
2020-11-16,Virgin Islands,78,1434,0,23,0,26069,0,1434,0,24635,0
2020-11-16,Virginia,51,204637,2677,3806,6,2957245,18002,204637,2677,2752608,15325
2020-11-16,Washington,53,138602,3237,2661,23,2778095,29313,130040,2309,2648055,27004
2020-11-16,West Virginia,54,34460,801,585,3,938911,12032,34460,801,904451,11231
2020-11-16,Wisconsin,55,334640,4716,2775,16,2343710,12547,334562,4638,2009148,7909
2020-11-16,Wyoming,56,23193,699,144,0,153401,699,23193,699,130208,0
2020-11-17,Alabama,01,220848,1616,3301,52,1508520,7330,220848,1616,1287672,5714
2020-11-17,Alaska,02,24909,641,94,2,878622,6275,23874,634,854748,5641
2020-11-17,Arizona,04,281284,4105,6320,18,2011792,16556,279896,2984,1731896,13572
2020-11-17,Arkansas,05,135902,1554,2245,20,1540028,8822,135902,1554,1404126,7268
2020-11-17,California,06,1058096,10736,18360,56,21259076,190182,1037978,8743,20221098,181439
2020-11-17,Colorado,08,173220,4330,2626,21,1500349,19043,172044,4331,1328305,14712
2020-11-17,Connecticut,09,94986,1702,4771,12,2826458,33306,94986,1702,2731472,31604
2020-11-17,Delaware,10,29552,352,739,3,385476,2567,29552,352,355924,2215
2020-11-17,District of Columbia,11,19309,245,660,0,596742,6390,19309,245,577433,6145
2020-11-17,Florida,12,897315,7459,17643,85,6663538,38061,884625,7285,5778913,30776
2020-11-17,Georgia,13,414821,4240,8778,38,3954422,53714,391466,3536,3562956,50178
2020-11-17,Guam,66,7203,59,101,2,78948,815,6234,59,72714,756
2020-11-17,Hawaii,15,16755,44,221,0,312058,52,16905,52,295153,0
2020-11-17,Idaho,16,85383,1477,803,30,445207,2974,83344,1099,361863,1875
2020-11-17,Illinois,17,599358,12789,11327,110,9255658,94205,597849,12601,8657809,81604
2020-11-17,Indiana,18,264810,5492,5025,89,1969088,16886,262207,5463,1706881,11423
2020-11-17,Iowa,19,193196,3599,2064,41,997034,4183,171545,2192,825489,1991
2020-11-17,Kansas,20,125668,971,1266,0,733756,0,122741,0,611015,0
2020-11-17,Kentucky,21,145220,2943,1787,37,2287167,21508,142008,2911,2145159,18597
2020-11-17,Louisiana,22,207685,2626,6156,17,3068330,31094,207685,2626,2860645,28468
2020-11-17,Maine,23,9363,246,166,1,764918,8746,9363,246,755555,8500
2020-11-17,Maryland,24,170193,2152,4335,26,2135601,12326,169805,2149,1965796,10177
2020-11-17,Massachusetts,25,192964,2525,10360,20,3078086,18005,192964,2525,2885122,15480
2020-11-17,Michigan,26,296436,7893,8513,76,5865787,57317,296840,7886,5568947,49431
2020-11-17,Minnesota,27,237005,5931,2999,26,2191193,14908,236949,5931,1954244,8977
2020-11-17,Mississippi,28,135803,905,3581,36,1042794,905,135803,905,906991,0
2020-11-17,Missouri,29,261105,5163,3552,67,1692549,13977,248886,5717,1443663,8260
2020-11-17,Montana,30,49496,1395,548,20,583828,10494,49398,1371,534430,9123
2020-11-17,Nebraska,31,103805,2204,827,22,674139,9159,101601,3440,572538,5719
2020-11-17,Nevada,32,124082,1641,1946,27,892492,5333,123794,1697,768698,3636
2020-11-17,New Hampshire,33,15303,274,502,2,388900,1292,15303,274,373597,1018
2020-11-17,New Jersey,34,287320,4026,16618,38,5374691,33402,285519,4026,5089172,29376
2020-11-17,New Mexico,35,67559,2105,1264,28,1398339,12218,67559,2105,1330780,10113
2020-11-17,New York,36,573544,5094,33576,36,17036695,159852,568778,5088,16467917,154764
2020-11-17,North Carolina,37,318537,3223,4881,38,4697561,37732,317495,3288,4380066,34444
2020-11-17,North Dakota,38,65973,1082,775,26,327340,1849,65967,1082,261373,767
2020-11-17,Northern Mariana Islands,69,103,1,2,0,16570,1,103,1,16467,0
2020-11-17,Ohio,39,312443,7079,5772,30,5364520,45681,312443,7079,5052077,38602
2020-11-17,Oklahoma,40,158408,1551,1544,6,1851019,40563,158408,1551,1692611,39012
2020-11-17,Oregon,41,58570,924,779,7,969822,6840,58570,924,911252,5916
2020-11-17,Pennsylvania,42,280978,5721,9433,34,2863980,20746,275513,5900,2588467,14846
2020-11-17,Puerto Rico,72,77200,569,951,9,349557,569,43585,569,305972,0
2020-11-17,Rhode Island,44,44528,605,1278,8,488250,2850,44528,605,443722,2245
2020-11-17,South Carolina,45,197900,1283,4156,13,2122323,16790,197900,1283,1924423,15507
2020-11-17,South Dakota,46,67284,1006,644,0,298359,2212,67284,1006,231075,1206
2020-11-17,Tennessee,47,314553,1843,3953,69,4176151,14305,320729,1841,3855422,12464
2020-11-17,Texas,48,1112576,10857,20278,121,9441069,62458,1039513,11624,8401556,50834
2020-11-17,Utah,49,159006,3227,734,9,1208117,9560,158957,3178,1049160,6382
2020-11-17,Vermont,50,3104,96,59,0,202177,1001,3104,96,199073,905
2020-11-17,Virgin Islands,78,1450,16,23,0,26433,364,1450,16,24983,348
2020-11-17,Virginia,51,206762,2125,3835,29,2982632,25387,206762,2125,2775870,23262
2020-11-17,Washington,53,140923,2321,2686,25,2795736,17641,131532,1492,2664204,16149
2020-11-17,West Virginia,54,35324,864,598,13,947444,8533,35324,864,912120,7669
2020-11-17,Wisconsin,55,342155,7515,2876,101,2366956,23246,342155,7593,2024801,15653
2020-11-17,Wyoming,56,24453,1260,155,11,152140,-1261,24453,1260,127687,-2521
2020-11-18,Alabama,01,223486,2638,3347,46,1517531,9011,223486,2638,1294045,6373
2020-11-18,Alaska,02,25454,545,94,0,885558,6936,24419,545,861139,6391
2020-11-18,Arizona,04,284554,3270,6365,45,2026755,14963,283102,3206,1743653,11757
2020-11-18,Arkansas,05,137617,1715,2275,30,1552919,12891,137617,1715,1415302,11176
2020-11-18,California,06,1069517,11421,18467,107,21418543,159467,1047789,9811,20370754,149656
2020-11-18,Colorado,08,178224,5004,2669,43,1520268,19919,176694,4650,1343574,15269
2020-11-18,Connecticut,09,97028,2042,4784,13,2860684,34226,97028,2042,2763656,32184
2020-11-18,Delaware,10,29755,203,742,3,386673,1197,29755,203,356918,994
2020-11-18,District of Columbia,11,19465,156,665,5,601412,4670,19465,156,581947,4514
2020-11-18,Florida,12,905240,7925,17730,87,6704999,41461,892352,7727,5812647,33734
2020-11-18,Georgia,13,417934,3113,8833,55,3975069,20647,393890,2424,3581179,18223
2020-11-18,Guam,66,7315,112,101,0,79060,112,6346,112,72714,0
2020-11-18,Hawaii,15,16817,62,222,1,312127,69,16974,69,295153,0
2020-11-18,Idaho,16,87020,1637,815,12,448393,3186,85125,1781,363268,1405
2020-11-18,Illinois,17,608056,8698,11488,161,9359227,103569,606771,8922,8752456,94647
2020-11-18,Indiana,18,270847,6037,5084,59,1989456,20368,268222,6015,1721234,14353
2020-11-18,Iowa,19,197532,4336,2102,38,1003986,6952,174839,3294,829147,3658
2020-11-18,Kansas,20,131051,5383,1326,60,748261,14505,128594,5853,619667,8652
2020-11-18,Kentucky,21,148069,2849,1816,29,2318785,31618,144753,2745,2174032,28873
2020-11-18,Louisiana,22,209914,2229,6184,28,3085849,17519,209914,2229,2875935,15290
2020-11-18,Maine,23,9519,156,170,4,775369,10451,9519,156,765850,10295
2020-11-18,Maryland,24,172204,2011,4351,16,2149335,13734,171823,2018,1977512,11716
2020-11-18,Massachusetts,25,195868,2904,10407,47,3101308,23222,195868,2904,2905440,20318
2020-11-18,Michigan,26,302541,6105,8576,63,5922691,56904,303058,6218,5619633,50686
2020-11-18,Minnesota,27,242099,5094,3066,67,2207809,16616,242043,5094,1965766,11522
2020-11-18,Mississippi,28,137396,1593,3601,20,1044387,1593,137396,1593,906991,0
2020-11-18,Missouri,29,266187,5082,3591,39,1702476,9927,253473,4587,1449003,5340
2020-11-18,Montana,30,50650,1154,568,20,591406,7578,50582,1184,540824,6394
2020-11-18,Nebraska,31,106617,2812,838,11,678985,4846,103805,2204,575180,2642
2020-11-18,Nevada,32,126106,2024,1947,1,895771,3279,125459,1665,770312,1614
2020-11-18,New Hampshire,33,15749,446,504,2,391151,2251,15749,446,375402,1805
2020-11-18,New Jersey,34,291374,4054,16655,37,5466148,91457,289562,4043,5176586,87414
2020-11-18,New Mexico,35,70452,2893,1290,26,1409823,11484,70451,2892,1339372,8592
2020-11-18,New York,36,578826,5282,33607,31,17191129,154434,574072,5294,16617057,149140
2020-11-18,North Carolina,37,322258,3721,4927,46,4731171,33610,320862,3367,4410309,30243
2020-11-18,North Dakota,38,67236,1263,791,16,328910,1570,67230,1263,261680,307
2020-11-18,Northern Mariana Islands,69,103,0,2,0,16570,0,103,0,16467,0
2020-11-18,Ohio,39,318828,6385,5827,55,5370905,6385,318828,6385,5052077,0
2020-11-18,Oklahoma,40,161425,3017,1570,26,1868941,17922,161425,3017,1707516,14905
2020-11-18,Oregon,41,59670,1100,791,12,976850,7028,59669,1099,917181,5929
2020-11-18,Pennsylvania,42,287464,6486,9541,108,2890838,26858,281852,6339,2608986,20519
2020-11-18,Puerto Rico,72,77525,325,971,20,349882,325,43910,325,305972,0
2020-11-18,Rhode Island,44,45911,1383,1284,6,493071,4821,45911,1383,447160,3438
2020-11-18,South Carolina,45,199447,1547,4182,26,2138289,15966,199447,1547,1938842,14419
2020-11-18,South Dakota,46,68671,1387,674,30,300973,2614,68671,1387,232302,1227
2020-11-18,Tennessee,47,319021,4468,4005,52,4200984,24833,325201,4472,3875783,20361
2020-11-18,Texas,48,1125758,13182,20471,193,9522343,81274,1048383,8870,8473960,72404
2020-11-18,Utah,49,162091,3085,742,8,1218943,10826,162028,3071,1056915,7755
2020-11-18,Vermont,50,3161,57,60,1,202721,544,3161,57,199560,487
2020-11-18,Virgin Islands,78,1463,13,23,0,26698,265,1463,13,25235,252
2020-11-18,Virginia,51,208833,2071,3860,25,3003410,20778,208833,2071,2794577,18707
2020-11-18,Washington,53,142511,1588,2704,18,2813081,17345,134121,2589,2678960,14756
2020-11-18,West Virginia,54,36277,953,612,14,960384,12940,36277,953,924107,11987
2020-11-18,Wisconsin,55,350665,8510,2939,63,2387606,20650,350665,8510,2036941,12140
2020-11-18,Wyoming,56,25275,822,155,0,152962,822,25275,822,127687,0
2020-11-19,Alabama,01,225910,2424,3419,72,1533166,15635,225910,2424,1307256,13211
2020-11-19,Alaska,02,25946,492,95,1,898799,13241,24909,490,873890,12751
2020-11-19,Arizona,04,288807,4253,6384,19,2045295,18540,287225,4123,1758070,14417
2020-11-19,Arkansas,05,139855,2238,2297,22,1568140,15221,139855,2238,1428285,12983
2020-11-19,California,06,1082674,13157,18555,88,21552528,133985,1059267,11478,20493261,122507
2020-11-19,Colorado,08,184260,6036,2734,65,1546507,26239,182801,6107,1363706,20132
2020-11-19,Connecticut,09,99381,2353,4805,21,2897280,36596,99381,2353,2797899,34243
2020-11-19,Delaware,10,30153,398,742,0,389021,2348,30153,398,358868,1950
2020-11-19,District of Columbia,11,19678,213,667,2,607834,6422,19678,213,588156,6209
2020-11-19,Florida,12,914325,9085,17809,79,6755524,50525,901234,8882,5854290,41643
2020-11-19,Georgia,13,421381,3447,8867,34,4010676,35607,396641,2751,3614035,32856
2020-11-19,Guam,66,7385,70,102,1,79130,70,6416,70,72714,0
2020-11-19,Hawaii,15,16917,100,222,0,312234,107,17081,107,295153,0
2020-11-19,Idaho,16,88642,1622,838,23,452950,4557,86435,1310,366515,3247
2020-11-19,Illinois,17,622869,14813,11671,183,9472674,113447,621383,14612,8851291,98835
2020-11-19,Indiana,18,278142,7295,5143,59,2009763,20307,275503,7281,1734260,13026
2020-11-19,Iowa,19,201572,4040,2127,25,1011476,7490,178313,3474,833163,4016
2020-11-19,Kansas,20,131408,357,1326,0,748261,0,128594,0,619667,0
2020-11-19,Kentucky,21,151706,3637,1843,27,2355104,36319,148390,3637,2206714,32682
2020-11-19,Louisiana,22,211966,2052,6199,15,3111627,25778,211966,2052,2899661,23726
2020-11-19,Maine,23,9734,215,171,1,788349,12980,9734,215,778615,12765
2020-11-19,Maryland,24,175092,2888,4372,21,2169508,20173,174733,2910,1994775,17263
2020-11-19,Massachusetts,25,198550,2682,10435,28,3123408,22100,198550,2682,2924858,19418
2020-11-19,Michigan,26,310396,7855,8717,141,5992927,70236,311041,7983,5681886,62253
2020-11-19,Minnesota,27,249962,7863,3138,72,2236816,29007,249906,7863,1986910,21144
2020-11-19,Mississippi,28,138791,1395,3619,18,1045782,1395,138791,1395,906991,0
2020-11-19,Missouri,29,270486,4299,3618,27,1712709,10233,257822,4349,1454887,5884
2020-11-19,Montana,30,51872,1222,569,1,595829,4423,51818,1236,544011,3187
2020-11-19,Nebraska,31,109280,2663,863,25,685788,6803,106617,2812,579171,3991
2020-11-19,Nevada,32,128234,2128,1958,11,903173,7402,127875,2416,775298,4986
2020-11-19,New Hampshire,33,16277,528,506,2,395483,4332,16277,528,379206,3804
2020-11-19,New Jersey,34,295556,4182,16689,34,5470330,4182,293744,4182,5176586,0
2020-11-19,New Mexico,35,74116,3664,1302,12,1420797,10974,74116,3665,1346681,7309
2020-11-19,New York,36,584128,5302,33648,41,17386368,195239,579382,5310,16806986,189929
2020-11-19,North Carolina,37,325658,3400,4968,41,4786263,55092,325158,4296,4461105,50796
2020-11-19,North Dakota,38,68618,1382,801,10,331177,2267,68612,1382,262565,885
2020-11-19,Northern Mariana Islands,69,103,0,2,0,16570,0,103,0,16467,0
2020-11-19,Ohio,39,326615,7787,5890,63,5475735,104830,326615,7787,5149120,97043
2020-11-19,Oklahoma,40,164340,2915,1588,18,1890561,21620,164340,2915,1726221,18705
2020-11-19,Oregon,41,60874,1204,809,18,985292,8442,60873,1204,924419,7238
2020-11-19,Pennsylvania,42,294345,6881,9643,102,2918505,27667,288978,7126,2629527,20541
2020-11-19,Puerto Rico,72,78046,521,982,11,350403,521,44431,521,305972,0
2020-11-19,Rhode Island,44,46951,1040,1288,4,496789,3718,46951,1040,449838,2678
2020-11-19,South Carolina,45,201160,1713,4201,19,2162127,23838,201160,1713,1960967,22125
2020-11-19,South Dakota,46,69742,1071,705,31,303269,2296,69742,1071,233527,1225
2020-11-19,Tennessee,47,321832,2811,4082,77,4218632,17648,328088,2887,3890544,14761
2020-11-19,Texas,48,1139526,13768,20689,218,9656497,134154,1060883,12500,8595614,121654
2020-11-19,Utah,49,165996,3905,758,16,1233330,14387,165996,3968,1067334,10419
2020-11-19,Vermont,50,3310,149,61,1,205694,2973,3310,149,202384,2824
2020-11-19,Virgin Islands,78,1469,6,23,0,26940,242,1469,6,25471,236
2020-11-19,Virginia,51,210787,1954,3896,36,3028092,24682,210787,1954,2817305,22728
2020-11-19,Washington,53,144968,2457,2717,13,2835472,22391,135424,1303,2700048,21088
2020-11-19,West Virginia,54,37399,1122,623,11,977539,17155,37399,1122,940140,16033
2020-11-19,Wisconsin,55,358113,7448,3021,82,2407639,20033,358113,7448,2049526,12585
2020-11-19,Wyoming,56,26169,894,176,21,156299,3337,26169,894,130130,2443
