date,state,fips,cases,newCases,deaths,newDeaths,tests,newTests,positive,newPositive,negative,newNegative
2020-09-15,US,00,6614317,39217,195689,1281,88590571,691802,6531560,34756,82059011,657046
2020-09-16,US,00,6653585,39268,196686,997,89248888,658317,6571832,40272,82677056,618045
2020-09-17,US,00,6698895,45310,197535,849,90027521,778633,6615219,43387,83412302,735246
2020-09-18,US,00,6747782,48887,198484,949,90882344,854823,6662536,47317,84219808,807506
2020-09-19,US,00,6789593,41811,199154,670,91806021,923677,6707920,45384,85098101,878293
2020-09-20,US,00,6825949,36356,199367,213,92622421,816400,6743362,35442,85879059,780958
2020-09-21,US,00,6880899,54950,199797,430,93284111,661690,6782473,39111,86501638,622579
2020-09-22,US,00,6918290,37391,200738,941,94016987,732876,6831499,49026,87185488,683850
2020-09-23,US,00,6959841,41551,201828,1090,94841001,824014,6870787,39288,87970214,784726
2020-09-24,US,00,7005043,45202,202713,885,95621957,780956,6914220,43433,88707737,737523
2020-09-25,US,00,7059624,54581,203566,853,96556949,934992,6969465,55245,89587484,879747
2020-09-26,US,00,7102321,42697,204335,769,97457738,900789,7016472,47007,90441266,853782
2020-09-27,US,00,7139619,37298,204602,267,98163819,706081,7051372,34900,91112447,671181
2020-09-28,US,00,7176979,37360,204952,350,98973623,809804,7086623,35251,91887000,774553
2020-09-29,US,00,7220676,43697,205878,926,99750033,776410,7123417,36794,92626616,739616
2020-09-30,US,00,7262734,42058,206852,974,100489647,739614,7168137,44720,93321510,694894
2020-10-01,US,00,7309152,46418,207699,847,101303672,814025,7213890,45753,94089782,768272
2020-10-02,US,00,7362732,53580,208564,865,102291945,988273,7263167,49277,95028778,938996
2020-10-03,US,00,7410511,47779,209273,709,103139551,847606,7313990,50823,95825561,796783
2020-10-04,US,00,7445574,35063,209606,333,103963247,823696,7351991,38001,96611256,785695
2020-10-05,US,00,7507986,62412,210035,429,104831470,868223,7389695,37704,97441775,830519
2020-10-06,US,00,7550848,42862,210756,721,105592134,760664,7428462,38767,98163672,721897
2020-10-07,US,00,7603865,53017,211752,996,106415493,823359,7479569,51107,98935924,772252
2020-10-08,US,00,7660248,56383,212680,928,107385250,969757,7534951,55382,99850299,914375
2020-10-09,US,00,7719210,58962,213595,915,108412444,1027194,7591754,56803,100820690,970391
2020-10-10,US,00,7770858,51648,214187,592,109408384,995940,7649262,57508,101759122,938432
2020-10-11,US,00,7815641,44783,214606,419,110233842,825458,7695756,46494,102538086,778964
2020-10-12,US,00,7863657,48016,214957,351,111117026,883184,7738784,43028,103378242,840156
2020-10-13,US,00,7918051,54394,215783,826,112036721,919695,7785714,46930,104251007,872765
2020-10-14,US,00,7977904,59853,216792,1009,112735254,698533,7842818,57104,104892436,641429
2020-10-15,US,00,8043257,65353,217585,793,113676743,941489,7906236,63418,105770507,878071
2020-10-16,US,00,8113720,70463,218476,891,114684695,1007952,7974596,68360,106710099,939592
2020-10-17,US,00,8166481,52761,219154,678,115710060,1025365,8032012,57416,107678048,967949
2020-10-18,US,00,8214363,47882,219541,387,116502987,792927,8079649,47637,108423338,745290
2020-10-19,US,00,8279803,65440,220058,517,117551406,1048419,8137166,57517,109414240,990902
2020-10-20,US,00,8340397,60594,220987,929,118391997,840591,8197573,60407,110194424,780184
2020-10-21,US,00,8404634,64237,222195,1208,119196282,804285,8258977,61404,110937305,742881
2020-10-22,US,00,8479762,75128,223023,828,120210861,1014579,8332174,73197,111878687,941382
2020-10-23,US,00,8564893,85131,223949,926,121335815,1124954,8414650,82476,112921165,1042478
2020-10-24,US,00,8643591,78698,224821,872,122351403,1015588,8497998,83348,113853405,932240
2020-10-25,US,00,8703303,59712,225160,339,123301206,949803,8562162,64164,114739044,885639
2020-10-26,US,00,8777800,74497,225698,538,124327860,1026654,8625286,63124,115702574,963530
2020-10-27,US,00,8852197,74397,226681,983,125220104,892244,8697144,71858,116522960,820386
2020-10-28,US,00,8934121,81924,227697,1016,126139752,919648,8776543,79399,117363209,840249
2020-10-29,US,00,9024915,90794,228701,1004,127247405,1107653,8865630,89087,118381775,1018566
2020-10-30,US,00,9124729,99814,229672,971,128327201,1079796,8963181,97551,119364020,982245
2020-10-31,US,00,9208964,84235,230510,838,129466882,1139681,9054023,90842,120412859,1048839
2020-11-01,US,00,9283188,74224,230937,427,130396998,930116,9195589,141566,121201409,788550
2020-11-02,US,00,9376927,93739,231477,540,131503651,1106653,9278657,83068,122224994,1023585
2020-11-03,US,00,9469557,92630,232607,1130,132492413,988762,9368025,89368,123124388,899394
2020-11-04,US,00,9577440,107883,234223,1616,133489400,996987,9472627,104602,124016773,892385
2020-11-05,US,00,9698981,121541,235331,1108,134805482,1316082,9590809,118182,125214673,1197900
2020-11-06,US,00,9831853,132872,236577,1246,136093732,1288250,9719103,128294,126374629,1159956
2020-11-07,US,00,9957785,125932,237584,1007,137219010,1125278,9850352,131249,127368658,994029
2020-11-08,US,00,10061201,103416,238048,464,138204441,985431,9962012,111660,128242429,873771
2020-11-09,US,00,10191642,130441,238793,745,139464135,1259694,10079597,117585,129384538,1142109
2020-11-10,US,00,10331382,139740,240258,1465,140602850,1138715,10212109,132512,130390741,1006203
2020-11-11,US,00,10474242,142860,241689,1431,141775278,1172428,10360279,148170,131414999,1024258
2020-11-12,US,00,10637733,163491,242861,1172,142973355,1198077,10516838,156559,132456517,1041518
2020-11-13,US,00,10819326,181593,244250,1389,144358044,1384689,10690115,173277,133667929,1211412
2020-11-14,US,00,10978447,159121,245460,1210,145714093,1356049,10856704,166589,134857389,1189460
2020-11-15,US,00,11113634,135187,246083,623,146942388,1228295,11002911,146207,135939477,1082088
2020-11-16,US,00,11280088,166454,246879,796,148226251,1283863,11152011,149100,137074240,1134763
2020-11-17,US,00,11441833,161745,248486,1607,149532231,1305980,11310487,158476,138221744,1147504
2020-11-18,US,00,11614116,172283,250411,1925,150808899,1276668,11477519,167032,139331380,1109636
2020-11-19,US,00,11801586,187470,252373,1962,152265322,1456423,11664104,186585,140601218,1269838
2020-11-20,US,00,12000258,198672,254325,1952,153839245,1573923,11859997,195893,141979248,1378030
2020-11-21,US,00,12172261,172003,255754,1429,155452351,1613106,12042806,182809,143409545,1430297
2020-11-22,US,00,12313295,141034,256597,843,156852266,1399915,12196178,153372,144656088,1246543
2020-11-23,US,00,12492394,179099,257635,1038,158276446,1424180,12349961,153783,145926485,1270397
2020-11-24,US,00,12670684,178290,259844,2209,159825676,1549230,12514353,164392,147311323,1384838
2020-11-25,US,00,12851220,180536,262157,2313,161224292,1398616,12701487,187134,148522805,1211482
2020-11-26,US,00,12954324,103104,263336,1179,162251768,1027476,12830196,128709,149421572,898767
2020-11-27,US,00,13159786,205462,264748,1412,163853656,1601888,13027376,197180,150826280,1404708
2020-11-28,US,00,13311031,151245,265940,1192,165215234,1361578,13178560,151184,152036674,1210394
2020-11-29,US,00,13447369,136338,266758,818,166221033,1005799,13314807,136247,152906226,869552
2020-11-30,US,00,13615129,167760,268023,1265,167576351,1355318,13463395,148588,154112956,1206730
2020-12-01,US,00,13799415,184286,270633,2610,169722868,2146517,13641607,178212,156081261,1968305
2020-12-02,US,00,14000601,201186,273518,2885,170965349,1242481,13842777,201170,157122572,1041311
2020-12-03,US,00,14218560,217959,276375,2857,172448928,1483579,14056416,213639,158392512,1269940
2020-12-04,US,00,14449741,231181,279012,2637,173958836,1509908,14285608,229192,159673228,1280716
2020-12-05,US,00,14655498,205757,281202,2190,175683388,1724552,14502286,216678,161181102,1507874
2020-12-06,US,00,14827657,172159,282313,1111,176979650,1296262,14683482,181196,162296168,1115066
2020-12-07,US,00,15031799,204142,283846,1533,178492409,1512759,14864420,180938,163627989,1331821
2020-12-08,US,00,15251704,219905,286667,2821,179944393,1451984,15079532,215112,164864861,1236872
2020-12-09,US,00,15471382,219678,289824,3157,181423993,1479600,15293715,214183,166130278,1265417
2020-12-10,US,00,15696634,225252,292761,2937,182918071,1494078,15512666,218951,167405405,1275127
2020-12-11,US,00,15977148,280514,295712,2951,184498147,1580076,15747483,234817,168750664,1345259
2020-12-12,US,00,16184592,207444,297971,2259,185886600,1388453,15971959,224476,169914641,1163977
2020-12-13,US,00,16368840,184248,299328,1357,187286595,1399995,16157760,185801,171128835,1214194
2020-12-14,US,00,16569913,201073,301006,1678,189169252,1882657,16350226,192466,172819026,1690191
2020-12-15,US,00,16772913,203000,304031,3025,190687114,1517862,16540009,189783,174147105,1328079
2020-12-16,US,00,17017946,245033,307642,3611,192118838,1431724,16771662,231653,175347176,1200071
2020-12-17,US,00,17256135,238189,310935,3293,193616520,1497682,17011818,240156,176604702,1257526
2020-12-18,US,00,17507582,251447,313750,2815,195392536,1776016,17251064,239246,178141472,1536770
2020-12-19,US,00,17701529,193947,316378,2628,196782254,1389718,17453876,202812,179328378,1186906
2020-12-20,US,00,17881332,179803,317800,1422,198198637,1416383,17649893,196017,180548744,1220366
2020-12-21,US,00,18083055,201723,319762,1962,199989462,1790825,17828084,178191,182161378,1612634
2020-09-15,Alabama,01,140160,701,2387,32,1032970,5419,140160,701,892810,4718
2020-09-15,Alaska,02,7256,43,41,0,407124,3711,6393,43,400731,3668
2020-09-15,Arizona,04,209215,489,5346,24,1312304,11640,209209,484,1103095,11156
2020-09-15,Arkansas,05,71497,870,1150,158,872116,43849,71357,730,800759,43119
2020-09-15,California,06,769917,2855,14606,148,12928170,121981,760013,2235,12168157,119746
2020-09-15,Colorado,08,62575,543,2006,6,795733,4976,62099,400,733634,4576
2020-09-15,Connecticut,09,55031,136,4485,0,1390771,10783,55031,136,1335740,10647
2020-09-15,Delaware,10,19137,200,618,1,264159,1655,19137,200,245022,1455
2020-09-15,District of Columbia,11,14687,65,616,0,336280,4132,14687,65,321593,4067
2020-09-15,Florida,12,668838,3116,12786,145,4960947,27466,660946,2743,4300001,24723
2020-09-15,Georgia,13,280356,1657,6255,44,2629090,13843,296833,1496,2332257,12347
2020-09-15,Guam,66,2935,39,29,2,44329,435,1966,39,42363,396
2020-09-15,Hawaii,15,10951,64,99,1,262041,2376,10913,79,251128,2297
2020-09-15,Idaho,16,36306,322,425,5,280170,1557,35532,253,244638,1304
2020-09-15,Illinois,17,267380,1511,8589,18,4812922,39031,266305,1466,4546617,37565
2020-09-15,Indiana,18,109445,690,3460,21,1254731,7438,107229,689,1147502,6749
2020-09-15,Iowa,19,75722,653,1234,1,689612,2976,73277,401,616335,2575
2020-09-15,Kansas,20,51006,135,555,9,458381,0,49899,0,408482,0
2020-09-15,Kentucky,21,61986,804,1112,7,1006439,9864,58000,718,948439,9146
2020-09-15,Louisiana,22,159253,371,5278,26,2091958,12659,159253,371,1932705,12288
2020-09-15,Maine,23,4918,15,137,1,336489,2712,4918,15,331571,2697
2020-09-15,Maryland,24,117745,598,3849,10,1472782,7919,117245,599,1355537,7320
2020-09-15,Massachusetts,25,125393,313,9225,6,1981998,11823,125393,313,1856605,11510
2020-09-15,Michigan,26,124978,702,6933,11,3187621,25534,124969,682,3062652,24852
2020-09-15,Minnesota,27,85403,402,1979,5,1247867,4512,85351,402,1162516,4110
2020-09-15,Mississippi,28,90523,505,2734,28,626311,505,90523,505,535788,0
2020-09-15,Missouri,29,107687,1630,1830,18,1155752,10545,105396,1317,1050356,9228
2020-09-15,Montana,30,9281,117,141,2,289368,3498,9244,137,280124,3361
2020-09-15,Nebraska,31,38970,328,451,1,406675,2710,38642,307,368033,2403
2020-09-15,Nevada,32,74129,240,1484,28,646536,1665,74040,226,572496,1439
2020-09-15,New Hampshire,33,7748,34,438,2,232458,642,7748,34,224710,608
2020-09-15,New Jersey,34,199193,436,16043,9,3212311,22341,197404,436,3014907,21905
2020-09-15,New Mexico,35,26923,81,830,7,831995,5376,26923,81,805072,5295
2020-09-15,New York,36,450425,767,32655,16,9455329,73678,445714,766,9009615,72912
2020-09-15,North Carolina,37,187486,1039,3135,41,2652440,17621,186887,1106,2465553,16515
2020-09-15,North Dakota,38,16067,233,175,2,220614,414,16033,232,204581,182
2020-09-15,Northern Mariana Islands,69,61,0,2,0,14377,0,61,0,14316,0
2020-09-15,Ohio,39,139485,1001,4506,87,2659531,36275,139485,1001,2520046,35274
2020-09-15,Oklahoma,40,71314,1091,912,7,1016508,26109,71314,1091,945194,25018
2020-09-15,Oregon,41,29664,176,519,8,618064,3260,29662,178,588402,3082
2020-09-15,Pennsylvania,42,151081,1037,7945,5,1841498,11826,146214,1151,1695284,10675
2020-09-15,Puerto Rico,72,38172,422,551,9,324178,229,18206,229,305972,0
2020-09-15,Rhode Island,44,23250,120,1078,3,310041,1844,23250,120,286791,1724
2020-09-15,South Carolina,45,133470,790,3098,21,1074737,-13736,133470,790,941267,-14526
2020-09-15,South Dakota,46,16994,193,184,0,166096,957,16994,193,149102,764
2020-09-15,Tennessee,47,172692,1194,2102,29,2515429,22578,175231,957,2340198,21621
2020-09-15,Texas,48,701509,6962,14661,153,5951192,39383,668746,5342,5282446,34041
2020-09-15,Utah,49,59017,566,436,0,720331,5409,59000,562,661331,4847
2020-09-15,Vermont,50,1702,6,58,0,150303,421,1702,7,148601,414
2020-09-15,Virgin Islands,78,1232,11,19,0,18545,194,1225,4,17320,190
2020-09-15,Virginia,51,135514,943,2839,96,1791808,12479,135514,943,1656294,11536
2020-09-15,Washington,53,84222,361,2107,12,1667715,11559,82465,138,1585250,11421
2020-09-15,West Virginia,54,12976,156,280,5,490646,2631,12976,156,477670,2475
2020-09-15,Wisconsin,55,97002,1438,1230,11,1381463,12359,96938,1441,1284525,10918
2020-09-15,Wyoming,56,4438,46,46,0,89745,739,4438,46,85307,693
2020-09-16,Alabama,01,141087,927,2392,5,1040771,7801,141087,927,899684,6874
2020-09-16,Alaska,02,7308,52,41,0,408564,1440,6443,50,402121,1390
2020-09-16,Arizona,04,209911,696,5376,30,1328461,16157,209907,698,1118554,15459
2020-09-16,Arkansas,05,72219,722,1157,7,846177,-25939,72219,862,773958,-26801
2020-09-16,California,06,773318,3401,14716,110,13000522,72352,762963,2950,12237559,69402
2020-09-16,Colorado,08,63068,493,2010,4,801922,6189,62686,587,739236,5602
2020-09-16,Connecticut,09,55166,135,4487,2,1394405,3634,55166,135,1339239,3499
2020-09-16,Delaware,10,19234,97,619,1,265905,1746,19234,97,246671,1649
2020-09-16,District of Columbia,11,14743,56,617,1,338241,1961,14743,56,323498,1905
2020-09-16,Florida,12,671193,2355,12938,152,4976056,15109,663234,2288,4312822,12821
2020-09-16,Georgia,13,282363,2007,6276,21,2654121,25031,299056,2223,2355065,22808
2020-09-16,Guam,66,2982,47,29,0,44851,522,2013,47,42838,475
2020-09-16,Hawaii,15,11052,101,102,3,263142,1101,10978,65,252164,1036
2020-09-16,Idaho,16,36594,288,430,5,281642,1472,35810,278,245832,1194
2020-09-16,Illinois,17,269282,1902,8622,33,4865233,52311,268246,1941,4596987,50370
2020-09-16,Indiana,18,110025,580,3472,12,1261892,7161,107809,580,1154083,6581
2020-09-16,Iowa,19,76680,958,1248,14,695111,5499,74080,803,621031,4696
2020-09-16,Kansas,20,51829,823,586,31,464226,5845,50870,971,413356,4874
2020-09-16,Kentucky,21,62723,737,1118,6,1027779,21340,58764,764,969015,20576
2020-09-16,Louisiana,22,159865,612,5294,16,2115184,23226,159865,612,1955319,22614
2020-09-16,Maine,23,4941,23,138,1,342187,5698,4941,23,337246,5675
2020-09-16,Maryland,24,118387,642,3855,6,1482958,10176,117888,643,1365070,9533
2020-09-16,Massachusetts,25,125699,306,9245,20,1998641,16643,125699,306,1872942,16337
2020-09-16,Michigan,26,125782,804,6944,11,3218461,30840,125742,773,3092719,30067
2020-09-16,Minnesota,27,85865,462,1985,6,1252392,4525,85813,462,1166579,4063
2020-09-16,Mississippi,28,91234,711,2756,22,632731,6420,91234,711,541497,5709
2020-09-16,Missouri,29,108997,1310,1844,14,1164383,8631,106587,1191,1057796,7440
2020-09-16,Montana,30,9487,206,141,0,292401,3033,9431,187,282970,2846
2020-09-16,Nebraska,31,39419,449,455,4,408961,2286,38970,328,369991,1958
2020-09-16,Nevada,32,74377,248,1496,12,649533,2997,74248,208,575285,2789
2020-09-16,New Hampshire,33,7780,32,438,0,233731,1273,7780,32,225951,1241
2020-09-16,New Jersey,34,199583,390,16054,11,3234972,22661,197792,388,3037180,22273
2020-09-16,New Mexico,35,27041,118,832,2,837400,5405,27041,118,810359,5287
2020-09-16,New York,36,451078,653,32662,7,9530416,75087,446366,652,9084050,74435
2020-09-16,North Carolina,37,188800,1314,3176,41,2683384,30944,188024,1137,2495360,29807
2020-09-16,North Dakota,38,16336,269,180,5,222022,1408,16298,265,205724,1143
2020-09-16,Northern Mariana Islands,69,61,0,2,0,14377,0,61,0,14316,0
2020-09-16,Ohio,39,140518,1033,4555,49,2689480,29949,140518,1033,2548962,28916
2020-09-16,Oklahoma,40,72284,970,924,12,1027596,11088,72284,970,955312,10118
2020-09-16,Oregon,41,29856,192,521,2,621273,3209,29850,188,591423,3021
2020-09-16,Pennsylvania,42,151889,808,7963,18,1855121,13623,146990,776,1708131,12847
2020-09-16,Puerto Rico,72,38284,112,570,19,324224,46,18252,46,305972,0
2020-09-16,Rhode Island,44,23358,108,1081,3,311344,1303,23358,108,287986,1195
2020-09-16,South Carolina,45,134122,652,3132,34,1080922,6185,134122,652,946800,5533
2020-09-16,South Dakota,46,17291,297,192,8,169655,3559,17291,297,152364,3262
2020-09-16,Tennessee,47,174400,1708,2127,25,2543236,27807,177087,1856,2366149,25951
2020-09-16,Texas,48,706034,4525,14803,142,5992779,41587,674772,6026,5318007,35561
2020-09-16,Utah,49,59770,753,437,1,726490,6159,59747,747,666743,5412
2020-09-16,Vermont,50,1702,0,58,0,150652,349,1704,2,148948,347
2020-09-16,Virgin Islands,78,1232,0,19,0,18672,127,1232,7,17440,120
2020-09-16,Virginia,51,136359,845,2884,45,1806247,14439,136359,845,1669888,13594
2020-09-16,Washington,53,84714,492,2113,6,1678866,11151,82976,511,1595890,10640
2020-09-16,West Virginia,54,13196,220,290,10,493883,3237,13196,220,480687,3017
2020-09-16,Wisconsin,55,98501,1499,1238,8,1393753,12290,98440,1502,1295313,10788
2020-09-16,Wyoming,56,4566,128,46,0,89969,224,4566,128,85403,96
2020-09-17,Alabama,01,141757,670,2401,9,1044913,4142,141757,670,903156,3472
2020-09-17,Alaska,02,7413,105,41,0,415863,7299,6551,108,409312,7191
2020-09-17,Arizona,04,211663,1752,5411,35,1352882,24421,211660,1753,1141222,22668
2020-09-17,Arkansas,05,73211,992,1166,9,856918,10741,73211,992,783707,9749
2020-09-17,California,06,776944,3626,14807,91,13080037,79515,766201,3238,12313836,76277
2020-09-17,Colorado,08,63613,545,2016,6,809241,7319,63145,459,746096,6860
2020-09-17,Connecticut,09,55386,220,4488,1,1408273,13868,55386,220,1352887,13648
2020-09-17,Delaware,10,19318,84,619,0,267168,1263,19318,84,247850,1179
2020-09-17,District of Columbia,11,14790,47,619,2,341318,3077,14790,47,326528,3030
2020-09-17,Florida,12,674448,3255,13085,147,5003024,26968,666507,3273,4336517,23695
2020-09-17,Georgia,13,284219,1856,6328,52,2679891,25770,300903,1847,2378988,23923
2020-09-17,Guam,66,3014,32,31,2,45253,402,2045,32,43208,370
2020-09-17,Hawaii,15,11211,159,106,4,265634,2492,11080,102,254554,2390
2020-09-17,Idaho,16,36924,330,435,5,283365,1723,36093,283,247272,1440
2020-09-17,Illinois,17,271370,2088,8643,21,4923033,57800,270302,2056,4652731,55744
2020-09-17,Indiana,18,110863,838,3478,6,1269650,7758,108646,837,1161004,6921
2020-09-17,Iowa,19,77865,1185,1257,9,701438,6327,75028,948,626410,5379
2020-09-17,Kansas,20,52039,210,586,0,464226,0,50870,0,413356,0
2020-09-17,Kentucky,21,63412,689,1127,9,1038685,10906,59370,606,979315,10300
2020-09-17,Louisiana,22,160343,478,5311,17,2124190,9006,160343,478,1963847,8528
2020-09-17,Maine,23,4962,21,138,0,351378,9191,4962,21,346416,9170
2020-09-17,Maryland,24,119017,630,3861,6,1494342,11384,118519,631,1375823,10753
2020-09-17,Massachusetts,25,126128,429,9260,15,2026295,27654,126128,429,1900167,27225
2020-09-17,Michigan,26,126794,1012,6956,12,3251731,33270,126722,980,3125009,32290
2020-09-17,Minnesota,27,86774,909,1994,9,1263546,11154,86722,909,1176824,10245
2020-09-17,Mississippi,28,91935,701,2780,24,633432,701,91935,701,541497,0
2020-09-17,Missouri,29,110554,1557,1864,20,1178581,14198,108334,1747,1070247,12451
2020-09-17,Montana,30,9721,234,143,2,295299,2898,9647,216,285652,2682
2020-09-17,Nebraska,31,39921,502,457,2,412851,3890,39419,449,373432,3441
2020-09-17,Nevada,32,74792,415,1509,13,652583,3050,74595,347,577988,2703
2020-09-17,New Hampshire,33,7814,34,438,0,235510,1779,7814,34,227696,1745
2020-09-17,New Jersey,34,200152,569,16057,3,3265818,30846,198361,569,3067457,30277
2020-09-17,New Mexico,35,27199,158,836,4,845167,7767,27199,158,817968,7609
2020-09-17,New York,36,451971,893,32669,7,9621920,91504,447262,896,9174658,90608
2020-09-17,North Carolina,37,190307,1507,3208,32,2714175,30791,189576,1552,2524599,29239
2020-09-17,North Dakota,38,16726,390,185,5,223137,1115,16690,392,206447,723
2020-09-17,Northern Mariana Islands,69,62,1,2,0,14378,1,62,1,14316,0
2020-09-17,Ohio,39,141585,1067,4580,25,2718333,28853,141585,1067,2576748,27786
2020-09-17,Oklahoma,40,73318,1034,930,6,1039837,12241,73318,1034,966519,11207
2020-09-17,Oregon,41,30068,212,521,0,625424,4151,29850,0,595574,4151
2020-09-17,Pennsylvania,42,152813,924,7978,15,1869198,14077,147923,933,1721275,13144
2020-09-17,Puerto Rico,72,38867,583,588,18,324606,382,18634,382,305972,0
2020-09-17,Rhode Island,44,23488,130,1085,4,313275,1931,23488,130,289787,1801
2020-09-17,South Carolina,45,135446,1324,3158,26,1087587,6665,135446,1324,952141,5341
2020-09-17,South Dakota,46,17686,395,193,1,171523,1868,17686,395,153837,1473
2020-09-17,Tennessee,47,175702,1302,2141,14,2564879,21643,178140,1053,2386739,20590
2020-09-17,Texas,48,710423,4389,14909,106,6036115,43336,678819,4047,5357296,39289
2020-09-17,Utah,49,60662,892,437,0,732682,6192,60658,911,672024,5281
2020-09-17,Vermont,50,1705,3,58,0,151715,1063,1707,3,150008,1060
2020-09-17,Virgin Islands,78,1238,6,19,0,18779,107,1238,6,17541,101
2020-09-17,Virginia,51,137460,1101,2920,36,1828512,22265,137460,1101,1691052,21164
2020-09-17,Washington,53,85101,387,2123,10,1693307,14441,83458,482,1609849,13959
2020-09-17,West Virginia,54,13430,234,294,4,498283,4400,13430,234,484853,4166
2020-09-17,Wisconsin,55,100619,2118,1240,2,1405298,11545,100574,2134,1304724,9411
2020-09-17,Wyoming,56,4652,86,49,3,91452,1483,4652,86,86800,1397
2020-09-18,Alabama,01,142863,1106,2428,27,1053055,8142,142863,1106,910192,7036
2020-09-18,Alaska,02,7528,115,42,1,418293,2430,6658,107,411635,2323
2020-09-18,Arizona,04,213663,2000,5455,44,1362319,9437,212942,1282,1149377,8155
2020-09-18,Arkansas,05,74082,871,1173,7,868179,11261,74082,871,794097,10390
2020-09-18,California,06,781436,4492,14912,105,13177186,97149,769831,3630,12407355,93519
2020-09-18,Colorado,08,64277,664,2020,4,817869,8628,63750,605,754119,8023
2020-09-18,Connecticut,09,55527,141,4492,4,1422148,13875,55527,141,1366621,13734
2020-09-18,Delaware,10,19366,48,620,1,268638,1470,19366,48,249272,1422
2020-09-18,District of Columbia,11,14852,62,619,0,347118,5800,14852,62,332266,5738
2020-09-18,Florida,12,677652,3204,13224,139,5030285,27261,669684,3177,4360601,24084
2020-09-18,Georgia,13,286170,1951,6390,62,2701952,22061,302737,1834,2399215,20227
2020-09-18,Guam,66,3043,29,34,3,45653,400,2074,29,43579,371
2020-09-18,Hawaii,15,11348,137,119,13,269463,3829,11239,159,258224,3670
2020-09-18,Idaho,16,37358,434,439,4,285552,2187,36489,396,249063,1791
2020-09-18,Illinois,17,273596,2226,8666,23,4985054,62021,272525,2223,4712529,59798
2020-09-18,Indiana,18,111900,1037,3495,17,1281438,11788,109683,1037,1171755,10751
2020-09-18,Iowa,19,78839,974,1264,7,708031,6593,76211,1183,631820,5410
2020-09-18,Kansas,20,53403,1364,596,10,474749,10523,52285,1415,422464,9108
2020-09-18,Kentucky,21,64155,743,1132,5,1051851,13166,60128,758,991723,12408
2020-09-18,Louisiana,22,161322,979,5340,29,2146986,22796,161322,979,1985664,21817
2020-09-18,Maine,23,5005,43,138,0,364424,13046,5005,43,359419,13003
2020-09-18,Maryland,24,119559,542,3869,8,1504867,10525,119062,543,1385805,9982
2020-09-18,Massachusetts,25,126582,454,9269,9,2048535,22240,126582,454,1921953,21786
2020-09-18,Michigan,26,127558,764,6955,-1,3285030,33299,127500,778,3157530,32521
2020-09-18,Minnesota,27,87859,1085,2002,8,1278837,15291,87807,1085,1191030,14206
2020-09-18,Mississippi,28,92432,497,2792,12,633432,0,91935,0,541497,0
2020-09-18,Missouri,29,112547,1993,1892,28,1190380,11799,110129,1795,1080251,10004
2020-09-18,Montana,30,9934,213,146,3,298555,3256,9871,224,288684,3032
2020-09-18,Nebraska,31,40387,466,457,0,416575,3724,39921,502,376654,3222
2020-09-18,Nevada,32,75153,361,1526,17,656601,4018,75096,501,581505,3517
2020-09-18,New Hampshire,33,7861,47,438,0,237518,2008,7861,47,229657,1961
2020-09-18,New Jersey,34,200639,487,16061,4,3291916,26098,198848,487,3093068,25611
2020-09-18,New Mexico,35,27350,151,841,5,850963,5796,27350,151,823613,5645
2020-09-18,New York,36,452764,793,32682,13,9711647,89727,448052,790,9263595,88937
2020-09-18,North Carolina,37,191672,1365,3232,24,2749020,34845,191019,1443,2558001,33402
2020-09-18,North Dakota,38,17233,507,187,2,225158,2021,17195,505,207963,1516
2020-09-18,Northern Mariana Islands,69,62,0,2,0,14378,0,62,0,14316,0
2020-09-18,Ohio,39,142596,1011,4608,28,2753105,34772,142596,1011,2610509,33761
2020-09-18,Oklahoma,40,74567,1249,939,9,1054217,14380,74567,1249,979650,13131
2020-09-18,Oregon,41,30351,283,524,3,629422,3998,30342,492,599080,3506
2020-09-18,Pennsylvania,42,153560,747,8006,28,1881488,12290,148683,760,1732805,11530
2020-09-18,Puerto Rico,72,39684,817,599,11,325085,479,19113,479,305972,0
2020-09-18,Rhode Island,44,23620,132,1088,3,315555,2280,23620,132,291935,2148
2020-09-18,South Carolina,45,136318,872,3177,19,1111404,23817,136318,872,975086,22945
2020-09-18,South Dakota,46,18075,389,198,5,173704,2181,18075,389,155629,1792
2020-09-18,Tennessee,47,177707,2005,2173,32,2603342,38463,180497,2357,2422845,36106
2020-09-18,Texas,48,713652,3229,15037,128,6090191,54076,682241,3422,5407950,50654
2020-09-18,Utah,49,61786,1124,437,0,738980,6298,61775,1117,677205,5181
2020-09-18,Vermont,50,1706,1,58,0,152587,872,1709,2,150878,870
2020-09-18,Virgin Islands,78,1257,19,19,0,18954,175,1242,4,17712,171
2020-09-18,Virginia,51,138702,1242,2949,29,1838235,9723,138702,1242,1699533,8481
2020-09-18,Washington,53,85583,482,2130,7,1706997,13690,83929,471,1623068,13219
2020-09-18,West Virginia,54,13683,253,297,3,503133,4850,13683,253,489450,4597
2020-09-18,Wisconsin,55,103211,2592,1247,7,1418412,13114,103154,2580,1315258,10534
2020-09-18,Wyoming,56,4747,95,49,0,92307,855,4747,95,87560,760
2020-09-19,Alabama,01,144164,1301,2437,9,1062612,9557,144164,1301,918448,8256
2020-09-19,Alaska,02,7613,85,42,0,422850,4557,6752,94,416098,4463
2020-09-19,Arizona,04,213551,-112,5471,16,1373159,10840,213551,609,1159608,10231
2020-09-19,Arkansas,05,75160,1078,1181,8,869257,1078,75160,1078,794097,0
2020-09-19,California,06,785076,3640,15023,111,13343886,166700,774135,4304,12569751,162396
2020-09-19,Colorado,08,64694,417,2022,2,825702,7833,64356,606,761346,7227
2020-09-19,Connecticut,09,55527,0,4492,0,1422148,0,55527,0,1366621,0
2020-09-19,Delaware,10,19449,83,621,1,269711,1073,19449,83,250262,990
2020-09-19,District of Columbia,11,14902,50,619,0,350877,3759,14902,50,335975,3709
2020-09-19,Florida,12,681225,3573,13286,62,5060515,30230,673194,3510,4387321,26720
2020-09-19,Georgia,13,288059,1889,6450,60,2735389,33437,305021,2284,2430368,31153
2020-09-19,Guam,66,3043,0,35,1,45958,305,2117,43,43841,262
2020-09-19,Hawaii,15,11457,109,119,0,279899,10436,11376,137,268523,10299
2020-09-19,Idaho,16,37624,266,441,2,288195,2643,36959,470,251236,2173
2020-09-19,Illinois,17,276057,2461,8688,22,5059340,74286,275054,2529,4784286,71757
2020-09-19,Indiana,18,112982,1082,3503,8,1292615,11177,110759,1076,1181856,10101
2020-09-19,Iowa,19,79785,946,1265,1,713775,5744,77058,847,636717,4897
2020-09-19,Kansas,20,53420,17,596,0,474749,0,52285,0,422464,0
2020-09-19,Kentucky,21,65068,913,1137,5,1054776,2925,61106,978,993670,1947
2020-09-19,Louisiana,22,161322,0,5340,0,2146986,0,161322,0,1985664,0
2020-09-19,Maine,23,5035,30,139,1,371187,6763,5035,30,366152,6733
2020-09-19,Maryland,24,120107,548,3876,7,1518804,13937,119744,682,1399060,13255
2020-09-19,Massachusetts,25,127181,599,9295,26,2069863,21328,127181,599,1942682,20729
2020-09-19,Michigan,26,128112,554,6970,15,3318469,33439,128087,587,3190382,32852
2020-09-19,Minnesota,27,88773,914,2015,13,1291395,12558,88721,914,1202674,11644
2020-09-19,Mississippi,28,93087,655,2809,17,702886,69454,93087,1152,609799,68302
2020-09-19,Missouri,29,113794,1247,1905,13,1202624,12244,111516,1387,1091108,10857
2020-09-19,Montana,30,10193,259,156,10,300840,2285,10163,292,290677,1993
2020-09-19,Nebraska,31,40797,410,457,0,419995,3420,40387,466,379608,2954
2020-09-19,Nevada,32,75524,371,1528,2,660686,4085,75419,323,585267,3762
2020-09-19,New Hampshire,33,7920,59,438,0,238732,1214,7920,59,230812,1155
2020-09-19,New Jersey,34,201100,461,16064,3,3292377,461,199309,461,3093068,0
2020-09-19,New Mexico,35,27512,162,847,6,857456,6493,27512,162,829944,6331
2020-09-19,New York,36,453747,983,32679,-3,9822091,110444,449038,986,9373053,109458
2020-09-19,North Carolina,37,192751,1079,3260,28,2771020,22000,192248,1229,2578772,20771
2020-09-19,North Dakota,38,17610,377,195,8,226468,1310,17573,378,208895,932
2020-09-19,Northern Mariana Islands,69,68,6,2,0,14378,0,62,0,14316,0
2020-09-19,Ohio,39,143547,951,4612,4,2788695,35590,143547,951,2645148,34639
2020-09-19,Oklahoma,40,75804,1237,943,4,1071501,17284,75804,1237,995697,16047
2020-09-19,Oregon,41,30600,249,527,3,633910,4488,30599,257,603311,4231
2020-09-19,Pennsylvania,42,154261,701,8028,22,1896125,14637,149845,1162,1746280,13475
2020-09-19,Puerto Rico,72,40993,1309,605,6,325779,694,19807,694,305972,0
2020-09-19,Rhode Island,44,23620,0,1088,0,318016,2461,23798,178,294218,2283
2020-09-19,South Carolina,45,137240,922,3188,11,1123265,11861,137240,922,986025,10939
2020-09-19,South Dakota,46,18444,369,200,2,175221,1517,18444,369,156777,1148
2020-09-19,Tennessee,47,179017,1310,2193,20,2627087,23745,181439,942,2445648,22803
2020-09-19,Texas,48,716914,3262,15124,87,6141184,50993,686068,3827,5455116,47166
2020-09-19,Utah,49,62893,1107,440,3,746137,7157,62852,1077,683285,6080
2020-09-19,Vermont,50,1710,4,58,0,153246,659,1713,4,151533,655
2020-09-19,Virgin Islands,78,1257,0,19,0,18954,0,1242,0,17712,0
2020-09-19,Virginia,51,139655,953,2990,41,1873355,35120,139655,953,1733700,34167
2020-09-19,Washington,53,85886,303,2130,0,1707475,478,84407,478,1623068,0
2020-09-19,West Virginia,54,13874,191,308,11,509486,6353,13874,191,495612,6162
2020-09-19,Wisconsin,55,105609,2398,1249,2,1431004,12592,105557,2403,1325447,10189
2020-09-19,Wyoming,56,4780,33,49,0,92340,33,4780,33,87560,0
2020-09-20,Alabama,01,144962,798,2437,0,1068328,5716,144962,798,923366,4918
2020-09-20,Alaska,02,7704,91,42,0,426925,4075,6860,108,420065,3967
2020-09-20,Arizona,04,214018,467,5480,9,1383924,10765,214018,467,1169906,10298
2020-09-20,Arkansas,05,75723,563,1181,0,886017,16760,75723,563,810294,16197
2020-09-20,California,06,788077,3001,15018,-5,13523158,179272,778400,4265,12744758,175007
2020-09-20,Colorado,08,65248,554,2023,1,832709,7007,64857,501,767852,6506
2020-09-20,Connecticut,09,55527,0,4492,0,1422148,0,55527,0,1366621,0
2020-09-20,Delaware,10,19566,117,621,0,271421,1710,19566,117,251855,1593
2020-09-20,District of Columbia,11,14955,53,620,1,355144,4267,14955,53,340189,4214
2020-09-20,Florida,12,683746,2521,13295,9,5087026,26511,675691,2497,4411335,24014
2020-09-20,Georgia,13,289096,1037,6453,3,2750822,15433,306155,1134,2444667,14299
2020-09-20,Guam,66,3043,0,35,0,45958,0,2117,0,43841,0
2020-09-20,Hawaii,15,11534,77,119,0,280008,109,11485,109,268523,0
2020-09-20,Idaho,16,37768,144,443,2,289928,1733,37247,288,252681,1445
2020-09-20,Illinois,17,277373,1316,8700,12,5107351,48011,276456,1402,4830895,46609
2020-09-20,Indiana,18,113728,746,3506,3,1301940,9325,111505,746,1190435,8579
2020-09-20,Iowa,19,80410,625,1265,0,718279,4504,77679,621,640600,3883
2020-09-20,Kansas,20,53433,13,597,1,474749,0,52285,0,422464,0
2020-09-20,Kentucky,21,65413,345,1139,2,1055212,436,61542,436,993670,0
2020-09-20,Louisiana,22,162258,936,5366,26,2178999,32013,162258,936,2016741,31077
2020-09-20,Maine,23,5079,44,139,0,374138,2951,5079,44,369059,2907
2020-09-20,Maryland,24,120656,549,3879,3,1529476,10672,120156,412,1409320,10260
2020-09-20,Massachusetts,25,127540,359,9310,15,2087281,17418,127540,359,1959741,17059
2020-09-20,Michigan,26,128148,36,6971,1,3318469,0,128087,0,3190382,0
2020-09-20,Minnesota,27,90069,1296,2017,2,1303475,12080,90017,1296,1213458,10784
2020-09-20,Mississippi,28,93364,277,2810,1,703163,277,93364,277,609799,0
2020-09-20,Missouri,29,115000,1206,1896,-9,1212508,9884,112844,1328,1099664,8556
2020-09-20,Montana,30,10325,132,157,1,302813,1973,10299,136,292514,1837
2020-09-20,Nebraska,31,41083,286,457,0,423360,3365,40797,410,382563,2955
2020-09-20,Nevada,32,75914,390,1532,4,665184,4498,75804,385,589380,4113
2020-09-20,New Hampshire,33,7947,27,438,0,240401,1669,7947,27,232454,1642
2020-09-20,New Jersey,34,201553,453,16067,3,3352791,60414,199762,453,3153029,59961
2020-09-20,New Mexico,35,27579,67,849,2,862899,5443,27579,67,835320,5376
2020-09-20,New York,36,454612,865,32686,7,9922446,100355,449900,862,9472546,99493
2020-09-20,North Carolina,37,193978,1227,3270,10,2804818,33798,193581,1333,2611237,32465
2020-09-20,North Dakota,38,17961,351,195,0,228222,1754,17925,352,210297,1402
2020-09-20,Northern Mariana Islands,69,68,0,2,0,14384,6,68,6,14316,0
2020-09-20,Ohio,39,144309,762,4615,3,2825297,36602,144309,762,2680988,35840
2020-09-20,Oklahoma,40,76807,1003,946,3,1072504,1003,76807,1003,995697,0
2020-09-20,Oregon,41,30802,202,528,1,636069,2159,30801,202,605268,1957
2020-09-20,Pennsylvania,42,154924,663,8049,21,1908910,12785,150578,733,1758332,12052
2020-09-20,Puerto Rico,72,41838,845,608,3,326041,262,20069,262,305972,0
2020-09-20,Rhode Island,44,23620,0,1088,0,319803,1787,23880,82,295923,1705
2020-09-20,South Carolina,45,137708,468,3199,11,1132595,9330,137708,468,994887,8862
2020-09-20,South Dakota,46,18696,252,202,2,176353,1132,18696,252,157657,880
2020-09-20,Tennessee,47,180621,1604,2195,2,2667126,40039,183514,2075,2483612,37964
2020-09-20,Texas,48,722460,5546,15159,35,6163931,22747,688534,2466,5475397,20281
2020-09-20,Utah,49,63774,881,440,0,752105,5968,63772,920,688333,5048
2020-09-20,Vermont,50,1715,5,58,0,154201,955,1718,5,152483,950
2020-09-20,Virgin Islands,78,1269,12,19,0,19312,358,1269,27,18043,331
2020-09-20,Virginia,51,140511,856,3015,25,1888817,15462,140511,856,1748306,14606
2020-09-20,Washington,53,86169,283,2130,0,1725783,18308,84942,535,1640841,17773
2020-09-20,West Virginia,54,14054,180,310,2,514304,4818,14054,180,500250,4638
2020-09-20,Wisconsin,55,107343,1734,1250,1,1439394,8390,107292,1735,1332102,6655
2020-09-20,Wyoming,56,4871,91,49,0,92431,91,4871,91,87560,0
2020-09-21,Alabama,01,145780,818,2439,2,1073892,5564,145780,818,928112,4746
2020-09-21,Alaska,02,7775,71,42,0,428645,1720,6930,70,421715,1650
2020-09-21,Arizona,04,214251,233,5482,2,1390962,7038,214251,233,1176711,6805
2020-09-21,Arkansas,05,76364,641,1197,16,893602,7585,76364,641,817238,6944
2020-09-21,California,06,792217,4140,15069,51,13672782,149624,781694,3294,12891088,146330
2020-09-21,Colorado,08,65936,688,2031,8,838884,6175,65399,542,773485,5633
2020-09-21,Connecticut,09,56024,497,4495,3,1467766,45618,56024,497,1411742,45121
2020-09-21,Delaware,10,19667,101,627,6,273213,1792,19667,101,253546,1691
2020-09-21,District of Columbia,11,14978,23,621,1,357744,2600,14978,23,342766,2577
2020-09-21,Florida,12,685431,1685,13316,21,5105183,18157,677362,1671,4427821,16486
2020-09-21,Georgia,13,289975,879,6455,2,2770863,20041,307339,1184,2463524,18857
2020-09-21,Guam,66,3116,73,36,1,46354,396,2147,30,44207,366
2020-09-21,Hawaii,15,11590,56,119,0,281577,1569,11562,77,270015,1492
2020-09-21,Idaho,16,38196,428,447,4,292286,2358,37491,244,254795,2114
2020-09-21,Illinois,17,279032,1659,8717,17,5145585,38234,277933,1477,4867652,36757
2020-09-21,Indiana,18,114251,523,3512,6,1308645,6705,112027,522,1196618,6183
2020-09-21,Iowa,19,81006,596,1284,19,721595,3316,78339,660,643256,2656
2020-09-21,Kansas,20,54956,1523,604,7,484691,9942,53959,1674,430732,8268
2020-09-21,Kentucky,21,65905,492,1141,2,1065404,10192,61917,375,1003487,9817
2020-09-21,Louisiana,22,162501,243,5375,9,2185792,6793,162501,243,2023291,6550
2020-09-21,Maine,23,5106,27,140,1,375392,1254,5106,27,370286,1227
2020-09-21,Maryland,24,121068,412,3883,4,1537629,8153,120568,412,1417061,7741
2020-09-21,Massachusetts,25,127796,256,9317,7,2098116,10835,127796,256,1970320,10579
2020-09-21,Michigan,26,129655,1507,6982,11,3370667,52198,129662,1575,3241005,50623
2020-09-21,Minnesota,27,90994,925,2021,4,1312937,9462,90942,925,1221995,8537
2020-09-21,Mississippi,28,93556,192,2810,0,706906,3743,93556,192,613350,3551
2020-09-21,Missouri,29,116814,1814,1936,40,1219559,7051,114307,1463,1105252,5588
2020-09-21,Montana,30,10509,184,160,3,311262,8449,10429,130,300833,8319
2020-09-21,Nebraska,31,41388,305,464,7,425816,2456,41083,286,384733,2170
2020-09-21,Nevada,32,76119,205,1531,-1,666792,1608,76036,232,590756,1376
2020-09-21,New Hampshire,33,7952,5,438,0,242242,1841,7952,5,234290,1836
2020-09-21,New Jersey,34,201945,392,16069,2,3353183,392,200154,392,3153029,0
2020-09-21,New Mexico,35,27683,104,851,2,866683,3784,27683,104,839000,3680
2020-09-21,New York,36,455187,575,32691,5,9980765,58319,450473,573,9530292,57746
2020-09-21,North Carolina,37,195093,1115,3283,13,2817539,12721,194381,800,2623158,11921
2020-09-21,North Dakota,38,18247,286,196,1,229476,1254,18209,284,211267,970
2020-09-21,Northern Mariana Islands,69,69,1,2,0,14385,1,69,1,14316,0
2020-09-21,Ohio,39,145165,856,4623,8,2856161,30864,145165,856,2710996,30008
2020-09-21,Oklahoma,40,77908,1101,948,2,1073605,1101,77908,1101,995697,0
2020-09-21,Oregon,41,30999,197,532,4,638798,2729,30995,194,607803,2535
2020-09-21,Pennsylvania,42,155729,805,8080,31,1917993,9083,150812,234,1767181,8849
2020-09-21,Puerto Rico,72,42476,638,609,1,326283,242,20311,242,305972,0
2020-09-21,Rhode Island,44,23932,312,1097,9,320566,763,23932,52,296634,711
2020-09-21,South Carolina,45,138124,416,3212,13,1144118,11523,138124,416,1005994,11107
2020-09-21,South Dakota,46,18869,173,202,0,177023,670,18869,173,158154,497
2020-09-21,Tennessee,47,181725,1104,2209,14,2679406,12280,184409,895,2494997,11385
2020-09-21,Texas,48,744736,22276,15212,53,6178723,14792,698387,9853,5480336,4939
2020-09-21,Utah,49,64404,630,441,1,756090,3985,64394,622,691696,3363
2020-09-21,Vermont,50,1719,4,58,0,155039,838,1722,4,153317,834
2020-09-21,Virgin Islands,78,1269,0,19,0,19312,0,1269,0,18043,0
2020-09-21,Virginia,51,141138,627,3021,6,1905474,16657,141138,627,1764336,16030
2020-09-21,Washington,53,86803,634,2137,7,1739273,13490,85265,323,1654008,13167
2020-09-21,West Virginia,54,14171,117,312,2,519516,5212,14171,117,505345,5095
2020-09-21,Wisconsin,55,108656,1313,1253,3,1446215,6821,108588,1296,1337627,5525
2020-09-21,Wyoming,56,4944,73,49,0,94131,1700,4944,73,89187,1627
2020-09-22,Alabama,01,146584,804,2457,18,1080149,6257,146584,804,933565,5453
2020-09-22,Alaska,02,7821,46,42,0,431191,2546,6987,57,424204,2489
2020-09-22,Arizona,04,214846,595,5501,19,1400654,9692,214846,595,1185808,9097
2020-09-22,Arkansas,05,76981,617,1209,12,900206,6604,76981,617,823225,5987
2020-09-22,California,06,795077,2860,15209,140,13804055,131273,784324,2630,13019731,128643
2020-09-22,Colorado,08,66552,616,2034,3,845111,6227,66053,654,779058,5573
2020-09-22,Connecticut,09,56160,136,4496,1,1479824,12058,56160,136,1423664,11922
2020-09-22,Delaware,10,19761,94,628,1,274837,1624,19761,94,255076,1530
2020-09-22,District of Columbia,11,15021,43,621,0,361633,3889,15021,43,346612,3846
2020-09-22,Florida,12,687901,2470,13415,99,5124209,19026,679776,2414,4444433,16612
2020-09-22,Georgia,13,290930,955,6524,69,2783427,12564,308221,882,2475206,11682
2020-09-22,Guam,66,3159,43,38,2,46828,474,2190,43,44638,431
2020-09-22,Hawaii,15,11653,63,119,0,282739,1162,11618,56,271121,1106
2020-09-22,Idaho,16,38676,480,452,5,294071,1785,37901,410,256170,1375
2020-09-22,Illinois,17,280511,1479,8741,24,5187414,41829,279464,1531,4907950,40298
2020-09-22,Indiana,18,114864,613,3520,8,1315440,6795,112626,599,1202814,6196
2020-09-22,Iowa,19,81674,668,1293,9,725082,3487,78887,548,646195,2939
2020-09-22,Kansas,20,55237,281,618,14,484691,0,53959,0,430732,0
2020-09-22,Kentucky,21,66624,719,1148,7,1075620,10216,62731,814,1012889,9402
2020-09-22,Louisiana,22,163253,752,5386,11,2206974,21182,163253,752,2043721,20430
2020-09-22,Maine,23,5146,40,140,0,375432,40,5146,40,370286,0
2020-09-22,Maryland,24,121409,341,3895,12,1544014,6385,120912,344,1423102,6041
2020-09-22,Massachusetts,25,127969,173,9328,11,2107281,9165,127969,173,1979312,8992
2020-09-22,Michigan,26,130406,751,6998,16,3390878,20211,130357,695,3260521,19516
2020-09-22,Minnesota,27,91474,480,2031,10,1317433,4496,91422,480,1226011,4016
2020-09-22,Mississippi,28,94021,465,2846,36,712501,5595,94021,465,618480,5130
2020-09-22,Missouri,29,118574,1760,1974,38,1241749,22190,115366,1059,1126383,21131
2020-09-22,Montana,30,10792,283,163,3,314009,2747,10700,271,303309,2476
2020-09-22,Nebraska,31,41828,440,473,9,428046,2230,41388,305,386658,1925
2020-09-22,Nevada,32,76376,257,1546,15,669074,2282,76298,262,592776,2020
2020-09-22,New Hampshire,33,7990,38,438,0,243527,1285,7990,38,235537,1247
2020-09-22,New Jersey,34,202371,426,16076,7,3397649,44466,200580,426,3197069,44040
2020-09-22,New Mexico,35,27790,107,854,3,872331,5648,27790,107,844541,5541
2020-09-22,New York,36,455938,751,32690,-1,10064762,83997,451227,754,9613535,83243
2020-09-22,North Carolina,37,196258,1165,3320,37,2824929,7390,195549,1168,2629380,6222
2020-09-22,North Dakota,38,18511,264,199,3,230035,559,18473,264,211562,295
2020-09-22,Northern Mariana Islands,69,69,0,2,0,14385,0,69,0,14316,0
2020-09-22,Ohio,39,145850,685,4635,12,2888787,32626,145850,685,2742937,31941
2020-09-22,Oklahoma,40,79072,1164,962,14,1101839,28234,79072,1164,1022767,27070
2020-09-22,Oregon,41,31323,324,535,3,642581,3783,31313,318,611268,3465
2020-09-22,Pennsylvania,42,156512,783,8099,19,1929562,11569,151646,834,1777916,10735
2020-09-22,Puerto Rico,72,42596,120,613,4,326371,88,20399,88,305972,0
2020-09-22,Rhode Island,44,24044,112,1099,2,322391,1825,24044,112,298347,1713
2020-09-22,South Carolina,45,140789,2665,3243,31,1172484,28366,140789,2665,1031695,25701
2020-09-22,South Dakota,46,19189,320,202,0,178346,1323,19189,320,159157,1003
2020-09-22,Tennessee,47,182546,821,2236,27,2691404,11998,185148,739,2506256,11259
2020-09-22,Texas,48,749069,4333,15322,110,6234103,55380,716207,17820,5517896,37560
2020-09-22,Utah,49,65058,654,443,2,762359,6269,65044,650,697315,5619
2020-09-22,Vermont,50,1721,2,58,0,155551,512,1724,2,153827,510
2020-09-22,Virgin Islands,78,1278,9,19,0,19464,152,1276,7,18188,145
2020-09-22,Virginia,51,142010,872,3060,39,1918489,13015,142010,872,1776479,12143
2020-09-22,Washington,53,87233,430,2163,26,1743167,3894,85461,196,1657706,3698
2020-09-22,West Virginia,54,14384,213,317,5,522669,3153,14384,213,508285,2940
2020-09-22,Wisconsin,55,110393,1737,1259,6,1458819,12604,110327,1739,1348492,10865
2020-09-22,Wyoming,56,5016,72,49,0,94840,709,5016,72,89824,637
2020-09-23,Alabama,01,147153,569,2488,31,1085604,5455,147153,569,938451,4886
2020-09-23,Alaska,02,7875,54,42,0,433198,2007,7063,76,426135,1931
2020-09-23,Arizona,04,215284,438,5526,25,1409866,9212,215284,438,1194582,8774
2020-09-23,Arkansas,05,77963,982,1229,20,909264,9058,77963,982,831301,8076
2020-09-23,California,06,798350,3273,15313,104,13879423,75368,787470,3146,13091953,72222
2020-09-23,Colorado,08,67186,634,2038,4,853592,8481,66669,616,786923,7865
2020-09-23,Connecticut,09,56315,155,4497,1,1489898,10074,56315,155,1433583,9919
2020-09-23,Delaware,10,19830,69,629,1,276044,1207,19830,69,256214,1138
2020-09-23,District of Columbia,11,15050,29,621,0,363448,1815,15050,29,348398,1786
2020-09-23,Florida,12,690491,2590,13617,202,5147851,23642,682370,2594,4465481,21048
2020-09-23,Georgia,13,292797,1867,6620,96,2803215,19788,309678,1457,2493537,18331
2020-09-23,Guam,66,3204,45,38,0,47251,423,2235,45,45016,378
2020-09-23,Hawaii,15,11820,167,121,2,284228,1489,11681,63,272547,1426
2020-09-23,Idaho,16,39030,354,454,2,295401,1330,38347,446,257054,884
2020-09-23,Illinois,17,282331,1820,8762,21,5233805,46391,281312,1848,4952493,44543
2020-09-23,Indiana,18,115578,714,3530,10,1322819,7379,113337,711,1209482,6668
2020-09-23,Iowa,19,82956,1282,1298,5,731853,6771,79923,1036,651930,5735
2020-09-23,Kansas,20,56355,1118,629,11,492281,7590,55226,1267,437055,6323
2020-09-23,Kentucky,21,67590,966,1161,13,1224142,148522,63517,786,1160625,147736
2020-09-23,Louisiana,22,163869,616,5407,21,2220009,13035,163869,616,2056140,12419
2020-09-23,Maine,23,5171,25,140,0,386035,10603,5171,25,380864,10578
2020-09-23,Maryland,24,121793,384,3902,7,1552105,8091,121297,385,1430808,7706
2020-09-23,Massachusetts,25,128512,543,9347,19,2127944,20663,128512,543,1999432,20120
2020-09-23,Michigan,26,131292,886,7013,15,3425107,34229,131259,902,3293848,33327
2020-09-23,Minnesota,27,92152,678,2037,6,1323951,6518,92100,678,1231851,5840
2020-09-23,Mississippi,28,94573,552,2870,24,716711,4210,94573,552,622138,3658
2020-09-23,Missouri,29,120124,1550,2035,61,1244563,2814,116946,1580,1127617,1234
2020-09-23,Montana,30,11034,242,165,2,317160,3151,10912,212,306248,2939
2020-09-23,Nebraska,31,42278,450,477,4,431102,3056,41785,397,389317,2659
2020-09-23,Nevada,32,76907,531,1556,10,671924,2850,76807,509,595117,2341
2020-09-23,New Hampshire,33,8007,17,438,0,244489,962,8007,17,236482,945
2020-09-23,New Jersey,34,202779,408,16082,6,3422747,25098,200988,408,3221759,24690
2020-09-23,New Mexico,35,27987,197,857,3,878406,6075,27987,197,850419,5878
2020-09-23,New York,36,456604,666,32691,1,10135692,70930,451892,665,9683800,70265
2020-09-23,North Carolina,37,197431,1173,3345,25,2842427,17498,196501,952,2645926,16546
2020-09-23,North Dakota,38,18984,473,206,7,231816,1781,18945,472,212871,1309
2020-09-23,Northern Mariana Islands,69,69,0,2,0,14845,460,69,0,14776,460
2020-09-23,Ohio,39,146753,903,4687,52,2931199,42412,146753,903,2784446,41509
2020-09-23,Oklahoma,40,80161,1089,970,8,1114326,12487,80161,1089,1034165,11398
2020-09-23,Oregon,41,31513,190,538,3,646125,3544,31503,190,614622,3354
2020-09-23,Pennsylvania,42,157373,861,8137,38,1942956,13394,152544,898,1790412,12496
2020-09-23,Puerto Rico,72,42660,64,617,4,326411,40,20439,40,305972,0
2020-09-23,Rhode Island,44,24177,133,1102,3,325120,2729,24177,133,300943,2596
2020-09-23,South Carolina,45,141686,897,3262,19,1190584,18100,141686,897,1048898,17203
2020-09-23,South Dakota,46,19634,445,202,0,180132,1786,19634,445,160498,1341
2020-09-23,Tennessee,47,184068,1522,2252,16,2713343,21939,186709,1561,2526634,20378
2020-09-23,Texas,48,753551,4482,15455,133,6287192,53089,719599,3392,5567593,49697
2020-09-23,Utah,49,65948,890,444,1,769910,7551,65921,877,703989,6674
2020-09-23,Vermont,50,1722,1,58,0,155914,363,1725,1,154189,362
2020-09-23,Virgin Islands,78,1290,12,19,0,19618,154,1278,2,18340,152
2020-09-23,Virginia,51,142590,580,3089,29,1929570,11081,142590,580,1786980,10501
2020-09-23,Washington,53,88042,809,2175,12,1743836,669,86130,669,1657706,0
2020-09-23,West Virginia,54,14504,120,319,2,525580,2911,14504,120,511076,2791
2020-09-23,Wisconsin,55,112276,1883,1269,10,1472405,13586,112222,1895,1360183,11691
2020-09-23,Wyoming,56,5169,153,50,1,94993,153,5169,153,89824,0
2020-09-24,Alabama,01,148206,1053,2506,18,1092953,7349,148206,1053,944747,6296
2020-09-24,Alaska,02,8015,140,43,1,433198,0,7194,131,426004,-131
2020-09-24,Arizona,04,215852,568,5560,34,1420417,10551,215852,568,1204565,9983
2020-09-24,Arkansas,05,79049,1086,1246,17,919786,10522,79049,1086,840737,9436
2020-09-24,California,06,801671,3321,15389,76,13952857,73434,790640,3170,13162217,70264
2020-09-24,Colorado,08,67745,559,2042,4,862805,9213,67217,548,795588,8665
2020-09-24,Connecticut,09,56472,157,4499,2,1505473,15575,56472,157,1449001,15418
2020-09-24,Delaware,10,19947,117,630,1,277916,1872,19947,117,257969,1755
2020-09-24,District of Columbia,11,15106,56,621,0,367867,4419,15106,56,352761,4363
2020-09-24,Florida,12,693032,2541,13794,177,5171306,23455,684847,2477,4486459,20978
2020-09-24,Georgia,13,294334,1537,6667,47,2824816,21601,311046,1368,2513770,20233
2020-09-24,Guam,66,3232,28,39,1,47687,436,2263,28,45424,408
2020-09-24,Hawaii,15,11908,88,123,2,286944,2716,11848,167,275096,2549
2020-09-24,Idaho,16,39547,517,458,4,297443,2042,38743,396,258700,1646
2020-09-24,Illinois,17,284620,2289,8793,31,5295876,62071,283569,2257,5012307,59814
2020-09-24,Indiana,18,116481,903,3548,18,1331608,8789,114236,899,1217372,7890
2020-09-24,Iowa,19,83993,1037,1303,5,738580,6727,81071,1148,657509,5579
2020-09-24,Kansas,20,56461,106,633,4,492281,0,55226,0,437055,0
2020-09-24,Kentucky,21,68230,640,1166,5,1233935,9793,64158,641,1169777,9152
2020-09-24,Louisiana,22,164446,577,5423,16,2237534,17525,164446,577,2073088,16948
2020-09-24,Maine,23,5215,44,140,0,399966,13931,5215,44,394751,13887
2020-09-24,Maryland,24,122293,500,3909,7,1561579,9474,121800,503,1439779,8971
2020-09-24,Massachusetts,25,128993,481,9362,15,2146526,18582,128993,481,2017533,18101
2020-09-24,Michigan,26,132400,1108,7020,7,3462824,37717,132337,1078,3330487,36639
2020-09-24,Minnesota,27,93064,912,2040,3,1336851,12900,93012,912,1243839,11988
2020-09-24,Mississippi,28,95310,737,2874,4,721759,5048,95310,737,626449,4311
2020-09-24,Missouri,29,121485,1361,2055,20,1259531,14968,118311,1365,1141220,13603
2020-09-24,Montana,30,11381,347,165,0,321518,4358,11242,330,310276,4028
2020-09-24,Nebraska,31,42731,453,478,1,434369,3267,42278,493,392091,2774
2020-09-24,Nevada,32,77338,431,1565,9,675488,3564,77197,390,598291,3174
2020-09-24,New Hampshire,33,8044,37,438,0,247151,2662,8044,37,239107,2625
2020-09-24,New Jersey,34,203343,564,16091,9,3451804,29057,201552,564,3250252,28493
2020-09-24,New Mexico,35,28224,237,859,2,885373,6967,28224,237,857149,6730
2020-09-24,New York,36,457557,953,32696,5,10228645,92953,452847,955,9775798,91998
2020-09-24,North Carolina,37,199236,1805,3380,35,2870191,27764,198189,1688,2672002,26076
2020-09-24,North Dakota,38,19454,470,215,9,233074,1258,19412,467,213662,791
2020-09-24,Northern Mariana Islands,69,69,0,2,0,14845,0,69,0,14776,0
2020-09-24,Ohio,39,147744,991,4715,28,2955715,24516,147744,991,2807971,23525
2020-09-24,Oklahoma,40,81244,1083,981,11,1126926,12600,81244,1083,1045682,11517
2020-09-24,Oregon,41,31869,356,540,2,650498,4373,31865,362,618633,4011
2020-09-24,Pennsylvania,42,158221,848,8150,13,1956867,13911,153397,853,1803470,13058
2020-09-24,Puerto Rico,72,43842,1182,627,10,327128,717,21156,717,305972,0
2020-09-24,Rhode Island,44,24311,134,1106,4,327583,2463,24311,134,303272,2329
2020-09-24,South Carolina,45,142707,1021,3279,17,1207106,16522,142707,1021,1064399,15501
2020-09-24,South Dakota,46,20097,463,210,8,181661,1529,20097,463,161564,1066
2020-09-24,Tennessee,47,185121,1053,2287,35,2729388,16045,187544,835,2541844,15210
2020-09-24,Texas,48,758379,4828,15587,132,6341954,54762,723919,4320,5618035,50442
2020-09-24,Utah,49,67167,1219,444,0,778412,8502,67119,1198,711293,7304
2020-09-24,Vermont,50,1724,2,58,0,156781,867,1727,2,155054,865
2020-09-24,Virgin Islands,78,1290,0,19,0,19824,206,1290,12,18534,194
2020-09-24,Virginia,51,143492,902,3113,24,1960009,30439,143492,902,1816517,29537
2020-09-24,Washington,53,88597,555,2175,0,1746323,2487,86729,599,1659594,1888
2020-09-24,West Virginia,54,14706,202,325,6,529025,3445,14706,202,514319,3243
2020-09-24,Wisconsin,55,114743,2467,1275,6,1485770,13365,114700,2478,1371070,10887
2020-09-24,Wyoming,56,5305,136,50,0,96640,1647,5305,136,91335,1511
2020-09-25,Alabama,01,150658,2452,2491,-15,1114022,21069,150658,2452,963364,18617
2020-09-25,Alaska,02,8133,118,48,5,441332,8134,7320,126,434012,8008
2020-09-25,Arizona,04,216367,515,5588,28,1428024,7607,216367,515,1211657,7092
2020-09-25,Arkansas,05,79946,897,1266,20,928768,8982,79946,897,848822,8085
2020-09-25,California,06,805733,4062,15533,144,14052247,99390,794040,3400,13258207,95990
2020-09-25,Colorado,08,68506,761,2045,3,872732,9927,67926,709,804806,9218
2020-09-25,Connecticut,09,56587,115,4501,2,1519151,13678,56587,115,1462564,13563
2020-09-25,Delaware,10,20085,138,631,1,279374,1458,20085,138,259289,1320
2020-09-25,District of Columbia,11,15163,57,623,2,373586,5719,15163,57,358423,5662
2020-09-25,Florida,12,695879,2847,13914,120,5197763,26457,687656,2809,4510107,23648
2020-09-25,Georgia,13,296089,1755,6717,50,2847494,22678,312514,1468,2534980,21210
2020-09-25,Guam,66,3255,23,40,1,48256,569,2286,23,45970,546
2020-09-25,Hawaii,15,12039,131,126,3,287034,90,11938,90,275096,0
2020-09-25,Idaho,16,40228,681,458,0,299882,2439,39234,491,260648,1948
2020-09-25,Illinois,17,287375,2755,8826,33,5365960,70084,286374,2805,5079586,67279
2020-09-25,Indiana,18,117656,1175,3566,18,1341462,9854,115407,1171,1226055,8683
2020-09-25,Iowa,19,85031,1038,1312,9,744981,6401,82045,974,662936,5427
2020-09-25,Kansas,20,57852,1391,634,1,502770,10489,56592,1366,446178,9123
2020-09-25,Kentucky,21,69150,920,1179,13,1252328,18393,65066,908,1187262,17485
2020-09-25,Louisiana,22,165152,706,5444,21,2256065,18531,165152,706,2090913,17825
2020-09-25,Maine,23,5235,20,140,0,406394,6428,5235,20,401159,6408
2020-09-25,Maryland,24,122850,557,3917,8,1572484,10905,122359,559,1450125,10346
2020-09-25,Massachusetts,25,129481,488,9373,11,2162414,15888,129481,488,2032933,15400
2020-09-25,Michigan,26,133443,1043,7028,8,3502312,39488,133377,1040,3368935,38448
2020-09-25,Minnesota,27,94241,1177,2046,6,1351156,14305,94189,1177,1256967,13128
2020-09-25,Mississippi,28,96032,722,2894,20,726386,4627,96032,722,630354,3905
2020-09-25,Missouri,29,123544,2059,2075,20,1273165,13634,120298,1987,1152867,11647
2020-09-25,Montana,30,11656,275,170,5,326116,4598,11564,322,314552,4276
2020-09-25,Nebraska,31,43162,431,483,5,437304,2935,42731,453,394573,2482
2020-09-25,Nevada,32,77930,592,1573,8,681336,5848,77753,556,603583,5292
2020-09-25,New Hampshire,33,8085,41,438,0,247151,0,8044,0,239107,0
2020-09-25,New Jersey,34,203891,548,16097,6,3478711,26907,202100,548,3276611,26359
2020-09-25,New Mexico,35,28487,263,865,6,893489,8116,28487,263,865002,7853
2020-09-25,New York,36,458466,909,32708,12,10323463,94818,453755,908,9869708,93910
2020-09-25,North Carolina,37,204658,5422,3427,47,2907617,37426,204331,6142,2703286,31284
2020-09-25,North Dakota,38,19888,434,222,7,234592,1518,19843,431,214749,1087
2020-09-25,Northern Mariana Islands,69,69,0,2,0,14845,0,69,0,14776,0
2020-09-25,Ohio,39,148894,1150,4734,19,2995593,39878,148894,1150,2846699,38728
2020-09-25,Oklahoma,40,82520,1276,993,12,1140664,13738,82520,1276,1058144,12462
2020-09-25,Oregon,41,32328,459,545,5,662906,12408,32314,449,630592,11959
2020-09-25,Pennsylvania,42,159051,830,8157,7,1970600,13733,154203,806,1816397,12927
2020-09-25,Puerto Rico,72,44905,1063,635,8,327840,712,21868,712,305972,0
2020-09-25,Rhode Island,44,24181,-130,1107,1,330034,2451,24181,-130,305853,2581
2020-09-25,South Carolina,45,143902,1195,3297,18,1226467,19361,143902,1195,1082565,18166
2020-09-25,South Dakota,46,20554,457,216,6,183947,2286,20554,457,163393,1829
2020-09-25,Tennessee,47,186769,1648,2326,39,2762845,33457,189454,1910,2573391,31547
2020-09-25,Texas,48,761644,3265,15637,50,6397755,55801,728552,4633,5669203,51168
2020-09-25,Utah,49,68537,1370,448,4,785727,7315,68530,1411,717197,5904
2020-09-25,Vermont,50,1731,7,58,0,157654,873,1734,7,155920,866
2020-09-25,Virgin Islands,78,1296,6,19,0,19972,148,1296,6,18676,142
2020-09-25,Virginia,51,144433,941,3136,23,1980649,20640,144433,941,1836216,19699
2020-09-25,Washington,53,89149,552,2193,18,1786365,40042,87324,595,1699041,39447
2020-09-25,West Virginia,54,14953,247,330,5,535394,6369,14953,247,520441,6122
2020-09-25,Wisconsin,55,117355,2612,1285,10,1500974,15204,117329,2629,1383645,12575
2020-09-25,Wyoming,56,5420,115,50,0,97826,1186,5420,115,92406,1071
2020-09-26,Alabama,01,151591,933,2501,10,1121639,7617,151591,933,970048,6684
2020-09-26,Alaska,02,8244,111,48,0,442869,1537,7439,119,435430,1418
2020-09-26,Arizona,04,216826,459,5623,35,1438677,10653,216826,459,1221851,10194
2020-09-26,Arkansas,05,80755,809,1285,19,936390,7622,80755,809,855635,6813
2020-09-26,California,06,809214,3481,15588,55,14182730,130483,798237,4197,13384493,126286
2020-09-26,Colorado,08,68973,467,2047,2,882842,10110,68510,584,814332,9526
2020-09-26,Connecticut,09,56587,0,4501,0,1519151,0,56587,0,1462564,0
2020-09-26,Delaware,10,20156,71,633,2,280399,1025,20156,71,260243,954
2020-09-26,District of Columbia,11,15215,52,624,1,377979,4393,15215,52,362764,4341
2020-09-26,Florida,12,698674,2795,14021,107,5226712,28949,690387,2731,4536325,26218
2020-09-26,Georgia,13,297553,1464,6758,41,2872355,24861,313873,1359,2558482,23502
2020-09-26,Guam,66,3255,0,40,0,48719,463,2354,68,46365,395
2020-09-26,Hawaii,15,12166,127,130,4,290146,3112,12070,132,278076,2980
2020-09-26,Idaho,16,40411,183,460,2,302177,2295,39757,523,262420,1772
2020-09-26,Illinois,17,289683,2308,8847,21,5431177,65217,288815,2441,5142362,62776
2020-09-26,Indiana,18,118819,1163,3577,11,1350390,8928,116549,1142,1233841,7786
2020-09-26,Iowa,19,85908,877,1314,2,750898,5917,82944,899,667954,5018
2020-09-26,Kansas,20,57852,0,634,0,502770,0,56592,0,446178,0
2020-09-26,Kentucky,21,70038,888,1185,6,1282596,30268,66036,970,1216560,29298
2020-09-26,Louisiana,22,165152,0,5444,0,2256065,0,165152,0,2090913,0
2020-09-26,Maine,23,5260,25,140,0,406419,25,5260,25,401159,0
2020-09-26,Maryland,24,123328,478,3925,8,1584300,11816,122972,613,1461328,11203
2020-09-26,Massachusetts,25,130050,569,9391,18,2176778,14364,130050,569,2046728,13795
2020-09-26,Michigan,26,134372,929,7044,16,3543057,40745,134373,996,3408684,39749
2020-09-26,Minnesota,27,95711,1470,2056,10,1368682,17526,95659,1470,1273023,16056
2020-09-26,Mississippi,28,96677,645,2911,17,730713,4327,96677,645,634036,3682
2020-09-26,Missouri,29,124939,1395,2118,43,1289169,16004,122014,1716,1167155,14288
2020-09-26,Montana,30,11943,287,171,1,329285,3169,11907,343,317378,2826
2020-09-26,Nebraska,31,43596,434,484,1,440645,3341,43162,431,397483,2910
2020-09-26,Nevada,32,78464,534,1583,10,685678,4342,78355,602,607323,3740
2020-09-26,New Hampshire,33,8121,36,439,1,265378,18227,8121,77,257257,18150
2020-09-26,New Jersey,34,204641,750,16103,6,3512568,33857,202850,750,3309718,33107
2020-09-26,New Mexico,35,28692,205,870,5,899937,6448,28692,205,871245,6243
2020-09-26,New York,36,459472,1006,32713,5,10423416,99953,454760,1005,9968656,98948
2020-09-26,North Carolina,37,206241,1583,3458,31,2947803,40186,206090,1759,2741713,38427
2020-09-26,North Dakota,38,20383,495,230,8,236189,1597,20340,497,215849,1100
2020-09-26,Northern Mariana Islands,69,69,0,2,0,14845,0,69,0,14776,0
2020-09-26,Ohio,39,150009,1115,4740,6,3033987,38394,150009,1115,2883978,37279
2020-09-26,Oklahoma,40,83510,990,1004,11,1158985,18321,83510,990,1075475,17331
2020-09-26,Oregon,41,32581,253,549,4,668671,5765,32581,267,636090,5498
2020-09-26,Pennsylvania,42,159937,886,8177,20,1985524,14924,155232,1029,1830292,13895
2020-09-26,Puerto Rico,72,45413,508,642,7,328136,296,22164,296,305972,0
2020-09-26,Rhode Island,44,24181,0,1107,0,333148,3114,24284,103,308864,3011
2020-09-26,South Carolina,45,145273,1371,3323,26,1242797,16330,145273,1371,1097524,14959
2020-09-26,South Dakota,46,21133,579,218,2,186134,2187,21133,579,165001,1608
2020-09-26,Tennessee,47,188205,1436,2347,21,2789879,27034,190891,1437,2598988,25597
2020-09-26,Texas,48,764642,2998,15792,155,6446270,48515,733438,4886,5712832,43629
2020-09-26,Utah,49,69556,1019,448,0,794487,8760,69547,1017,724940,7743
2020-09-26,Vermont,50,1739,8,58,0,158543,889,1744,10,156799,879
2020-09-26,Virgin Islands,78,1317,21,19,0,19972,0,1296,0,18676,0
2020-09-26,Virginia,51,145408,975,3144,8,2000579,19930,145408,975,1855171,18955
2020-09-26,Washington,53,89514,365,2196,3,1803707,17342,87912,588,1715795,16754
2020-09-26,West Virginia,54,15158,205,332,2,542291,6897,15158,205,527133,6692
2020-09-26,Wisconsin,55,120249,2894,1291,6,1513643,12669,120231,2902,1393412,9767
2020-09-26,Wyoming,56,5465,45,50,0,97871,45,5465,45,92406,0
2020-09-27,Alabama,01,152321,730,2502,1,1128006,6367,152321,730,975685,5637
2020-09-27,Alaska,02,8359,115,52,4,442869,0,7549,110,435320,-110
2020-09-27,Arizona,04,217237,411,5623,0,1447845,9168,217237,411,1230608,8757
2020-09-27,Arkansas,05,81242,487,1308,23,943134,6744,81242,487,861892,6257
2020-09-27,California,06,811698,2484,15608,20,14333498,150768,802308,4071,13531190,146697
2020-09-27,Colorado,08,69472,499,2048,1,893381,10539,69079,569,824302,9970
2020-09-27,Connecticut,09,56587,0,4501,0,1519151,0,56587,0,1462564,0
2020-09-27,Delaware,10,20260,104,633,0,282024,1625,20260,104,261764,1521
2020-09-27,District of Columbia,11,15250,35,624,0,381159,3180,15250,35,365909,3145
2020-09-27,Florida,12,700556,1882,14031,10,5245111,18399,692234,1847,4552877,16552
2020-09-27,Georgia,13,298321,768,6789,31,2886269,13914,314685,812,2571584,13102
2020-09-27,Guam,66,3255,0,40,0,48719,0,2354,0,46365,0
2020-09-27,Hawaii,15,12264,98,131,1,291836,1690,12197,127,279639,1563
2020-09-27,Idaho,16,40501,90,460,0,304781,2604,40296,539,264485,2065
2020-09-27,Illinois,17,291271,1588,8859,12,5481999,50822,290419,1604,5191580,49218
2020-09-27,Indiana,18,119721,902,3580,3,1358860,8470,117450,901,1241410,7569
2020-09-27,Iowa,19,86624,716,1316,2,754623,3725,83636,692,670987,3033
2020-09-27,Kansas,20,57978,126,636,2,502770,0,56592,0,446178,0
2020-09-27,Kentucky,21,70385,347,1189,4,1283051,455,66491,455,1216560,0
2020-09-27,Louisiana,22,166075,923,5465,21,2283149,27084,166075,923,2117074,26161
2020-09-27,Maine,23,5288,28,140,0,421196,14777,5288,28,415908,14749
2020-09-27,Maryland,24,123895,567,3935,10,1594363,10063,123403,431,1470960,9632
2020-09-27,Massachusetts,25,130642,592,9404,13,2194841,18063,130642,592,2064199,17471
2020-09-27,Michigan,26,134409,37,7044,0,3543057,0,134373,0,3408684,0
2020-09-27,Minnesota,27,96786,1075,2060,4,1384512,15830,96734,1075,1287778,14755
2020-09-27,Mississippi,28,96859,182,2919,8,730895,182,96859,182,634036,0
2020-09-27,Missouri,29,126115,1176,2117,-1,1298106,8937,123406,1392,1174700,7545
2020-09-27,Montana,30,12126,183,173,2,330307,1022,12107,200,318200,822
2020-09-27,Nebraska,31,44063,467,485,1,445129,4484,43596,434,401533,4050
2020-09-27,Nevada,32,78820,356,1585,2,688956,3278,78728,373,610228,2905
2020-09-27,New Hampshire,33,8172,51,439,0,267486,2108,8172,51,259314,2057
2020-09-27,New Jersey,34,205339,698,16106,3,3513266,698,203548,698,3309718,0
2020-09-27,New Mexico,35,28844,152,870,0,905329,5392,28844,152,876485,5240
2020-09-27,New York,36,460340,868,32722,9,10508186,84770,455626,866,10052560,83904
2020-09-27,North Carolina,37,207407,1166,3460,2,2978728,30925,207380,1290,2771348,29635
2020-09-27,North Dakota,38,20727,344,234,4,237575,1386,20681,341,216894,1045
2020-09-27,Northern Mariana Islands,69,69,0,2,0,14846,1,70,1,14776,0
2020-09-27,Ohio,39,150809,800,4741,1,3071187,37200,150809,800,2920378,36400
2020-09-27,Oklahoma,40,84333,823,1006,2,1158985,0,83510,0,1075475,0
2020-09-27,Oregon,41,32820,239,549,0,671490,2819,32820,239,638670,2580
2020-09-27,Pennsylvania,42,160770,833,8180,3,2001220,15696,156150,918,1845070,14778
2020-09-27,Puerto Rico,72,46304,891,644,2,328669,533,22697,533,305972,0
2020-09-27,Rhode Island,44,24181,0,1107,0,335120,1972,24398,114,310722,1858
2020-09-27,South Carolina,45,145887,614,3326,3,1252538,9741,145887,614,1106651,9127
2020-09-27,South Dakota,46,21541,408,218,0,187504,1370,21541,408,165963,962
2020-09-27,Tennessee,47,190037,1832,2350,3,2832536,42657,192995,2104,2639541,40553
2020-09-27,Texas,48,770539,5897,15831,39,6470128,23858,735132,1694,5734996,22164
2020-09-27,Utah,49,70616,1060,453,5,801308,6821,70615,1068,730693,5753
2020-09-27,Vermont,50,1742,3,58,0,159167,624,1746,2,157421,622
2020-09-27,Virgin Islands,78,1317,0,19,0,20160,188,1317,21,18843,167
2020-09-27,Virginia,51,146144,736,3159,15,2010539,9960,146144,736,1864395,9224
2020-09-27,Washington,53,89822,308,2196,0,1823226,19519,88433,521,1734793,18998
2020-09-27,West Virginia,54,15348,190,334,2,549723,7432,15348,190,534375,7242
2020-09-27,Wisconsin,55,122498,2249,1291,0,1521696,8053,122478,2247,1399218,5806
2020-09-27,Wyoming,56,5633,168,50,0,98039,168,5633,168,92406,0
2020-09-28,Alabama,01,152983,662,2501,-1,1133274,5268,152983,662,980291,4606
2020-09-28,Alaska,02,8477,118,52,0,444791,1922,7663,114,437128,1808
2020-09-28,Arizona,04,217513,276,5624,1,1453252,5407,217510,273,1235742,5134
2020-09-28,Arkansas,05,82049,807,1329,21,1000226,57092,82049,807,918177,56285
2020-09-28,California,06,814796,3098,15641,33,14484852,151354,805263,2955,13679589,148399
2020-09-28,Colorado,08,69967,495,2052,4,899874,6493,69490,411,830384,6082
2020-09-28,Connecticut,09,57147,560,4503,2,1571206,52055,57147,560,1514059,51495
2020-09-28,Delaware,10,20389,129,634,1,283815,1791,20389,129,263426,1662
2020-09-28,District of Columbia,11,15264,14,624,0,383048,1889,15264,14,367784,1875
2020-09-28,Florida,12,701294,738,14036,5,5253332,8221,692962,728,4560370,7493
2020-09-28,Georgia,13,298963,642,6803,14,2898498,12229,315281,596,2583217,11633
2020-09-28,Guam,66,3255,0,40,0,49211,492,2390,36,46821,456
2020-09-28,Hawaii,15,12351,87,131,0,293741,1905,12295,98,281446,1807
2020-09-28,Idaho,16,41386,885,460,0,306854,2073,40501,205,266353,1868
2020-09-28,Illinois,17,293169,1898,8877,18,5523141,41142,292128,1709,5231013,39433
2020-09-28,Indiana,18,120581,860,3591,11,1366294,7434,118322,872,1247972,6562
2020-09-28,Iowa,19,87256,632,1324,8,755316,693,84002,366,671314,327
2020-09-28,Kansas,20,59793,1815,641,5,513909,11139,58629,2037,455280,9102
2020-09-28,Kentucky,21,71003,618,1195,6,1301191,18140,66939,448,1234252,17692
2020-09-28,Louisiana,22,166315,240,5480,15,2289618,6469,166315,240,2123303,6229
2020-09-28,Maine,23,5300,12,140,0,423396,2200,5300,12,418096,2188
2020-09-28,Maryland,24,124371,476,3938,3,1603099,8736,123880,477,1479219,8259
2020-09-28,Massachusetts,25,131072,430,9415,11,2207953,13112,131072,430,2076881,12682
2020-09-28,Michigan,26,135782,1373,7052,8,3593990,50933,135702,1329,3458288,49604
2020-09-28,Minnesota,27,97690,904,2067,7,1397865,13353,97638,904,1300227,12449
2020-09-28,Mississippi,28,97049,190,2921,2,735892,4997,97049,190,638843,4807
2020-09-28,Missouri,29,127894,1779,2132,15,1302958,4852,124686,1280,1178272,3572
2020-09-28,Montana,30,12538,412,174,1,337196,6889,12413,306,324783,6583
2020-09-28,Nebraska,31,44578,515,487,2,448361,3232,44063,467,404298,2765
2020-09-28,Nevada,32,79313,493,1586,1,692673,3717,79191,463,613482,3254
2020-09-28,New Hampshire,33,8208,36,439,0,269367,1881,8208,36,261159,1845
2020-09-28,New Jersey,34,205898,559,16107,1,3566304,53038,204107,559,3362197,52479
2020-09-28,New Mexico,35,28985,141,873,3,909505,4176,28985,141,880520,4035
2020-09-28,New York,36,461176,836,32737,15,10561122,52936,456460,834,10104662,52102
2020-09-28,North Carolina,37,208497,1090,3469,9,3004533,25805,208248,868,2796285,24937
2020-09-28,North Dakota,38,20986,259,237,3,238694,1119,20940,259,217754,860
2020-09-28,Northern Mariana Islands,69,69,0,2,0,14846,0,70,0,14776,0
2020-09-28,Ohio,39,151802,993,4746,5,3106176,34989,151802,993,2954374,33996
2020-09-28,Oklahoma,40,85194,861,1007,1,1160669,1684,85194,1684,1075475,0
2020-09-28,Oregon,41,32995,175,549,0,675029,3539,32994,174,642035,3365
2020-09-28,Pennsylvania,42,161642,872,8181,1,2012317,11097,156826,676,1855491,10421
2020-09-28,Puerto Rico,72,47422,1118,648,4,329329,660,23357,660,305972,0
2020-09-28,Rhode Island,44,24424,243,1110,3,335684,564,24424,26,311260,538
2020-09-28,South Carolina,45,146455,568,3337,11,1273928,21390,146455,568,1127473,20822
2020-09-28,South Dakota,46,21738,197,218,0,188344,840,21738,197,166606,643
2020-09-28,Tennessee,47,190991,954,2362,12,2847342,14806,193732,737,2653610,14069
2020-09-28,Texas,48,773679,3140,15898,67,6486587,16459,739222,4090,5747365,12369
2020-09-28,Utah,49,71442,826,453,0,805996,4688,71442,827,734554,3861
2020-09-28,Vermont,50,1745,3,58,0,159999,832,1749,3,158250,829
2020-09-28,Virgin Islands,78,1318,1,20,1,20160,0,1317,0,18843,0
2020-09-28,Virginia,51,146593,449,3172,13,2034617,24078,146593,449,1888024,23629
2020-09-28,Washington,53,90596,774,2199,3,1839698,16472,88761,328,1750937,16144
2020-09-28,West Virginia,54,15512,164,337,3,553270,3547,15512,164,537758,3383
2020-09-28,Wisconsin,55,124320,1822,1293,2,1529594,7898,124217,1739,1405377,6159
2020-09-28,Wyoming,56,5754,121,50,0,100116,2077,5754,121,94362,1956
2020-09-29,Alabama,01,153554,571,2517,16,1136717,3443,153554,571,983163,2872
2020-09-29,Alaska,02,8602,125,52,0,451056,6265,7785,122,443271,6143
2020-09-29,Arizona,04,218185,672,5632,8,1458090,4838,218184,674,1239906,4164
2020-09-29,Arkansas,05,82755,706,1350,21,1010657,10431,82755,706,927902,9725
2020-09-29,California,06,817939,3143,15791,150,14613545,128693,807425,2162,13806120,126531
2020-09-29,Colorado,08,70458,491,2058,6,907152,7278,70025,535,837127,6743
2020-09-29,Connecticut,09,57329,182,4505,2,1581592,10386,57329,182,1524263,10204
2020-09-29,Delaware,10,20531,142,635,1,285488,1673,20531,142,264957,1531
2020-09-29,District of Columbia,11,15300,36,626,2,386396,3348,15300,36,371096,3312
2020-09-29,Florida,12,704560,3266,14142,106,5281719,28387,696171,3209,4585548,25178
2020-09-29,Georgia,13,300019,1056,6836,33,2910833,12335,316306,1025,2594527,11310
2020-09-29,Guam,66,3412,157,48,8,49727,516,2443,53,47284,463
2020-09-29,Hawaii,15,12436,85,133,2,296593,2852,12382,87,284211,2765
2020-09-29,Idaho,16,41854,468,466,6,308542,1688,40923,422,267619,1266
2020-09-29,Illinois,17,294673,1504,8901,24,5568765,45624,293490,1362,5275275,44262
2020-09-29,Indiana,18,121327,746,3612,21,1371355,5061,119066,744,1252289,4317
2020-09-29,Iowa,19,88234,978,1341,17,758388,3072,84476,474,673912,2598
2020-09-29,Kansas,20,59951,158,650,9,513909,0,58629,0,455280,0
2020-09-29,Kentucky,21,71921,918,1205,10,1371241,70050,67856,917,1303385,69133
2020-09-29,Louisiana,22,166848,533,5490,10,2307757,18139,166848,533,2140909,17606
2020-09-29,Maine,23,5337,37,141,1,428054,4658,5337,37,422717,4621
2020-09-29,Maryland,24,124805,434,3946,8,1610310,7211,124311,431,1485999,6780
2020-09-29,Massachusetts,25,131584,512,9423,8,2222139,14186,131584,512,2090555,13674
2020-09-29,Michigan,26,136899,1117,7073,21,3618084,24094,136820,1118,3481264,22976
2020-09-29,Minnesota,27,98499,809,2072,5,1406578,8713,98447,809,1308131,7904
2020-09-29,Mississippi,28,97638,589,2957,36,736481,589,97638,589,638843,0
2020-09-29,Missouri,29,128816,922,2148,16,1303034,76,124762,76,1178272,0
2020-09-29,Montana,30,12825,287,177,3,339926,2730,12724,311,327202,2419
2020-09-29,Nebraska,31,45044,466,493,6,452557,4196,44578,515,407979,3681
2020-09-29,Nevada,32,79691,378,1594,8,695720,3047,79595,404,616125,2643
2020-09-29,New Hampshire,33,8233,25,439,0,270204,837,8233,25,261971,812
2020-09-29,New Jersey,34,206354,456,16117,10,3566760,456,204563,456,3362197,0
2020-09-29,New Mexico,35,29157,172,875,2,914986,5481,29157,172,885829,5309
2020-09-29,New York,36,462364,1188,32743,6,10649353,88231,457649,1189,10191704,87042
2020-09-29,North Carolina,37,209384,887,3511,42,3019586,15053,209137,889,2810449,14164
2020-09-29,North Dakota,38,21404,418,242,5,239806,1112,21359,419,218447,693
2020-09-29,Northern Mariana Islands,69,69,0,2,0,14846,0,70,0,14776,0
2020-09-29,Ohio,39,152907,1105,4783,37,3141377,35201,152907,1105,2988470,34096
2020-09-29,Oklahoma,40,86219,1025,1018,11,1192403,31734,86219,1025,1106184,30709
2020-09-29,Oregon,41,33297,302,555,6,679383,4354,33291,297,646092,4057
2020-09-29,Pennsylvania,42,163219,1577,8196,15,2024575,12258,157814,988,1866761,11270
2020-09-29,Puerto Rico,72,48467,1045,654,6,329773,444,23801,444,305972,0
2020-09-29,Rhode Island,44,24556,132,1113,3,337898,2214,24556,132,313342,2082
2020-09-29,South Carolina,45,147634,1179,3359,22,1300414,26486,147634,1179,1152780,25307
2020-09-29,South Dakota,46,21997,259,223,5,189146,802,21997,259,167149,543
2020-09-29,Tennessee,47,191859,868,2393,31,2860481,13139,194611,879,2665870,12260
2020-09-29,Texas,48,780543,6864,15994,96,6544585,57998,743284,4062,5801301,53936
2020-09-29,Utah,49,72136,694,457,4,812209,6213,72136,694,740073,5519
2020-09-29,Vermont,50,1749,4,58,0,160754,755,1753,4,159001,751
2020-09-29,Virgin Islands,78,1318,0,20,0,20373,213,1318,1,19055,212
2020-09-29,Virginia,51,147516,923,3187,15,2047065,12448,147516,923,1899549,11525
2020-09-29,Washington,53,91011,415,2218,19,1850786,11088,88961,200,1761825,10888
2020-09-29,West Virginia,54,15692,180,345,8,558313,5043,15692,180,542621,4863
2020-09-29,Wisconsin,55,126744,2424,1312,19,1540438,10844,126664,2447,1413774,8397
2020-09-29,Wyoming,56,5821,67,50,0,100543,427,5821,67,94722,360
2020-09-30,Alabama,01,154701,1147,2540,23,1149176,12459,154701,1147,994475,11312
2020-09-30,Alaska,02,8707,105,52,0,457207,6151,7889,104,449318,6047
2020-09-30,Arizona,04,218511,326,5654,22,1462148,4058,218507,323,1243641,3735
2020-09-30,Arkansas,05,83697,942,1369,19,1032804,22147,83697,942,949107,21205
2020-09-30,California,06,821125,3186,15898,107,14705202,91657,810625,3200,13894577,88457
2020-09-30,Colorado,08,71090,632,2061,3,916384,9232,70536,511,845848,8721
2020-09-30,Connecticut,09,57550,221,4508,3,1593993,12401,57550,221,1536443,12180
2020-09-30,Delaware,10,20613,82,636,1,286562,1074,20613,82,265949,992
2020-09-30,District of Columbia,11,15326,26,627,1,387860,1464,15326,26,372534,1438
2020-09-30,Florida,12,706508,1948,14316,174,5292719,11000,698051,1880,4594668,9120
2020-09-30,Georgia,13,301485,1466,6861,25,2933679,22846,318026,1720,2615653,21126
2020-09-30,Guam,66,3457,45,50,2,50114,387,2488,45,47626,342
2020-09-30,Hawaii,15,12555,119,135,2,296680,87,12469,87,284211,0
2020-09-30,Idaho,16,42549,695,469,3,310441,1899,41434,511,269007,1388
2020-09-30,Illinois,17,296935,2262,8935,34,5627311,58546,295763,2273,5331548,56273
2020-09-30,Indiana,18,122295,968,3632,20,1379850,8495,120019,953,1259831,7542
2020-09-30,Iowa,19,89248,1014,1358,17,764867,6479,85596,1120,679271,5359
2020-09-30,Kansas,20,60957,1006,678,28,521450,7541,59749,1120,461701,6421
2020-09-30,Kentucky,21,72830,909,1208,3,1384609,13368,68840,984,1315769,12384
2020-09-30,Louisiana,22,167458,610,5511,21,2318604,10847,167458,610,2151146,10237
2020-09-30,Maine,23,5391,54,141,0,435100,7046,5391,54,429709,6992
2020-09-30,Maryland,24,125217,412,3949,3,1618007,7697,124725,414,1493282,7283
2020-09-30,Massachusetts,25,132116,532,9456,33,2236565,14426,132116,532,2104449,13894
2020-09-30,Michigan,26,138074,1175,7084,11,3647862,29778,138014,1194,3509848,28584
2020-09-30,Minnesota,27,99187,688,2089,17,1414701,8123,99134,687,1315567,7436
2020-09-30,Mississippi,28,98190,552,2969,12,737033,552,98190,552,638843,0
2020-09-30,Missouri,29,130065,1249,2157,9,1304385,1351,126113,1351,1178272,0
2020-09-30,Montana,30,13179,354,180,3,343158,3232,13071,347,330087,2885
2020-09-30,Nebraska,31,45564,520,493,0,455638,3081,45044,466,410594,2615
2020-09-30,Nevada,32,80084,393,1600,6,698096,2376,79980,385,618116,1991
2020-09-30,New Hampshire,33,8266,33,439,0,273713,3509,8266,33,265447,3476
2020-09-30,New Jersey,34,207062,708,16122,5,3613032,46272,205275,712,3407757,45560
2020-09-30,New Mexico,35,29435,278,877,2,921009,6023,29435,278,891574,5745
2020-09-30,New York,36,463369,1005,32757,14,10747313,97960,458649,1000,10288664,96960
2020-09-30,North Carolina,37,211004,1620,3565,54,3034871,15285,210632,1495,2824239,13790
2020-09-30,North Dakota,38,21849,445,250,8,241449,1643,21803,444,219646,1199
2020-09-30,Northern Mariana Islands,69,70,1,2,0,15182,336,70,0,15112,336
2020-09-30,Ohio,39,153987,1080,4804,21,3165935,24558,153987,1080,3011948,23478
2020-09-30,Oklahoma,40,87199,980,1031,13,1204028,11625,87199,980,1116829,10645
2020-09-30,Oregon,41,33554,257,560,5,685873,6490,33509,218,652364,6272
2020-09-30,Pennsylvania,42,164135,916,8216,20,2038094,13519,158967,1153,1879127,12366
2020-09-30,Puerto Rico,72,48755,288,661,7,329972,199,24000,199,305972,0
2020-09-30,Rhode Island,44,24748,192,1114,1,340601,2703,24748,192,315853,2511
2020-09-30,South Carolina,45,147942,308,3378,19,1309098,8684,147942,308,1161156,8376
2020-09-30,South Dakota,46,22389,392,223,0,190769,1623,22389,392,168380,1231
2020-09-30,Tennessee,47,193357,1498,2429,36,2884356,23875,196139,1528,2688217,22347
2020-09-30,Texas,48,784027,3484,16102,108,6598829,54244,748967,5683,5849862,48561
2020-09-30,Utah,49,73053,917,460,3,819987,7778,73042,906,746945,6872
2020-09-30,Vermont,50,1752,3,58,0,161360,606,1756,3,159604,603
2020-09-30,Virgin Islands,78,1318,0,20,0,20561,188,1318,0,19243,188
2020-09-30,Virginia,51,148271,755,3208,21,2057645,10580,148271,755,1909374,9825
2020-09-30,Washington,53,91560,549,2222,4,1857096,6310,89739,778,1767357,5532
2020-09-30,West Virginia,54,15848,156,350,5,561568,3255,15848,156,545720,3099
2020-09-30,Wisconsin,55,129172,2428,1338,26,1552370,11932,129123,2459,1423247,9473
2020-09-30,Wyoming,56,5948,127,50,0,101160,617,5948,127,95212,490
2020-10-01,Alabama,01,155744,1043,2548,8,1156314,7138,155744,1043,1000570,6095
2020-10-01,Alaska,02,8838,131,53,1,462323,5116,8026,137,454297,4979
2020-10-01,Arizona,04,219214,703,5674,20,1475972,13824,219212,705,1256760,13119
2020-10-01,Arkansas,05,84821,1124,1384,15,1045906,13102,84821,1124,961085,11978
2020-10-01,California,06,824306,3181,15989,91,14771851,66649,813687,3062,13958164,63587
2020-10-01,Colorado,08,71723,633,2064,3,927208,10824,71218,682,855990,10142
2020-10-01,Connecticut,09,57742,192,4511,3,1604380,10387,57742,192,1546638,10195
2020-10-01,Delaware,10,20787,174,636,0,288217,1655,20787,174,267430,1481
2020-10-01,District of Columbia,11,15358,32,628,1,390180,2320,15358,32,374822,2288
2020-10-01,Florida,12,709136,2628,14443,127,5317293,24574,700602,2551,4616691,22023
2020-10-01,Georgia,13,303010,1525,6903,42,2954392,20713,319334,1308,2635058,19405
2020-10-01,Guam,66,3519,62,50,0,50548,434,2550,62,47998,372
2020-10-01,Hawaii,15,12660,105,138,3,298642,1962,12589,120,286053,1842
2020-10-01,Idaho,16,42915,366,473,4,313018,2577,42048,614,270970,1963
2020-10-01,Illinois,17,299111,2176,8956,21,5692926,65615,297929,2166,5394997,63449
2020-10-01,Indiana,18,123459,1164,3645,13,1387731,7881,121176,1157,1266555,6724
2020-10-01,Iowa,19,90483,1235,1366,8,770943,6076,86634,1038,684309,5038
2020-10-01,Kansas,20,61103,146,678,0,521450,0,59749,0,461701,0
2020-10-01,Kentucky,21,73619,789,1225,17,1408615,24006,69728,888,1338887,23118
2020-10-01,Louisiana,22,168009,551,5519,8,2334745,16141,168009,551,2166736,15590
2020-10-01,Maine,23,5431,40,142,1,442391,7291,5431,40,436960,7251
2020-10-01,Maryland,24,125997,780,3949,0,1628200,10193,125510,785,1502690,9408
2020-10-01,Massachusetts,25,132870,754,9480,24,2254770,18205,132870,754,2121900,17451
2020-10-01,Michigan,26,139064,990,7103,19,3683581,35719,139012,998,3544569,34721
2020-10-01,Minnesota,27,100253,1066,2102,13,1429575,14874,100200,1066,1329375,13808
2020-10-01,Mississippi,28,98886,696,2979,10,737729,696,98886,696,638843,0
2020-10-01,Missouri,29,131778,1713,2184,27,1315418,11033,127912,1799,1187506,9234
2020-10-01,Montana,30,13626,447,181,1,348709,5551,13500,429,335209,5122
2020-10-01,Nebraska,31,46185,621,497,4,459542,3904,45564,520,413978,3384
2020-10-01,Nevada,32,80507,423,1603,3,701557,3461,80410,430,621147,3031
2020-10-01,New Hampshire,33,8317,51,441,2,275834,2121,8317,51,267517,2070
2020-10-01,New Jersey,34,207676,614,16127,5,3613646,614,205889,614,3407757,0
2020-10-01,New Mexico,35,29661,226,882,5,928389,7380,29661,226,898728,7154
2020-10-01,New York,36,464752,1383,32768,11,10856531,109218,460031,1382,10396500,107836
2020-10-01,North Carolina,37,213218,2214,3601,36,3063661,28790,212909,2277,2850752,26513
2020-10-01,North Dakota,38,22221,372,259,9,242852,1403,22170,367,220682,1036
2020-10-01,Northern Mariana Islands,69,70,0,2,0,15182,0,70,0,15112,0
2020-10-01,Ohio,39,155314,1327,4817,13,3240197,74262,155314,1327,3084883,72935
2020-10-01,Oklahoma,40,88369,1170,1035,4,1215441,11413,88369,1170,1127072,10243
2020-10-01,Oregon,41,33865,311,561,1,691945,6072,33862,353,658083,5719
2020-10-01,Pennsylvania,42,165078,943,8234,18,2049762,11668,160123,1156,1889639,10512
2020-10-01,Puerto Rico,72,49067,312,665,4,330148,176,24176,176,305972,0
2020-10-01,Rhode Island,44,24914,166,1117,3,343499,2898,24914,166,318585,2732
2020-10-01,South Carolina,45,148323,381,3400,22,1316454,7356,148323,381,1168131,6975
2020-10-01,South Dakota,46,23136,747,236,13,195003,4234,23136,747,171867,3487
2020-10-01,Tennessee,47,194601,1244,2473,44,2902732,18376,197432,1293,2705300,17083
2020-10-01,Texas,48,788066,4039,16220,118,6648792,49963,752501,3534,5896291,46429
2020-10-01,Utah,49,74099,1046,460,0,827136,7149,74050,1008,753086,6141
2020-10-01,Vermont,50,1755,3,58,0,162367,1007,1759,3,160608,1004
2020-10-01,Virgin Islands,78,1326,8,20,0,20771,210,1323,5,19448,205
2020-10-01,Virginia,51,148721,450,3228,20,2081967,24322,148721,450,1933246,23872
2020-10-01,Washington,53,92166,606,2227,5,1870939,13843,90372,633,1780567,13210
2020-10-01,West Virginia,54,16024,176,354,4,566588,5020,16024,176,550564,4844
2020-10-01,Wisconsin,55,132176,3004,1358,20,1566844,14474,132123,3000,1434721,11474
2020-10-01,Wyoming,56,6083,135,53,3,101295,135,6083,135,95212,0
2020-10-02,Alabama,01,156698,954,2550,2,1163310,6996,156698,954,1006612,6042
2020-10-02,Alaska,02,8964,126,53,0,469290,6967,8167,141,461123,6826
2020-10-02,Arizona,04,219778,564,5693,19,1483180,7208,219763,551,1263417,6657
2020-10-02,Arkansas,05,85779,958,1391,7,1057730,11824,85779,958,971951,10866
2020-10-02,California,06,828364,4058,16074,85,14868431,96580,817277,3590,14051154,92990
2020-10-02,Colorado,08,72454,731,2069,5,937921,10713,71898,680,866023,10033
2020-10-02,Connecticut,09,58297,555,4513,2,1676410,72030,58297,555,1618113,71475
2020-10-02,Delaware,10,20937,150,642,6,290283,2066,20937,150,269346,1916
2020-10-02,District of Columbia,11,15423,65,629,1,394118,3938,15423,65,378695,3873
2020-10-02,Florida,12,711796,2660,14553,110,5342929,25636,703212,2610,4639717,23026
2020-10-02,Georgia,13,304406,1396,6945,42,2970013,15621,320634,1300,2649379,14321
2020-10-02,Guam,66,3586,67,51,1,51118,570,2617,67,48501,503
2020-10-02,Hawaii,15,12754,94,141,3,300459,1817,12694,105,287765,1712
2020-10-02,Idaho,16,43528,613,478,5,315314,2296,42561,513,272753,1783
2020-10-02,Illinois,17,301540,2429,9007,51,5765867,72941,300385,2456,5465482,70485
2020-10-02,Indiana,18,124959,1500,3656,11,1398522,10791,122640,1464,1275882,9327
2020-10-02,Iowa,19,91483,1000,1377,11,775992,5049,87559,925,688433,4124
2020-10-02,Kansas,20,62424,1321,699,21,531117,9667,61111,1362,470006,8305
2020-10-02,Kentucky,21,74566,947,1232,7,1431600,22985,70727,999,1360873,21986
2020-10-02,Louisiana,22,168826,817,5545,26,2357449,22704,168826,817,2188623,21887
2020-10-02,Maine,23,5468,37,142,0,449290,6899,5468,37,443822,6862
2020-10-02,Maryland,24,126711,714,3950,1,1639785,11585,126222,712,1513563,10873
2020-10-02,Massachusetts,25,133631,761,9490,10,2276229,21459,133631,761,2142598,20698
2020-10-02,Michigan,26,140057,993,7110,7,3723748,40167,139996,984,3583752,39183
2020-10-02,Minnesota,27,101419,1166,2112,10,1447050,17475,101366,1166,1345684,16309
2020-10-02,Mississippi,28,99558,672,2999,20,738401,672,99558,672,638843,0
2020-10-02,Missouri,29,133725,1947,2207,23,1326189,10771,129397,1485,1196792,9286
2020-10-02,Montana,30,14044,418,186,5,353362,4653,13855,355,339507,4298
2020-10-02,Nebraska,31,46977,792,498,1,464264,4722,46185,621,418079,4101
2020-10-02,Nevada,32,81285,778,1611,8,706635,5078,81182,772,625453,4306
2020-10-02,New Hampshire,33,8534,217,442,1,277869,2035,8534,217,269335,1818
2020-10-02,New Jersey,34,208416,740,16131,4,3672127,58481,206629,740,3465498,57741
2020-10-02,New Mexico,35,30000,339,887,5,935401,7012,30000,339,905401,6673
2020-10-02,New York,36,466353,1601,32789,21,10976024,119493,461629,1598,10514395,117895
2020-10-02,North Carolina,37,215035,1817,3628,27,3099704,36043,214684,1775,2885020,34268
2020-10-02,North Dakota,38,22697,476,267,8,244259,1407,22641,471,221618,936
2020-10-02,Northern Mariana Islands,69,70,0,2,0,15185,3,73,3,15112,0
2020-10-02,Ohio,39,156809,1495,4905,88,3271748,31551,156809,1495,3114939,30056
2020-10-02,Oklahoma,40,89559,1190,1044,9,1230160,14719,89559,1190,1140601,13529
2020-10-02,Oregon,41,34180,315,566,5,697293,5348,34163,301,663130,5047
2020-10-02,Pennsylvania,42,166270,1192,8254,20,2066255,16493,161284,1161,1904971,15332
2020-10-02,Puerto Rico,72,49747,680,673,8,330477,329,24505,329,305972,0
2020-10-02,Rhode Island,44,25076,162,1118,1,345909,2410,25076,162,320833,2248
2020-10-02,South Carolina,45,149185,862,3409,9,1338052,21598,149185,862,1188867,20736
2020-10-02,South Dakota,46,23522,386,237,1,196261,1258,23522,386,172739,872
2020-10-02,Tennessee,47,195680,1079,2489,16,2919014,16282,198403,971,2720611,15311
2020-10-02,Texas,48,793962,5896,16307,87,6699098,50306,756004,3503,5943094,46803
2020-10-02,Utah,49,75175,1076,474,14,835124,7988,75157,1107,759967,6881
2020-10-02,Vermont,50,1768,13,58,0,163280,913,1773,14,161507,899
2020-10-02,Virgin Islands,78,1326,0,20,0,21011,240,1326,3,19685,237
2020-10-02,Virginia,51,149687,966,3250,22,2102198,20231,149687,966,1952511,19265
2020-10-02,Washington,53,92727,561,2239,12,1887578,16639,90990,618,1796588,16021
2020-10-02,West Virginia,54,16307,283,355,1,576499,9911,16307,283,560192,9628
2020-10-02,Wisconsin,55,134996,2820,1364,6,1580519,13675,134948,2825,1445571,10850
2020-10-02,Wyoming,56,6214,131,53,0,103278,1983,6214,131,97064,1852
2020-10-03,Alabama,01,158380,1682,2558,8,1174699,11389,158380,1682,1016319,9707
2020-10-03,Alaska,02,9111,147,54,1,473256,3966,8306,139,464950,3827
2020-10-03,Arizona,04,220403,625,5705,12,1492856,9676,220399,636,1272457,9040
2020-10-03,Arkansas,05,86525,746,1407,16,1068412,10682,86525,746,981887,9936
2020-10-03,California,06,831494,3130,16122,48,14998888,130457,819436,2159,14179452,128298
2020-10-03,Colorado,08,72929,475,2071,2,947395,9474,72555,657,874840,8817
2020-10-03,Connecticut,09,58297,0,4513,0,1676410,0,58297,0,1618113,0
2020-10-03,Delaware,10,21125,188,645,3,292458,2175,21125,188,271333,1987
2020-10-03,District of Columbia,11,15473,50,629,0,397549,3431,15473,50,382076,3381
2020-10-03,Florida,12,714583,2787,14627,74,5367833,24904,705965,2753,4661868,22151
2020-10-03,Georgia,13,305941,1535,6972,27,3001381,31368,322078,1444,2679303,29924
2020-10-03,Guam,66,3668,82,52,1,51756,638,2699,82,49057,556
2020-10-03,Hawaii,15,12887,133,152,11,302213,1754,12788,94,289425,1660
2020-10-03,Idaho,16,43702,174,480,2,318543,3229,43238,677,275305,2552
2020-10-03,Illinois,17,303807,2267,9033,26,5837501,71634,302827,2442,5534674,69192
2020-10-03,Indiana,18,126414,1455,3669,13,1408475,9953,124059,1419,1284416,8534
2020-10-03,Iowa,19,92302,819,1381,4,781309,5317,88470,911,692839,4406
2020-10-03,Kansas,20,62446,22,698,-1,531117,0,61111,0,470006,0
2020-10-03,Kentucky,21,75576,1010,1239,7,1443856,12256,72001,1274,1371855,10982
2020-10-03,Louisiana,22,168826,0,5545,0,2357449,0,168826,0,2188623,0
2020-10-03,Maine,23,5486,18,142,0,449308,18,5486,18,443822,0
2020-10-03,Maryland,24,127194,483,3957,7,1649725,9940,126819,597,1522906,9343
2020-10-03,Massachusetts,25,134303,672,9507,17,2290114,13885,134303,672,2155811,13213
2020-10-03,Michigan,26,141236,1179,7125,15,3764274,40526,141271,1275,3623003,39251
2020-10-03,Minnesota,27,102840,1421,2126,14,1462532,15482,102787,1421,1359745,14061
2020-10-03,Mississippi,28,100167,609,3011,12,739010,609,100167,609,638843,0
2020-10-03,Missouri,29,134826,1101,2220,13,1339556,13367,131105,1708,1208451,11659
2020-10-03,Montana,30,14490,446,186,0,354783,1421,14356,501,340427,920
2020-10-03,Nebraska,31,47403,426,503,5,469968,5704,46977,792,422991,4912
2020-10-03,Nevada,32,81829,544,1623,12,710210,3575,81708,526,628502,3049
2020-10-03,New Hampshire,33,8597,63,442,0,279564,1695,8597,63,270967,1632
2020-10-03,New Jersey,34,209363,947,16135,4,3673074,947,207576,947,3465498,0
2020-10-03,New Mexico,35,30296,296,890,3,941512,6111,30296,296,911216,5815
2020-10-03,New York,36,468081,1728,32794,5,11110291,134267,463360,1731,10646931,132536
2020-10-03,North Carolina,37,217049,2014,3647,19,3136266,36562,216886,2202,2919380,34360
2020-10-03,North Dakota,38,23137,440,274,7,245956,1697,23084,443,222872,1254
2020-10-03,Northern Mariana Islands,69,70,0,2,0,15185,0,73,0,15112,0
2020-10-03,Ohio,39,157966,1157,4925,20,3318775,47027,157966,1157,3160809,45870
2020-10-03,Oklahoma,40,90748,1189,1051,7,1247822,17662,90748,1189,1157074,16473
2020-10-03,Oregon,41,34512,332,572,6,701903,4610,34511,348,667392,4262
2020-10-03,Pennsylvania,42,166270,0,8271,17,2066255,0,161284,0,1904971,0
2020-10-03,Puerto Rico,72,50375,628,681,8,330776,299,24804,299,305972,0
2020-10-03,Rhode Island,44,25076,0,1118,0,348613,2704,25245,169,323368,2535
2020-10-03,South Carolina,45,150891,1706,3442,33,1339758,1706,150891,1706,1188867,0
2020-10-03,South Dakota,46,23986,464,248,11,198019,1758,23986,464,174033,1294
2020-10-03,Tennessee,47,196870,1190,2534,45,2936962,17948,199595,1192,2737367,16756
2020-10-03,Texas,48,799411,5449,16440,133,6755155,56057,763010,7006,5992145,49051
2020-10-03,Utah,49,76231,1056,476,2,842884,7760,76225,1068,766659,6692
2020-10-03,Vermont,50,1778,10,58,0,164142,862,1782,9,162360,853
2020-10-03,Virgin Islands,78,1327,1,20,0,21011,0,1326,0,19685,0
2020-10-03,Virginia,51,150803,1116,3270,20,2121758,19560,150803,1116,1970955,18444
2020-10-03,Washington,53,93160,433,2238,-1,1908519,20941,91570,580,1816949,20361
2020-10-03,West Virginia,54,16468,161,357,2,582705,6206,16468,161,566237,6045
2020-10-03,Wisconsin,55,138018,3022,1383,19,1594765,14246,138002,3054,1456763,11192
2020-10-03,Wyoming,56,6365,151,53,0,103429,151,6365,151,97064,0
2020-10-04,Alabama,01,159169,789,2558,0,1181242,6543,159169,789,1022073,5754
2020-10-04,Alaska,02,9300,189,54,0,476818,3562,8447,141,468371,3421
2020-10-04,Arizona,04,220757,354,5706,1,1500858,8002,220754,355,1280104,7647
2020-10-04,Arkansas,05,87013,488,1425,18,1076050,7638,87013,488,989037,7150
2020-10-04,California,06,834635,3141,16150,28,15160287,161399,823729,4293,14336558,157106
2020-10-04,Colorado,08,73389,460,2077,6,955819,8424,73076,521,882743,7903
2020-10-04,Connecticut,09,58297,0,4513,0,1676410,0,58297,0,1618113,0
2020-10-04,Delaware,10,21243,118,645,0,294089,1631,21243,118,272846,1513
2020-10-04,District of Columbia,11,15519,46,631,2,399825,2276,15519,46,384306,2230
2020-10-04,Florida,12,716451,1868,14670,43,5388166,20333,707751,1786,4680415,18547
2020-10-04,Georgia,13,306778,837,6999,27,3018618,17237,322925,847,2695693,16390
2020-10-04,Guam,66,3586,-82,53,1,51756,0,2699,0,49057,0
2020-10-04,Hawaii,15,12957,70,155,3,304149,1936,12921,133,291228,1803
2020-10-04,Idaho,16,43964,262,482,2,320578,2035,43702,464,276876,1571
2020-10-04,Illinois,17,305218,1411,9050,17,5889157,51656,304280,1453,5584877,50203
2020-10-04,Indiana,18,127501,1087,3674,5,1418063,9588,125146,1087,1292917,8501
2020-10-04,Iowa,19,92744,442,1387,6,785567,4258,89096,626,696471,3632
2020-10-04,Kansas,20,62479,33,698,0,531117,0,61111,0,470006,0
2020-10-04,Kentucky,21,76086,510,1242,3,1444472,616,72617,616,1371855,0
2020-10-04,Louisiana,22,169719,893,5577,32,2383670,26221,169719,893,2213951,25328
2020-10-04,Maine,23,5519,33,142,0,449341,33,5519,33,443822,0
2020-10-04,Maryland,24,127785,591,3958,1,1659847,10122,127290,471,1532557,9651
2020-10-04,Massachusetts,25,134947,644,9510,3,2309113,18999,134947,644,2174166,18355
2020-10-04,Michigan,26,141287,51,7125,0,3764274,0,141271,0,3623003,0
2020-10-04,Minnesota,27,103879,1039,2133,7,1480219,17687,103826,1039,1376393,16648
2020-10-04,Mississippi,28,100488,321,3013,2,739331,321,100488,321,638843,0
2020-10-04,Missouri,29,135691,865,2220,0,1350745,11189,132431,1326,1218314,9863
2020-10-04,Montana,30,14738,248,187,1,357413,2630,14635,279,342778,2351
2020-10-04,Nebraska,31,47807,404,504,1,473353,3385,47403,426,425950,2959
2020-10-04,Nevada,32,82134,305,1623,0,713389,3179,82100,392,631289,2787
2020-10-04,New Hampshire,33,8645,48,443,1,279612,48,8645,48,270967,0
2020-10-04,New Jersey,34,209989,626,16136,1,3734094,61020,208202,626,3525892,60394
2020-10-04,New Mexico,35,30477,181,892,2,947945,6433,30477,181,917468,6252
2020-10-04,New York,36,469307,1226,32813,19,11220620,110329,464582,1222,10756038,109107
2020-10-04,North Carolina,37,217641,592,3653,6,3160968,24702,217496,610,2943472,24092
2020-10-04,North Dakota,38,23553,416,277,3,247537,1581,23495,411,224042,1170
2020-10-04,Northern Mariana Islands,69,73,3,2,0,15185,0,73,0,15112,0
2020-10-04,Ohio,39,158907,941,4925,0,3356675,37900,158907,941,3197768,36959
2020-10-04,Oklahoma,40,91317,569,1052,1,1248391,569,91317,569,1157074,0
2020-10-04,Oregon,41,34771,259,573,1,705436,3533,34770,259,670666,3274
2020-10-04,Pennsylvania,42,168161,1891,8287,16,2095170,28915,163535,2251,1931635,26664
2020-10-04,Puerto Rico,72,50675,300,686,5,331006,230,25034,230,305972,0
2020-10-04,Rhode Island,44,25076,0,1118,0,350570,1957,25369,124,325201,1833
2020-10-04,South Carolina,45,151582,691,3453,11,1378086,38328,151582,691,1226504,37637
2020-10-04,South Dakota,46,24418,432,248,0,199775,1756,24418,432,175357,1324
2020-10-04,Tennessee,47,198262,1392,2550,16,2970388,33426,201210,1615,2769178,31811
2020-10-04,Texas,48,802440,3029,16471,31,6782763,27608,765894,2884,6016869,24724
2020-10-04,Utah,49,77618,1387,478,2,849830,6946,77618,1393,772212,5553
2020-10-04,Vermont,50,1785,7,58,0,164757,615,1788,6,162969,609
2020-10-04,Virgin Islands,78,1327,0,20,0,21239,228,1327,1,19912,227
2020-10-04,Virginia,51,151870,1067,3273,3,2122825,1067,151870,1067,1970955,0
2020-10-04,Washington,53,93527,367,2238,0,1925735,17216,92198,628,1833537,16588
2020-10-04,West Virginia,54,16628,160,358,1,590079,7374,16628,160,573451,7214
2020-10-04,Wisconsin,55,139941,1923,1388,5,1605641,10876,139928,1926,1465713,8950
2020-10-04,Wyoming,56,6504,139,53,0,103568,139,6504,139,97064,0
2020-10-05,Alabama,01,159713,544,2559,1,1186304,5062,159713,544,1026591,4518
2020-10-05,Alaska,02,9511,211,54,0,479374,2556,8643,196,470731,2360
2020-10-05,Arizona,04,221091,334,5707,1,1507610,6752,221070,316,1286540,6436
2020-10-05,Arkansas,05,87430,417,1447,22,1082876,6826,87430,417,995446,6409
2020-10-05,California,06,837720,3085,16179,29,15301681,141394,826784,3055,14474897,138339
2020-10-05,Colorado,08,74029,640,2085,8,962621,6802,73537,461,889084,6341
2020-10-05,Connecticut,09,59120,823,4517,4,1726721,50311,59120,823,1667601,49488
2020-10-05,Delaware,10,21363,120,645,0,295835,1746,21363,120,274472,1626
2020-10-05,District of Columbia,11,15547,28,631,0,401568,1743,15547,28,386021,1715
2020-10-05,Florida,12,717866,1415,14711,41,5403966,15800,709157,1406,4694809,14394
2020-10-05,Georgia,13,328127,21349,7028,29,3032757,14139,323714,789,2709043,13350
2020-10-05,Guam,66,3722,136,56,3,52365,609,2753,54,49612,555
2020-10-05,Hawaii,15,13007,50,156,1,306112,1963,12991,70,293121,1893
2020-10-05,Idaho,16,44832,868,487,5,322409,1831,43964,262,278445,1569
2020-10-05,Illinois,17,307428,2210,9071,21,5927695,38538,306133,1853,5621562,36685
2020-10-05,Indiana,18,128285,784,3681,7,1425175,7112,125976,830,1299199,6282
2020-10-05,Iowa,19,93261,517,1399,12,788014,2447,89460,364,698554,2083
2020-10-05,Kansas,20,63817,1338,706,8,541106,9989,62708,1597,478398,8392
2020-10-05,Kentucky,21,76787,701,1248,6,1463278,18806,73158,541,1390120,18265
2020-10-05,Louisiana,22,169937,218,5586,9,2391020,7350,169937,218,2221083,7132
2020-10-05,Maine,23,5545,26,142,0,466682,17341,5545,26,461137,17315
2020-10-05,Maryland,24,128277,492,3961,3,1668317,8470,127791,501,1540526,7969
2020-10-05,Massachusetts,25,135462,515,9530,20,2320428,11315,135462,515,2184966,10800
2020-10-05,Michigan,26,142757,1470,7141,16,3818827,54553,142726,1455,3676101,53098
2020-10-05,Minnesota,27,104852,973,2136,3,1494177,13958,104799,973,1389378,12985
2020-10-05,Mississippi,28,100703,215,3013,0,805358,66027,100703,215,704655,65812
2020-10-05,Missouri,29,137297,1606,2229,9,1358668,7923,133418,987,1225250,6936
2020-10-05,Montana,30,15127,389,190,3,369975,12562,14847,212,355128,12350
2020-10-05,Nebraska,31,48259,452,509,5,476952,3599,47807,404,429145,3195
2020-10-05,Nevada,32,82544,410,1624,1,716564,3175,82437,337,634127,2838
2020-10-05,New Hampshire,33,8680,35,444,1,281659,2047,8680,35,272979,2012
2020-10-05,New Jersey,34,210500,511,16138,2,3758058,23964,208713,511,3549345,23453
2020-10-05,New Mexico,35,30632,155,894,2,954596,6651,30632,155,923964,6496
2020-10-05,New York,36,470244,937,32827,14,11297024,76404,465515,933,10831509,75471
2020-10-05,North Carolina,37,220045,2404,3656,3,3193916,32948,219754,2258,2974162,30690
2020-10-05,North Dakota,38,23865,312,280,3,248596,1059,23806,311,224790,748
2020-10-05,Northern Mariana Islands,69,75,2,2,0,15196,11,75,2,15121,9
2020-10-05,Ohio,39,159964,1057,4931,6,3388186,31511,159964,1057,3228222,30454
2020-10-05,Oklahoma,40,91982,665,1055,3,1249056,665,91982,665,1157074,0
2020-10-05,Oregon,41,35056,285,574,1,709012,3576,35049,279,673963,3297
2020-10-05,Pennsylvania,42,169126,965,8300,13,2105159,9989,164207,672,1940952,9317
2020-10-05,Puerto Rico,72,51305,630,695,9,331369,363,25397,363,305972,0
2020-10-05,Rhode Island,44,25419,343,1121,3,351261,691,25419,50,325842,641
2020-10-05,South Carolina,45,152159,577,3456,3,1389106,11020,152159,577,1236947,10443
2020-10-05,South Dakota,46,24598,180,248,0,200443,668,24598,180,175845,488
2020-10-05,Tennessee,47,200603,2341,2570,20,3014664,44276,203699,2489,2810965,41787
2020-10-05,Texas,48,806535,4095,16519,48,6802887,20124,769303,3409,6033584,16715
2020-10-05,Utah,49,78733,1115,483,5,854412,4582,78723,1105,775689,3477
2020-10-05,Vermont,50,1817,32,58,0,165682,925,1821,33,163861,892
2020-10-05,Virgin Islands,78,1322,-5,20,0,21477,238,1322,-5,20155,243
2020-10-05,Virginia,51,152557,687,3276,3,2148109,25284,152557,687,1995552,24597
2020-10-05,Washington,53,94202,675,2253,15,1938626,12891,92601,403,1846025,12488
2020-10-05,West Virginia,54,16742,114,361,3,596531,6452,16742,114,579789,6338
2020-10-05,Wisconsin,55,141780,1839,1393,5,1614232,8591,141655,1727,1472577,6864
2020-10-05,Wyoming,56,6629,125,53,0,106162,2594,6629,125,99533,2469
2020-10-06,Alabama,01,160477,764,2580,21,1191770,5466,160477,764,1031293,4702
2020-10-06,Alaska,02,9656,145,54,0,479374,0,8790,147,470584,-147
2020-10-06,Arizona,04,221937,846,5713,6,1516207,8597,221934,864,1294273,7733
2020-10-06,Arkansas,05,88071,641,1469,22,1091512,8636,88071,641,1003441,7995
2020-10-06,California,06,840322,2602,16251,72,15430421,128740,828461,1677,14601960,127063
2020-10-06,Colorado,08,74535,506,2094,9,970591,7970,74191,654,896400,7316
2020-10-06,Connecticut,09,59241,121,4521,4,1744434,17713,59241,121,1685193,17592
2020-10-06,Delaware,10,21466,103,646,1,297513,1678,21466,103,276047,1575
2020-10-06,District of Columbia,11,15652,105,631,0,410029,8461,15652,105,394377,8356
2020-10-06,Florida,12,720117,2251,14766,55,5424811,20845,711358,2201,4713453,18644
2020-10-06,Georgia,13,329101,974,7062,34,3044792,12035,324650,936,2720142,11099
2020-10-06,Guam,66,3787,65,56,0,53012,647,2814,61,50198,586
2020-10-06,Hawaii,15,13090,83,159,3,307028,916,13041,50,293987,866
2020-10-06,Idaho,16,45487,655,494,7,324236,1827,44422,458,279814,1369
2020-10-06,Illinois,17,308990,1562,9100,29,5977208,49513,307750,1617,5669458,47896
2020-10-06,Indiana,18,129281,996,3711,30,1432219,7044,126946,970,1305273,6074
2020-10-06,Iowa,19,93909,648,1414,15,790843,2829,89934,474,700909,2355
2020-10-06,Kansas,20,64077,260,706,0,541106,0,62708,0,478398,0
2020-10-06,Kentucky,21,77741,954,1255,7,1475754,12476,74194,1036,1401560,11440
2020-10-06,Louisiana,22,170469,532,5592,6,2403780,12760,170469,532,2233311,12228
2020-10-06,Maine,23,5565,20,142,0,469220,2538,5565,20,463655,2518
2020-10-06,Maryland,24,128691,414,3967,6,1675227,6910,128204,413,1547023,6497
2020-10-06,Massachusetts,25,135957,495,9538,8,2333254,12826,135957,495,2197297,12331
2020-10-06,Michigan,26,143901,1144,7163,22,3844962,26135,143878,1152,3701084,24983
2020-10-06,Minnesota,27,105793,941,2140,4,1502736,8559,105740,941,1396996,7618
2020-10-06,Mississippi,28,101678,975,3027,14,805358,0,100703,0,704655,0
2020-10-06,Missouri,29,139172,1875,2258,29,1367139,8471,134583,1165,1232556,7306
2020-10-06,Montana,30,15633,506,192,2,372720,2745,15347,500,357373,2245
2020-10-06,Nebraska,31,48757,498,511,2,481013,4061,48259,452,432754,3609
2020-10-06,Nevada,32,83036,492,1630,6,718732,2168,82916,479,635816,1689
2020-10-06,New Hampshire,33,8731,51,446,2,283471,1812,8731,51,274740,1761
2020-10-06,New Jersey,34,211129,629,16147,9,3758687,629,209342,629,3549345,0
2020-10-06,New Mexico,35,30947,315,894,0,960934,6338,30947,315,929987,6023
2020-10-06,New York,36,471638,1394,32836,9,11393383,96359,466908,1393,10926475,94966
2020-10-06,North Carolina,37,221438,1393,3691,35,3216686,22770,221258,1504,2995428,21266
2020-10-06,North Dakota,38,24368,503,284,4,250031,1435,24308,502,225723,933
2020-10-06,Northern Mariana Islands,69,75,0,2,0,15196,0,75,0,15121,0
2020-10-06,Ohio,39,161299,1335,4947,16,3427972,39786,161299,1335,3266673,38451
2020-10-06,Oklahoma,40,93346,1364,1066,11,1280061,31005,93346,1364,1186715,29641
2020-10-06,Oregon,41,35347,291,581,7,713398,4386,35340,291,678058,4095
2020-10-06,Pennsylvania,42,170255,1129,8318,18,2117235,12076,165243,1036,1951992,11040
2020-10-06,Puerto Rico,72,51737,432,696,1,331607,238,25635,238,305972,0
2020-10-06,Rhode Island,44,25596,177,1125,4,354081,2820,25596,177,328485,2643
2020-10-06,South Carolina,45,152970,811,3471,15,1403136,14030,152970,811,1250166,13219
2020-10-06,South Dakota,46,24876,278,248,0,201477,1034,24876,278,176601,756
2020-10-06,Tennessee,47,202257,1654,2594,24,3040282,25618,205375,1676,2834907,23942
2020-10-06,Texas,48,811191,4656,16622,103,6872748,69861,773435,4132,6099313,65729
2020-10-06,Utah,49,79449,716,489,6,857060,2648,79439,716,777621,1932
2020-10-06,Vermont,50,1821,4,58,0,166167,485,1825,4,164342,481
2020-10-06,Virgin Islands,78,1321,-1,20,0,21477,0,1322,0,20155,0
2020-10-06,Virginia,51,153182,625,3291,15,2162363,14254,153182,625,2009181,13629
2020-10-06,Washington,53,94694,492,2261,8,1953984,15358,92853,252,1861131,15106
2020-10-06,West Virginia,54,16936,194,364,3,599553,3022,16936,194,582617,2828
2020-10-06,Wisconsin,55,143886,2106,1410,17,1625846,11614,143730,2075,1482116,9539
2020-10-06,Wyoming,56,6770,141,53,0,106682,520,6770,141,99912,379
2020-10-07,Alabama,01,161418,941,2601,21,1199944,8174,161418,941,1038526,7233
2020-10-07,Alaska,02,9784,128,55,1,490074,10700,8911,121,481163,10579
2020-10-07,Arizona,04,222558,621,5733,20,1523486,7279,222538,604,1300948,6675
2020-10-07,Arkansas,05,88880,809,1482,13,1101523,10011,88880,809,1012643,9202
2020-10-07,California,06,843732,3410,16358,107,15556706,126285,831225,2764,14725481,123521
2020-10-07,Colorado,08,75410,875,2097,3,980037,9446,74922,731,905115,8715
2020-10-07,Connecticut,09,59364,123,4522,1,1752045,7611,59364,123,1692681,7488
2020-10-07,Delaware,10,21550,84,649,3,299173,1660,21550,84,277623,1576
2020-10-07,District of Columbia,11,15697,45,632,1,412656,2627,15697,45,396959,2582
2020-10-07,Florida,12,722699,2582,14903,137,5450906,26095,713902,2544,4737004,23551
2020-10-07,Georgia,13,330769,1668,7089,27,3058187,13395,326142,1492,2732045,11903
2020-10-07,Guam,66,3837,50,58,2,53488,476,2868,54,50620,422
2020-10-07,Hawaii,15,13196,106,162,3,308277,1249,13124,83,295153,1166
2020-10-07,Idaho,16,46233,746,502,8,326191,1955,45082,660,281109,1295
2020-10-07,Illinois,17,311614,2624,9138,38,6036028,58820,310380,2630,5725648,56190
2020-10-07,Indiana,18,130569,1288,3727,16,1440917,8698,128227,1281,1312690,7417
2020-10-07,Iowa,19,95205,1296,1419,5,796057,5214,90884,950,705173,4264
2020-10-07,Kansas,20,65131,1054,725,19,549398,8292,63952,1244,485446,7048
2020-10-07,Kentucky,21,78669,928,1261,6,1491770,16016,76587,2393,1415183,13623
2020-10-07,Louisiana,22,172625,2156,5604,12,2427915,24135,172625,2156,2255290,21979
2020-10-07,Maine,23,5604,39,142,0,475749,6529,5604,39,470145,6490
2020-10-07,Maryland,24,129158,467,3973,6,1683904,8677,128664,460,1555240,8217
2020-10-07,Massachusetts,25,136492,535,9557,19,2349414,16160,136492,535,2212922,15625
2020-10-07,Michigan,26,145131,1230,7171,8,3879635,34673,145092,1214,3734543,33459
2020-10-07,Minnesota,27,106704,911,2154,14,1511141,8405,106651,911,1404490,7494
2020-10-07,Mississippi,28,102241,563,3051,24,806896,1538,102241,1538,704655,0
2020-10-07,Missouri,29,141262,2090,2334,76,1375015,7876,135651,1068,1239364,6808
2020-10-07,Montana,30,16194,561,193,1,376176,3456,16063,716,360113,2740
2020-10-07,Nebraska,31,49396,639,516,5,485994,4981,48757,498,437237,4483
2020-10-07,Nevada,32,83500,464,1639,9,720509,1777,83347,431,637162,1346
2020-10-07,New Hampshire,33,8800,69,448,2,285128,1657,8800,69,276328,1588
2020-10-07,New Jersey,34,211638,509,16152,5,3781810,23123,209850,508,3571960,22615
2020-10-07,New Mexico,35,31372,425,896,2,965319,4385,31372,425,933947,3960
2020-10-07,New York,36,472994,1356,32850,14,11501629,108246,468268,1360,11033361,106886
2020-10-07,North Carolina,37,223349,1911,3716,25,3235273,18587,222969,1711,3012304,16876
2020-10-07,North Dakota,38,24861,493,308,24,251614,1583,24798,490,226816,1093
2020-10-07,Northern Mariana Islands,69,75,0,2,0,15196,0,75,0,15121,0
2020-10-07,Ohio,39,162723,1424,4970,23,3458869,30897,162723,1424,3296146,29473
2020-10-07,Oklahoma,40,94352,1006,1075,9,1290623,10562,94352,1006,1196271,9556
2020-10-07,Oregon,41,35646,299,585,4,718568,5170,35634,294,682934,4876
2020-10-07,Pennsylvania,42,171550,1295,8347,29,2134094,16859,166552,1309,1967542,15550
2020-10-07,Puerto Rico,72,51768,31,705,9,331630,23,25658,23,305972,0
2020-10-07,Rhode Island,44,25776,180,1126,1,357350,3269,25776,180,331574,3089
2020-10-07,South Carolina,45,153705,735,3502,31,1410596,7460,153705,735,1256891,6725
2020-10-07,South Dakota,46,25906,1030,258,10,208780,7303,25906,1030,182874,6273
2020-10-07,Tennessee,47,204286,2029,2615,21,3062543,22261,207455,2080,2855088,20181
2020-10-07,Texas,48,817166,5975,16747,125,6941652,68904,777556,4121,6164096,64783
2020-10-07,Utah,49,80522,1073,499,10,862274,5214,80446,1007,781828,4207
2020-10-07,Vermont,50,1827,6,58,0,166732,565,1832,7,164900,558
2020-10-07,Virgin Islands,78,1322,1,20,0,21594,117,1321,-1,20273,118
2020-10-07,Virginia,51,153691,509,3303,12,2178542,16179,153691,509,2024851,15670
2020-10-07,Washington,53,95500,806,2274,13,1964163,10179,93759,906,1870404,9273
2020-10-07,West Virginia,54,17139,203,369,5,603345,3792,17139,203,586206,3589
2020-10-07,Wisconsin,55,146376,2490,1427,17,1639497,13651,146193,2463,1493304,11188
2020-10-07,Wyoming,56,6899,129,53,0,107845,1163,6899,129,100946,1034
2020-10-08,Alabama,01,161975,557,2637,36,1204021,4077,161975,557,1042046,3520
2020-10-08,Alaska,02,9919,135,56,1,491171,1097,9045,134,482126,963
2020-10-08,Arizona,04,223407,849,5743,10,1535900,12414,223401,863,1312499,11551
2020-10-08,Arkansas,05,90145,1265,1503,21,1115691,14168,90145,1265,1025546,12903
2020-10-08,California,06,847384,3652,16425,67,15623623,66917,834800,3575,14788823,63342
2020-10-08,Colorado,08,76186,776,2107,10,990222,10185,75785,863,914437,9322
2020-10-08,Connecticut,09,59748,384,4527,5,1779258,27213,59748,384,1719510,26829
2020-10-08,Delaware,10,21682,132,651,2,301502,2329,21682,132,279820,2197
2020-10-08,District of Columbia,11,15765,68,634,2,416816,4160,15765,68,401051,4092
2020-10-08,Florida,12,726005,3306,15067,164,5480893,29987,717148,3246,4763745,26741
2020-10-08,Georgia,13,332142,1373,7125,36,3083121,24934,327407,1265,2755714,23669
2020-10-08,Guam,66,3903,66,59,1,54071,583,2934,66,51137,517
2020-10-08,Hawaii,15,13297,101,163,1,308385,108,13232,108,295153,0
2020-10-08,Idaho,16,46848,615,504,2,328861,2670,45753,671,283108,1999
2020-10-08,Illinois,17,314725,3111,9173,35,6108519,72491,313439,3059,5795080,69432
2020-10-08,Indiana,18,132030,1461,3742,15,1451391,10474,129677,1450,1321714,9024
2020-10-08,Iowa,19,96749,1544,1433,14,803037,6980,92145,1261,710892,5719
2020-10-08,Kansas,20,65296,165,741,16,549398,0,63952,0,485446,0
2020-10-08,Kentucky,21,79550,881,1272,11,1511238,19468,77455,868,1433783,18600
2020-10-08,Louisiana,22,173149,524,5609,5,2440215,12300,173149,524,2267066,11776
2020-10-08,Maine,23,5639,35,142,0,482615,6866,5639,35,476976,6831
2020-10-08,Maryland,24,129919,761,3979,6,1696299,12395,129425,761,1566874,11634
2020-10-08,Massachusetts,25,136936,444,9565,8,2363484,14070,136936,444,2226548,13626
2020-10-08,Michigan,26,146548,1417,7194,23,3921840,42205,146493,1401,3775347,40804
2020-10-08,Minnesota,27,107975,1271,2160,6,1526559,15418,107922,1271,1418637,14147
2020-10-08,Mississippi,28,102819,578,3074,23,807474,578,102819,578,704655,0
2020-10-08,Missouri,29,142732,1470,2360,26,1387139,12124,137156,1505,1249983,10619
2020-10-08,Montana,30,16766,572,197,4,381665,5489,16677,614,364988,4875
2020-10-08,Nebraska,31,50059,663,518,2,490130,4136,49396,639,440734,3497
2020-10-08,Nevada,32,83971,471,1650,11,724198,3689,83827,480,640371,3209
2020-10-08,New Hampshire,33,8878,78,448,0,287628,2500,8878,78,278750,2422
2020-10-08,New Jersey,34,212936,1298,16161,9,3842667,60857,211148,1298,3631519,59559
2020-10-08,New Mexico,35,31756,384,899,3,973945,8626,31756,384,942189,8242
2020-10-08,New York,36,474829,1835,32859,9,11647440,145811,470104,1836,11177336,143975
2020-10-08,North Carolina,37,225738,2389,3744,28,3268955,33682,225397,2428,3043558,31254
2020-10-08,North Dakota,38,25388,527,314,6,253344,1730,25321,523,228023,1207
2020-10-08,Northern Mariana Islands,69,75,0,2,0,15196,0,75,0,15121,0
2020-10-08,Ohio,39,164262,1539,4983,13,3489730,30861,164262,1539,3325468,29322
2020-10-08,Oklahoma,40,95564,1212,1085,10,1304870,14247,95564,1212,1209306,13035
2020-10-08,Oregon,41,36121,475,596,11,724378,5810,36116,482,688262,5328
2020-10-08,Pennsylvania,42,172971,1421,8372,25,2153031,18937,167928,1376,1985103,17561
2020-10-08,Puerto Rico,72,52294,526,715,10,331982,352,26010,352,305972,0
2020-10-08,Rhode Island,44,26045,269,1127,1,364314,6964,26045,269,338269,6695
2020-10-08,South Carolina,45,154755,1050,3514,12,1430639,20043,154755,1050,1275884,18993
2020-10-08,South Dakota,46,26441,535,272,14,211261,2481,26411,505,184850,1976
2020-10-08,Tennessee,47,206265,1979,2676,61,3089853,27310,209447,1992,2880406,25318
2020-10-08,Texas,48,821732,4566,16853,106,7010194,68542,781794,4238,6228400,64304
2020-10-08,Utah,49,81975,1453,504,5,871780,9506,81947,1501,789833,8005
2020-10-08,Vermont,50,1838,11,58,0,167985,1253,1843,11,166142,1242
2020-10-08,Virgin Islands,78,1324,2,20,0,21688,94,1322,1,20366,93
2020-10-08,Virginia,51,155535,1844,3328,25,2198370,19828,155535,1844,2042835,17984
2020-10-08,Washington,53,96227,727,2280,6,1990751,26588,94482,723,1896269,25865
2020-10-08,West Virginia,54,17325,186,370,1,609660,6315,17325,186,592335,6129
2020-10-08,Wisconsin,55,149613,3237,1436,9,1656295,16798,149467,3274,1506828,13524
2020-10-08,Wyoming,56,7092,193,54,1,108942,1097,7092,193,101850,904
2020-10-09,Alabama,01,163465,1490,2653,16,1216017,11996,163465,1490,1052552,10506
2020-10-09,Alaska,02,10099,180,56,0,493070,1899,9232,187,483838,1712
2020-10-09,Arizona,04,224101,694,5746,3,1548282,12382,224084,683,1324198,11699
2020-10-09,Arkansas,05,91312,1167,1530,27,1115691,0,90145,0,1025546,0
2020-10-09,California,06,851228,3844,16502,77,15736497,112874,838606,3806,14897891,109068
2020-10-09,Colorado,08,77068,882,2115,8,1001087,10865,76619,834,924468,10031
2020-10-09,Connecticut,09,60038,290,4530,3,1796539,17281,60038,290,1736501,16991
2020-10-09,Delaware,10,21827,145,651,0,304367,2865,21827,145,282540,2720
2020-10-09,District of Columbia,11,15843,78,634,0,422225,5409,15843,78,406382,5331
2020-10-09,Florida,12,728913,2908,15185,118,5509242,28349,720001,2853,4789241,25496
2020-10-09,Georgia,13,333934,1792,7178,53,3112629,29508,329032,1625,2783597,27883
2020-10-09,Guam,66,3958,55,59,0,54495,424,2989,55,51506,369
2020-10-09,Hawaii,15,13461,164,165,2,308486,101,13333,101,295153,0
2020-10-09,Idaho,16,47674,826,506,2,331475,2614,46426,673,285049,1941
2020-10-09,Illinois,17,317501,2776,9207,34,6180417,71898,316556,3117,5863861,68781
2020-10-09,Indiana,18,133864,1834,3761,19,1463436,12045,131493,1816,1331943,10229
2020-10-09,Iowa,19,98023,1274,1454,21,808801,5764,93187,1042,715614,4722
2020-10-09,Kansas,20,67086,1790,765,24,560189,10791,65807,1855,494382,8936
2020-10-09,Kentucky,21,80633,1083,1283,11,1536085,24847,78456,1001,1457629,23846
2020-10-09,Louisiana,22,173406,257,5635,26,2450087,9872,173406,257,2276681,9615
2020-10-09,Maine,23,5666,27,143,1,491052,8437,5666,27,485386,8410
2020-10-09,Maryland,24,130652,733,3990,11,1707367,11068,130159,734,1577208,10334
2020-10-09,Massachusetts,25,137701,765,9577,12,2383082,19598,137701,765,2245381,18833
2020-10-09,Michigan,26,147880,1332,7202,8,3965016,43176,147816,1323,3817200,41853
2020-10-09,Minnesota,27,109365,1390,2174,14,1543542,16983,109312,1390,1434230,15593
2020-10-09,Mississippi,28,103681,862,3080,6,808336,862,103681,862,704655,0
2020-10-09,Missouri,29,145034,2302,2463,103,1399619,12480,139164,2008,1260455,10472
2020-10-09,Montana,30,17478,712,206,9,386746,5081,17399,722,369347,4359
2020-10-09,Nebraska,31,50168,109,522,4,494467,4337,50059,663,444408,3674
2020-10-09,Nevada,32,84785,814,1658,8,730234,6036,84593,766,645641,5270
2020-10-09,New Hampshire,33,8970,92,450,2,287628,0,8878,0,278750,0
2020-10-09,New Jersey,34,213801,865,16164,3,3878988,36321,212013,865,3666975,35456
2020-10-09,New Mexico,35,32241,485,902,3,980053,6108,32241,485,947812,5623
2020-10-09,New York,36,476422,1593,32867,8,11786740,139300,471696,1592,11315044,137708
2020-10-09,North Carolina,37,227756,2018,3768,24,3311285,42330,227431,2034,3083854,40296
2020-10-09,North Dakota,38,26044,656,325,11,255121,1777,25965,644,229156,1133
2020-10-09,Northern Mariana Islands,69,75,0,2,0,15196,0,75,0,15121,0
2020-10-09,Ohio,39,166102,1840,4994,11,3537962,48232,166102,1840,3371860,46392
2020-10-09,Oklahoma,40,97088,1524,1091,6,1321971,17101,97088,1524,1224883,15577
2020-10-09,Oregon,41,36538,417,600,4,730671,6293,36526,410,694145,5883
2020-10-09,Pennsylvania,42,174352,1381,8387,15,2169073,16042,169308,1380,1999765,14662
2020-10-09,Puerto Rico,72,52892,598,720,5,332298,316,26326,316,305972,0
2020-10-09,Rhode Island,44,26294,249,1130,3,368061,3747,26294,249,341767,3498
2020-10-09,South Carolina,45,155676,921,3530,16,1452568,21929,155676,921,1296892,21008
2020-10-09,South Dakota,46,27215,774,277,5,214153,2892,27215,804,186938,2088
2020-10-09,Tennessee,47,207823,1558,2702,26,3116772,26919,211003,1556,2905769,25363
2020-10-09,Texas,48,826241,4509,16955,102,7075406,65212,785830,4036,6289576,61176
2020-10-09,Utah,49,83307,1332,508,4,880169,8389,83290,1343,796879,7046
2020-10-09,Vermont,50,1846,8,58,0,168961,976,1851,8,167110,968
2020-10-09,Virgin Islands,78,1324,0,20,0,21758,70,1324,2,20434,68
2020-10-09,Virginia,51,156649,1114,3344,16,2228231,29861,156649,1114,2071582,28747
2020-10-09,Washington,53,96837,610,2288,8,2019758,29007,95205,723,1924553,28284
2020-10-09,West Virginia,54,17707,382,376,6,617623,7963,17707,382,599916,7581
2020-10-09,Wisconsin,55,152831,3218,1453,17,1671293,14998,152631,3164,1518662,11834
2020-10-09,Wyoming,56,7335,243,54,0,110511,1569,7335,243,103176,1326
2020-10-10,Alabama,01,164526,1061,2664,11,1223945,7928,164526,1061,1059419,6867
2020-10-10,Alaska,02,10350,251,56,0,499253,6183,9462,230,489791,5953
2020-10-10,Arizona,04,224985,884,5759,13,1560907,12625,224978,894,1335929,11731
2020-10-10,Arkansas,05,92220,908,1552,22,1142188,26497,92220,2075,1049968,24422
2020-10-10,California,06,854302,3074,16568,66,15878445,141948,842776,4170,15035669,137778
2020-10-10,Colorado,08,78047,979,2121,6,1012173,11086,77642,1023,934531,10063
2020-10-10,Connecticut,09,60038,0,4530,0,1796539,0,60038,0,1736501,0
2020-10-10,Delaware,10,21998,171,653,2,307645,3278,21998,171,285647,3107
2020-10-10,District of Columbia,11,15918,75,636,2,429099,6874,15918,75,413181,6799
2020-10-10,Florida,12,728913,0,15185,0,5509242,0,720001,0,4789241,0
2020-10-10,Georgia,13,335351,1417,7223,45,3132559,19930,330269,1237,2802290,18693
2020-10-10,Guam,66,4025,67,60,1,54816,321,3056,67,51760,254
2020-10-10,Hawaii,15,13532,71,167,2,308651,165,13498,165,295153,0
2020-10-10,Idaho,16,47927,253,508,2,335790,4315,47088,662,288702,3653
2020-10-10,Illinois,17,320283,2782,9235,28,6246673,66256,319461,2905,5927212,63351
2020-10-10,Indiana,18,135789,1925,3782,21,1474639,11203,133411,1918,1341228,9285
2020-10-10,Iowa,19,99099,1076,1460,6,814078,5277,94271,1084,719807,4193
2020-10-10,Kansas,20,67193,107,768,3,560189,0,65807,0,494382,0
2020-10-10,Kentucky,21,81630,997,1293,10,1547178,11093,79445,989,1467733,10104
2020-10-10,Louisiana,22,173406,0,5635,0,2450087,0,173406,0,2276681,0
2020-10-10,Maine,23,5696,30,143,0,491082,30,5696,30,485386,0
2020-10-10,Maryland,24,131169,517,3995,5,1719802,12435,130795,636,1589007,11799
2020-10-10,Massachusetts,25,138340,639,9587,10,2398294,15212,138340,639,2259954,14573
2020-10-10,Michigan,26,149406,1526,7221,19,4010309,45293,149464,1648,3860845,43645
2020-10-10,Minnesota,27,110881,1516,2184,10,1561103,17561,110828,1516,1450275,16045
2020-10-10,Mississippi,28,104638,957,3096,16,809293,957,104638,957,704655,0
2020-10-10,Missouri,29,148199,3165,2483,20,1447667,48048,144230,5066,1303437,42982
2020-10-10,Montana,30,18118,640,209,3,388649,1903,18117,718,370532,1185
2020-10-10,Nebraska,31,51887,1719,525,3,504432,9965,51144,1085,453288,8880
2020-10-10,Nevada,32,85463,678,1659,1,734943,4709,85399,806,649544,3903
2020-10-10,New Hampshire,33,9092,122,455,5,292451,4823,9092,214,283359,4609
2020-10-10,New Jersey,34,214665,864,16171,7,3914021,35033,212877,864,3701144,34169
2020-10-10,New Mexico,35,32722,481,907,5,989652,9599,32722,481,956930,9118
2020-10-10,New York,36,477870,1448,32875,8,11921319,134579,473143,1447,11448176,133132
2020-10-10,North Carolina,37,229959,2203,3786,18,3350815,39530,229752,2321,3121063,37209
2020-10-10,North Dakota,38,26632,588,340,15,257121,2000,26563,598,230558,1402
2020-10-10,Northern Mariana Islands,69,77,2,2,0,15198,2,77,2,15121,0
2020-10-10,Ohio,39,167458,1356,4997,3,3583857,45895,167458,1356,3416399,44539
2020-10-10,Oklahoma,40,98621,1533,1095,4,1339139,17168,98621,1533,1240518,15635
2020-10-10,Oregon,41,36925,387,600,0,736598,5927,36935,409,699663,5518
2020-10-10,Pennsylvania,42,175804,1452,8421,34,2190490,21417,171050,1742,2019440,19675
2020-10-10,Puerto Rico,72,53364,472,728,8,332530,232,26558,232,305972,0
2020-10-10,Rhode Island,44,26294,0,1130,0,373851,5790,26580,286,347271,5504
2020-10-10,South Carolina,45,156621,945,3551,21,1470311,17743,156621,945,1313690,16798
2020-10-10,South Dakota,46,27947,732,286,9,216485,2332,27947,732,188538,1600
2020-10-10,Tennessee,47,209593,1770,2729,27,3141232,24460,212649,1646,2928583,22814
2020-10-10,Texas,48,829758,3517,17019,64,7136901,61495,790060,4230,6346841,57265
2020-10-10,Utah,49,84697,1390,512,4,890719,10550,84644,1354,806075,9196
2020-10-10,Vermont,50,1857,11,58,0,169612,651,1861,10,167751,641
2020-10-10,Virgin Islands,78,1325,1,20,0,21758,0,1324,0,20434,0
2020-10-10,Virginia,51,157905,1256,3354,10,2247176,18945,157905,1256,2089271,17689
2020-10-10,Washington,53,97223,386,2289,1,2041317,21559,95931,726,1945386,20833
2020-10-10,West Virginia,54,17913,206,381,5,628006,10383,17913,206,610093,10177
2020-10-10,Wisconsin,55,155752,2921,1470,17,1685908,14615,155602,2971,1530306,11644
2020-10-10,Wyoming,56,7455,120,54,0,110631,120,7455,120,103176,0
2020-10-11,Alabama,01,165342,816,2664,0,1229759,5814,165342,816,1064417,4998
2020-10-11,Alaska,02,10608,258,56,0,502997,3744,9712,250,493285,3494
2020-10-11,Arizona,04,225575,590,5759,0,1571069,10162,225575,597,1345494,9565
2020-10-11,Arkansas,05,92833,613,1569,17,1151185,8997,92833,613,1058352,8384
2020-10-11,California,06,857076,2774,16581,13,16047004,168559,846579,3803,15200425,164756
2020-10-11,Colorado,08,78752,705,2134,13,1022564,10391,78461,819,944103,9572
2020-10-11,Connecticut,09,60038,0,4530,0,1796539,0,60038,0,1736501,0
2020-10-11,Delaware,10,22130,132,654,1,310570,2925,22130,132,288440,2793
2020-10-11,District of Columbia,11,15984,66,637,1,436167,7068,15984,66,420183,7002
2020-10-11,Florida,12,734483,5570,15363,178,5541455,32213,725415,5414,4816040,26799
2020-10-11,Georgia,13,336586,1235,7246,23,3151039,18480,331409,1140,2819630,17340
2020-10-11,Guam,66,4047,22,61,1,54971,155,3078,22,51893,133
2020-10-11,Hawaii,15,13633,101,168,1,308722,71,13569,71,295153,0
2020-10-11,Idaho,16,48155,228,508,0,338770,2980,47701,613,291069,2367
2020-10-11,Illinois,17,322985,2702,9245,10,6310720,64047,322188,2727,5988532,61320
2020-10-11,Indiana,18,137359,1570,3789,7,1486182,11543,134981,1570,1351201,9973
2020-10-11,Iowa,19,99941,842,1462,2,819460,5382,95346,1075,724114,4307
2020-10-11,Kansas,20,67231,38,769,1,560189,0,65807,0,494382,0
2020-10-11,Kentucky,21,82358,728,1295,2,1548025,847,80292,847,1467733,0
2020-10-11,Louisiana,22,174587,1181,5655,20,2488868,38781,174587,1181,2314281,37600
2020-10-11,Maine,23,5723,27,143,0,491109,27,5723,27,485386,0
2020-10-11,Maryland,24,131853,684,3999,4,1731844,12042,131357,562,1600487,11480
2020-10-11,Massachusetts,25,138903,563,9604,17,2414084,15790,138903,563,2275181,15227
2020-10-11,Michigan,26,149448,42,7221,0,4010309,0,149464,0,3860845,0
2020-10-11,Minnesota,27,112321,1440,2194,10,1578724,17621,112268,1440,1466456,16181
2020-10-11,Mississippi,28,104932,294,3101,5,809587,294,104932,294,704655,0
2020-10-11,Missouri,29,148481,282,2483,0,1447667,0,144230,0,1303437,0
2020-10-11,Montana,30,18733,615,210,1,390258,1609,18702,585,371556,1024
2020-10-11,Nebraska,31,52382,495,525,0,508921,4489,51887,743,457034,3746
2020-10-11,Nevada,32,85922,459,1663,4,738304,3361,85779,380,652525,2981
2020-10-11,New Hampshire,33,9143,51,456,1,292451,0,9092,0,283359,0
2020-10-11,New Jersey,34,215416,751,16174,3,3914772,751,213628,751,3701144,0
2020-10-11,New Mexico,35,32983,261,911,4,997373,7721,32983,261,964390,7460
2020-10-11,New York,36,479013,1143,32879,4,12039573,118254,474286,1143,11565287,117111
2020-10-11,North Carolina,37,231564,1605,3791,5,3388250,37435,231471,1719,3156779,35716
2020-10-11,North Dakota,38,27269,637,343,3,258971,1850,27200,637,231771,1213
2020-10-11,Northern Mariana Islands,69,77,0,2,0,15198,0,77,0,15121,0
2020-10-11,Ohio,39,168749,1291,4999,2,3623321,39464,168749,1291,3454572,38173
2020-10-11,Oklahoma,40,99387,766,1098,3,1339905,766,99387,766,1240518,0
2020-10-11,Oregon,41,37263,338,600,0,741233,4635,37262,327,703971,4308
2020-10-11,Pennsylvania,42,176820,1016,8426,5,2205861,15371,172216,1166,2033645,14205
2020-10-11,Puerto Rico,72,53671,307,730,2,332748,218,26776,218,305972,0
2020-10-11,Rhode Island,44,26294,0,1130,0,377850,3999,26750,170,351100,3829
2020-10-11,South Carolina,45,157406,785,3552,1,1484658,14347,157406,785,1327252,13562
2020-10-11,South Dakota,46,28564,617,286,0,218111,1626,28564,617,189547,1009
2020-10-11,Tennessee,47,211426,1833,2738,9,3172361,31129,214717,2068,2957644,29061
2020-10-11,Texas,48,832750,2992,17047,28,7170740,33839,792478,2418,6378262,31421
2020-10-11,Utah,49,85844,1147,518,6,896766,6047,85844,1200,810922,4847
2020-10-11,Vermont,50,1868,11,58,0,171216,1604,1871,10,169345,1594
2020-10-11,Virgin Islands,78,1325,0,20,0,21945,187,1325,1,20620,186
2020-10-11,Virginia,51,158716,811,3358,4,2265905,18729,158716,811,2107189,17918
2020-10-11,Washington,53,97527,304,2289,0,2065035,23718,96632,701,1968403,23017
2020-10-11,West Virginia,54,18128,215,382,1,633942,5936,18128,215,615814,5721
2020-10-11,Wisconsin,55,158426,2674,1477,7,1696192,10284,158315,2713,1537877,7571
2020-10-11,Wyoming,56,7611,156,54,0,110787,156,7611,156,103176,0
2020-10-12,Alabama,01,166076,734,2665,1,1234463,4704,166076,734,1068387,3970
2020-10-12,Alaska,02,10805,197,56,0,505927,2930,9903,191,496024,2739
2020-10-12,Arizona,04,226072,497,5759,0,1579111,8042,226050,475,1353061,7567
2020-10-12,Arkansas,05,93487,654,1586,17,1159683,8498,93487,654,1066196,7844
2020-10-12,California,06,859959,2883,16594,13,16191341,144337,850028,3449,15341313,140888
2020-10-12,Colorado,08,79499,747,2144,10,1028709,6145,79037,576,949672,5569
2020-10-12,Connecticut,09,61377,1339,4532,2,1896944,100405,61377,1339,1835567,99066
2020-10-12,Delaware,10,22289,159,656,2,314281,3711,22289,159,291992,3552
2020-10-12,District of Columbia,11,16022,38,637,0,438819,2652,16022,38,422797,2614
2020-10-12,Florida,12,736016,1533,15411,48,5558193,16738,726934,1519,4831259,15219
2020-10-12,Georgia,13,339577,2991,7259,13,3168126,17087,332311,902,2835815,16185
2020-10-12,Guam,66,4139,92,61,0,55690,719,3170,92,52520,627
2020-10-12,Hawaii,15,13675,42,168,0,308823,101,13670,101,295153,0
2020-10-12,Idaho,16,48663,508,511,3,340623,1853,48066,365,292557,1488
2020-10-12,Illinois,17,325755,2770,9258,13,6358299,47579,324930,2742,6033369,44837
2020-10-12,Indiana,18,138933,1574,3795,6,1495852,9670,136555,1574,1359297,8096
2020-10-12,Iowa,19,100451,510,1481,19,822140,2680,95809,463,726331,2217
2020-10-12,Kansas,20,69158,1927,774,5,572081,11892,67862,2055,504219,9837
2020-10-12,Kentucky,21,83074,716,1300,5,1576416,28391,80930,638,1495486,27753
2020-10-12,Louisiana,22,174647,60,5669,14,2492265,3397,174647,60,2317618,3337
2020-10-12,Maine,23,5752,29,143,0,491138,29,5752,29,485386,0
2020-10-12,Maryland,24,132357,504,4003,4,1742435,10591,131861,504,1610574,10087
2020-10-12,Massachusetts,25,139663,760,9617,13,2432880,18796,139663,760,2293217,18036
2020-10-12,Michigan,26,151284,1836,7227,6,4061097,50788,151396,1932,3909701,48856
2020-10-12,Minnesota,27,113492,1171,2197,3,1589752,11028,113439,1171,1476313,9857
2020-10-12,Mississippi,28,105228,296,3101,0,809883,296,105228,296,704655,0
2020-10-12,Missouri,29,149460,979,2484,1,1447667,0,144230,0,1303437,0
2020-10-12,Montana,30,19205,472,212,2,400458,10200,19125,423,381333,9777
2020-10-12,Nebraska,31,52839,457,529,4,511938,3017,52382,495,459556,2522
2020-10-12,Nevada,32,86433,511,1670,7,741168,2864,86348,569,654820,2295
2020-10-12,New Hampshire,33,9208,65,456,0,293576,1125,9143,51,284433,1074
2020-10-12,New Jersey,34,215885,469,16175,1,3971597,56825,214097,469,3757500,56356
2020-10-12,New Mexico,35,33362,379,915,4,1002906,5533,33362,379,969544,5154
2020-10-12,New York,36,480045,1032,32896,17,12131366,91793,475315,1029,11656051,90764
2020-10-12,North Carolina,37,233059,1495,3799,8,3417814,29564,232747,1276,3185067,28288
2020-10-12,North Dakota,38,27742,473,350,7,260275,1304,27673,473,232602,831
2020-10-12,Northern Mariana Islands,69,77,0,2,0,15198,0,77,0,15121,0
2020-10-12,Ohio,39,170179,1430,5005,6,3661924,38603,170179,1430,3491745,37173
2020-10-12,Oklahoma,40,100184,797,1104,6,1340702,797,100184,797,1240518,0
2020-10-12,Oregon,41,37472,209,600,0,745255,4022,37467,205,707788,3817
2020-10-12,Pennsylvania,42,177844,1024,8444,18,2218010,12149,173304,1088,2044706,11061
2020-10-12,Puerto Rico,72,54234,563,735,5,332976,228,27004,228,305972,0
2020-10-12,Rhode Island,44,26294,0,1130,0,379100,1250,26831,81,352269,1169
2020-10-12,South Carolina,45,158055,649,3559,7,1497817,13159,158055,649,1339762,12510
2020-10-12,South Dakota,46,28925,361,288,2,219244,1133,28925,361,190319,772
2020-10-12,Tennessee,47,214245,2819,2745,7,3211720,39359,217682,2965,2994038,36394
2020-10-12,Texas,48,836807,4057,17073,26,7191773,21033,795126,2648,6396647,18385
2020-10-12,Utah,49,86879,1035,524,6,900997,4231,86832,988,814165,3243
2020-10-12,Vermont,50,1876,8,58,0,172069,853,1880,9,170189,844
2020-10-12,Virgin Islands,78,1325,0,20,0,21945,0,1325,0,20620,0
2020-10-12,Virginia,51,159570,854,3361,3,2281091,15186,159570,854,2121521,14332
2020-10-12,Washington,53,98265,738,2292,3,2065418,383,97015,383,1968403,0
2020-10-12,West Virginia,54,18281,153,385,3,639434,5492,18281,153,621153,5339
2020-10-12,Wisconsin,55,160655,2229,1488,11,1706023,9831,160331,2016,1545692,7815
2020-10-12,Wyoming,56,7802,191,54,0,110978,191,7802,191,103176,0
2020-10-13,Alabama,01,167193,1117,2665,0,1241317,6854,167193,1117,1074124,5737
2020-10-13,Alaska,02,10960,155,56,0,514789,8862,10059,156,504730,8706
2020-10-13,Arizona,04,226749,677,5767,8,1586081,6970,226734,684,1359347,6286
2020-10-13,Arkansas,05,94167,680,1611,25,1167481,7798,94167,680,1073314,7118
2020-10-13,California,06,863614,3655,16650,56,16333717,142376,852406,2378,15481311,139998
2020-10-13,Colorado,08,80414,915,2181,37,1037975,9266,80085,1048,957890,8218
2020-10-13,Connecticut,09,61697,320,4533,1,1910348,13404,61697,320,1848651,13084
2020-10-13,Delaware,10,22394,105,659,3,315752,1471,22394,105,293358,1366
2020-10-13,District of Columbia,11,16068,46,637,0,443081,4262,16068,46,427013,4216
2020-10-13,Florida,12,738741,2725,15530,119,5584266,26073,729591,2657,4854675,23416
2020-10-13,Georgia,13,340758,1181,7282,23,3180548,12422,333304,993,2847244,11429
2020-10-13,Guam,66,4235,96,62,1,56368,678,3266,96,53102,582
2020-10-13,Hawaii,15,13736,61,172,4,308865,42,13712,42,295153,0
2020-10-13,Idaho,16,49987,1324,514,3,343003,2380,48663,597,294340,1783
2020-10-13,Illinois,17,329160,3405,9288,30,6414292,55993,327781,2851,6086511,53142
2020-10-13,Indiana,18,140505,1572,3822,27,1503923,8071,138104,1549,1365819,6522
2020-10-13,Iowa,19,101531,1080,1491,10,824869,2729,96338,529,728531,2200
2020-10-13,Kansas,20,69392,234,786,12,572081,0,67862,0,504219,0
2020-10-13,Kentucky,21,83967,893,1318,18,1602616,26200,81691,761,1520925,25439
2020-10-13,Louisiana,22,175329,682,5679,10,2512847,20582,175329,682,2337518,19900
2020-10-13,Maine,23,5780,28,143,0,514278,23140,5780,28,508498,23112
2020-10-13,Maryland,24,132839,482,4012,9,1751309,8874,132343,482,1618966,8392
2020-10-13,Massachusetts,25,140412,749,9630,13,2446741,13861,140412,749,2306329,13112
2020-10-13,Michigan,26,152842,1558,7257,30,4099559,38462,152862,1466,3946697,36996
2020-10-13,Minnesota,27,114627,1135,2204,7,1600861,11109,114574,1135,1486287,9974
2020-10-13,Mississippi,28,105941,713,3115,14,810596,713,105941,713,704655,0
2020-10-13,Missouri,29,150496,1036,2495,11,1447667,0,144230,0,1303437,0
2020-10-13,Montana,30,19682,477,217,5,409651,9193,19611,486,390040,8707
2020-10-13,Nebraska,31,53543,704,533,4,515493,3555,52839,457,462654,3098
2020-10-13,Nevada,32,86970,537,1677,7,743677,2509,86835,487,656842,2022
2020-10-13,New Hampshire,33,9279,71,456,0,297850,4274,9279,136,288571,4138
2020-10-13,New Jersey,34,216873,988,16182,7,3972585,988,215085,988,3757500,0
2020-10-13,New Mexico,35,33713,351,918,3,1011320,8414,33713,351,977607,8063
2020-10-13,New York,36,481436,1391,32905,9,12230436,99070,476708,1393,11753728,97677
2020-10-13,North Carolina,37,234842,1783,3849,50,3444583,26769,234481,1734,3210102,25035
2020-10-13,North Dakota,38,28250,508,362,12,261663,1388,28163,490,233500,898
2020-10-13,Northern Mariana Islands,69,77,0,2,0,15198,0,77,0,15121,0
2020-10-13,Ohio,39,171626,1447,5017,12,3698741,36817,171626,1447,3527115,35370
2020-10-13,Oklahoma,40,101493,1309,1119,15,1373716,33014,101493,1309,1272223,31705
2020-10-13,Oregon,41,37788,316,605,5,751277,6022,37780,313,713497,5709
2020-10-13,Pennsylvania,42,179673,1829,8458,14,2234739,16729,174646,1342,2060093,15387
2020-10-13,Puerto Rico,72,54540,306,738,3,333111,135,27139,135,305972,0
2020-10-13,Rhode Island,44,26960,666,1139,9,380694,1594,26960,129,353734,1465
2020-10-13,South Carolina,45,158883,828,3576,17,1511481,13664,158883,828,1352598,12836
2020-10-13,South Dakota,46,29339,414,288,0,220402,1158,29339,414,191063,744
2020-10-13,Tennessee,47,215423,1178,2768,23,3225624,13904,218829,1147,3006795,12757
2020-10-13,Texas,48,842316,5509,17165,92,7266042,74269,800256,5130,6465786,69139
2020-10-13,Utah,49,87825,946,524,0,909124,8127,87819,987,821305,7140
2020-10-13,Vermont,50,1886,10,58,0,172773,704,1891,11,170882,693
2020-10-13,Virgin Islands,78,1328,3,20,0,22062,117,1325,0,20737,117
2020-10-13,Virginia,51,160805,1235,3372,11,2302010,20919,160805,1235,2141205,19684
2020-10-13,Washington,53,99311,1046,2311,19,2126401,60983,97268,253,2029133,60730
2020-10-13,West Virginia,54,18555,274,387,2,644666,5232,18555,274,626111,4958
2020-10-13,Wisconsin,55,164137,3482,1521,33,1720713,14690,163759,3428,1556954,11262
2020-10-13,Wyoming,56,7964,162,57,3,113843,2865,7964,162,105879,2703
2020-10-14,Alabama,01,167977,784,2706,41,1246453,5136,167977,784,1078476,4352
2020-10-14,Alaska,02,11103,143,60,4,517177,2388,10214,155,506963,2233
2020-10-14,Arizona,04,227660,911,5772,5,1594245,8164,227635,901,1366610,7263
2020-10-14,Arkansas,05,95246,1079,1634,23,1178353,10872,95246,1079,1083107,9793
2020-10-14,California,06,867094,3480,16752,102,16425487,91770,855072,2666,15570415,89104
2020-10-14,Colorado,08,81205,791,2186,5,1045267,7292,80777,692,964490,6600
2020-10-14,Connecticut,09,61861,164,4537,4,1918724,8376,61861,164,1856863,8212
2020-10-14,Delaware,10,22465,71,660,1,316823,1071,22465,71,294358,1000
2020-10-14,District of Columbia,11,16132,64,638,1,448262,5181,16132,64,432130,5117
2020-10-14,Florida,12,741624,2883,15594,64,5606014,21748,732399,2808,4873615,18940
2020-10-14,Georgia,13,342302,1544,7298,16,3204308,23760,334601,1297,2869707,22463
2020-10-14,Guam,66,4310,75,62,0,56894,526,3341,75,53553,451
2020-10-14,Hawaii,15,13834,98,182,10,308926,61,13773,61,295153,0
2020-10-14,Idaho,16,50534,547,520,6,345863,2860,49247,584,296616,2276
2020-10-14,Illinois,17,332124,2964,9335,47,6466961,52669,330643,2862,6136318,49807
2020-10-14,Indiana,18,141670,1165,3836,14,1511060,7137,139269,1165,1371791,5972
2020-10-14,Iowa,19,102905,1374,1505,14,829253,4384,97384,1046,731869,3338
2020-10-14,Kansas,20,70665,1273,838,52,579827,7746,69155,1293,510672,6453
2020-10-14,Kentucky,21,85278,1311,1325,7,1613841,11225,83013,1322,1530828,9903
2020-10-14,Louisiana,22,176209,880,5695,16,2519723,6876,176209,880,2343514,5996
2020-10-14,Maine,23,5816,36,143,0,520402,6124,5816,36,514586,6088
2020-10-14,Maryland,24,133413,574,4022,10,1760654,9345,132918,575,1627736,8770
2020-10-14,Massachusetts,25,140992,580,9647,17,2459860,13119,140992,580,2318868,12539
2020-10-14,Michigan,26,154409,1567,7270,13,4129412,29853,154455,1593,3974957,28260
2020-10-14,Minnesota,27,115996,1369,2233,29,1613411,12550,115943,1369,1497468,11181
2020-10-14,Mississippi,28,106817,876,3140,25,811472,876,106817,876,704655,0
2020-10-14,Missouri,29,154213,3717,2598,103,1352161,-95506,148679,4449,1203482,-99955
2020-10-14,Montana,30,20321,639,225,8,414579,4928,20210,599,394369,4329
2020-10-14,Nebraska,31,54467,924,536,3,519411,3918,53543,704,465868,3214
2020-10-14,Nevada,32,87527,557,1694,17,747418,3741,87314,479,660104,3262
2020-10-14,New Hampshire,33,9349,70,458,2,301619,3769,9349,70,292270,3699
2020-10-14,New Jersey,34,217812,939,16191,9,4036867,64282,216023,938,3820844,63344
2020-10-14,New Mexico,35,34290,577,921,3,1019029,7709,34290,577,984739,7132
2020-10-14,New York,36,482671,1235,32916,11,12342180,111744,477940,1232,11864240,110512
2020-10-14,North Carolina,37,236812,1970,3882,33,3467235,22652,236407,1926,3230828,20726
2020-10-14,North Dakota,38,28952,702,370,8,263112,1449,28826,663,234286,786
2020-10-14,Northern Mariana Islands,69,77,0,2,0,15533,335,77,0,15456,335
2020-10-14,Ohio,39,173665,2039,5033,16,3726652,27911,173665,2039,3552987,25872
2020-10-14,Oklahoma,40,102615,1122,1132,13,1385669,11953,102615,1122,1283054,10831
2020-10-14,Oregon,41,38175,387,609,4,761552,10275,38160,380,723392,9895
2020-10-14,Pennsylvania,42,180956,1283,8481,23,2250651,15912,175922,1276,2074729,14636
2020-10-14,Puerto Rico,72,55516,976,742,4,333601,490,27629,490,305972,0
2020-10-14,Rhode Island,44,27164,204,1147,8,383063,2369,27164,204,355899,2165
2020-10-14,South Carolina,45,159809,926,3593,17,1526565,15084,159809,926,1366756,14158
2020-10-14,South Dakota,46,30215,876,291,3,222321,1919,30215,876,192106,1043
2020-10-14,Tennessee,47,217140,1717,2801,33,3243821,18197,220538,1709,3023283,16488
2020-10-14,Texas,48,848168,5852,17276,111,7342121,76079,805082,4826,6537039,71253
2020-10-14,Utah,49,89018,1193,529,5,917021,7897,88963,1144,828058,6753
2020-10-14,Vermont,50,1889,3,58,0,173428,655,1894,3,171534,652
2020-10-14,Virgin Islands,78,1328,0,20,0,22187,125,1328,3,20859,122
2020-10-14,Virginia,51,161610,805,3381,9,2313940,11930,161610,805,2152330,11125
2020-10-14,Washington,53,100068,757,2319,8,2127268,867,98135,867,2029133,0
2020-10-14,West Virginia,54,18818,263,391,4,649465,4799,18818,263,630647,4536
2020-10-14,Wisconsin,55,167441,3304,1549,28,1735471,14758,167082,3323,1568389,11435
2020-10-14,Wyoming,56,8177,213,57,0,111026,-2817,8177,213,102849,-3030
2020-10-15,Alabama,01,169162,1185,2756,50,1254577,8124,169162,1185,1085415,6939
2020-10-15,Alaska,02,11268,165,61,1,519461,2284,10380,166,509081,2118
2020-10-15,Arizona,04,228748,1088,5789,17,1606089,11844,228748,1113,1377341,10731
2020-10-15,Arkansas,05,96524,1278,1645,11,1191223,12870,96524,1278,1094699,11592
2020-10-15,California,06,870380,3286,16839,87,16517812,92325,858401,3329,15659411,88996
2020-10-15,Colorado,08,82443,1238,2187,1,1056107,10840,81918,1141,974189,9699
2020-10-15,Connecticut,09,62028,167,4540,3,1934569,15845,62028,167,1872541,15678
2020-10-15,Delaware,10,22560,95,661,1,318633,1810,22560,95,296073,1715
2020-10-15,District of Columbia,11,16166,34,638,0,450614,2352,16166,34,434448,2318
2020-10-15,Florida,12,744980,3356,15735,141,5634218,28204,735685,3286,4898533,24918
2020-10-15,Georgia,13,344093,1791,7320,22,3229781,25473,336241,1640,2893540,23833
2020-10-15,Guam,66,4396,86,62,0,57465,571,3427,86,54038,485
2020-10-15,Hawaii,15,13922,88,183,1,309025,99,13872,99,295153,0
2020-10-15,Idaho,16,51471,937,521,1,348111,2248,49892,645,298219,1603
2020-10-15,Illinois,17,336211,4087,9392,57,6534047,67086,334658,4015,6199389,63071
2020-10-15,Indiana,18,143617,1947,3864,28,1521402,10342,141212,1943,1380190,8399
2020-10-15,Iowa,19,104232,1327,1516,11,835606,6353,98717,1333,736889,5020
2020-10-15,Kansas,20,70815,150,838,0,579827,0,69155,0,510672,0
2020-10-15,Kentucky,21,86410,1132,1341,16,1645379,31538,84195,1182,1561184,30356
2020-10-15,Louisiana,22,176952,743,5707,12,2546007,26284,176952,743,2369055,25541
2020-10-15,Maine,23,5836,20,144,1,526067,5665,5836,20,520231,5645
2020-10-15,Maryland,24,134042,629,4028,6,1770835,10181,133548,630,1637287,9551
2020-10-15,Massachusetts,25,141579,587,9672,25,2474616,14756,141579,587,2333037,14169
2020-10-15,Michigan,26,156926,2517,7304,34,4171989,42577,156913,2458,4015076,40119
2020-10-15,Minnesota,27,117159,1163,2252,19,1623517,10106,117106,1163,1506411,8943
2020-10-15,Mississippi,28,108139,1322,3152,12,812794,1322,108139,1322,704655,0
2020-10-15,Missouri,29,156142,1929,2531,-67,1359246,7085,150554,1875,1208692,5210
2020-10-15,Montana,30,21043,722,230,5,419832,5253,20933,723,398899,4530
2020-10-15,Nebraska,31,55428,961,546,10,523777,4366,54467,924,469310,3442
2020-10-15,Nevada,32,88081,554,1700,6,745344,-2074,87969,655,657375,-2729
2020-10-15,New Hampshire,33,9426,77,463,5,303576,1957,9426,77,294150,1880
2020-10-15,New Jersey,34,218783,971,16197,6,4070357,33490,216994,971,3853363,32519
2020-10-15,New Mexico,35,34958,668,922,1,1027392,8363,34958,668,992434,7695
2020-10-15,New York,36,484135,1464,32935,19,12475392,133212,479400,1460,11995992,131752
2020-10-15,North Carolina,37,239338,2526,3899,17,3500763,33528,238939,2532,3261824,30996
2020-10-15,North Dakota,38,29658,706,375,5,264630,1518,29522,696,235108,822
2020-10-15,Northern Mariana Islands,69,80,3,2,0,15533,0,77,0,15456,0
2020-10-15,Ohio,39,175843,2178,5038,5,3760979,34327,175843,2178,3585136,32149
2020-10-15,Oklahoma,40,103836,1221,1143,11,1398768,13099,103836,1221,1294932,11878
2020-10-15,Oregon,41,38536,361,613,4,769276,7724,38525,365,730751,7359
2020-10-15,Pennsylvania,42,182502,1546,8496,15,2266717,16066,177520,1598,2089197,14468
2020-10-15,Puerto Rico,72,56085,569,743,1,333919,318,27947,318,305972,0
2020-10-15,Rhode Island,44,27438,274,1149,2,386776,3713,27438,274,359338,3439
2020-10-15,South Carolina,45,161106,1297,3607,14,1546608,20043,161106,1297,1385502,18746
2020-10-15,South Dakota,46,31012,797,304,13,224239,1918,31012,797,193227,1121
2020-10-15,Tennessee,47,219355,2215,2836,35,3268663,24842,222827,2289,3045836,22553
2020-10-15,Texas,48,853977,5809,17362,86,7412503,70382,809808,4726,6602695,65656
2020-10-15,Utah,49,90488,1470,531,2,923932,6911,90461,1498,833471,5413
2020-10-15,Vermont,50,1903,14,58,0,174471,1043,1910,16,172561,1027
2020-10-15,Virgin Islands,78,1329,1,21,1,22365,178,1327,-1,21038,179
2020-10-15,Virginia,51,162941,1331,3388,7,2336626,22686,162941,1331,2173685,21355
2020-10-15,Washington,53,100838,770,2331,12,2149903,22635,98903,768,2051000,21867
2020-10-15,West Virginia,54,19082,264,393,2,656414,6949,19082,264,637332,6685
2020-10-15,Wisconsin,55,171480,4039,1568,19,1750966,15495,171122,4040,1579844,11455
2020-10-15,Wyoming,56,8375,198,57,0,116389,5363,8375,198,108014,5165
2020-10-16,Alabama,01,170374,1212,2786,30,1261832,7255,170374,1212,1091458,6043
2020-10-16,Alaska,02,11496,228,62,1,522664,3203,10601,221,512063,2982
2020-10-16,Arizona,04,229508,760,5806,17,1614467,8378,229486,738,1384981,7640
2020-10-16,Arkansas,05,97539,1015,1665,20,1203320,12097,97539,1015,1105781,11082
2020-10-16,California,06,874101,3721,16901,62,16621956,104144,861476,3075,15760480,101069
2020-10-16,Colorado,08,83712,1269,2196,9,1065484,9377,83230,1312,982254,8065
2020-10-16,Connecticut,09,62830,802,4542,2,1967633,33064,62830,802,1904803,32262
2020-10-16,Delaware,10,22724,164,662,1,321142,2509,22724,164,298418,2345
2020-10-16,District of Columbia,11,16255,89,641,3,455787,5173,16255,89,439532,5084
2020-10-16,Florida,12,748429,3449,15829,94,5664298,30080,739050,3365,4925248,26715
2020-10-16,Georgia,13,345879,1786,7382,62,3254270,24489,337850,1609,2916420,22880
2020-10-16,Guam,66,4507,111,64,2,58122,657,3538,111,54584,546
2020-10-16,Hawaii,15,14007,85,184,1,309115,90,13962,90,295153,0
2020-10-16,Idaho,16,52234,763,529,8,350972,2861,50610,718,300362,2143
2020-10-16,Illinois,17,341219,5008,9447,55,6622355,88308,339761,5103,6282594,83205
2020-10-16,Indiana,18,145915,2298,3887,23,1532949,11547,143495,2283,1389454,9264
2020-10-16,Iowa,19,105746,1514,1524,8,822775,-12831,99946,1229,722829,-14060
2020-10-16,Kansas,20,72509,1694,859,21,589189,9362,70855,1700,518334,7662
2020-10-16,Kentucky,21,87764,1354,1349,8,1666429,21050,85506,1311,1580923,19739
2020-10-16,Louisiana,22,177726,774,5727,20,2565652,19645,177726,774,2387926,18871
2020-10-16,Maine,23,5865,29,145,1,533641,7574,5865,29,527776,7545
2020-10-16,Maryland,24,134822,780,4032,4,1782457,11622,134329,781,1648128,10841
2020-10-16,Massachusetts,25,142346,767,9702,30,2489643,15027,142346,767,2347297,14260
2020-10-16,Michigan,26,159144,2218,7320,16,4225410,53421,159119,2206,4066291,51215
2020-10-16,Minnesota,27,119449,2290,2265,13,1646955,23438,119396,2290,1527559,21148
2020-10-16,Mississippi,28,109255,1116,3160,8,838799,26005,109255,1116,729544,24889
2020-10-16,Missouri,29,158764,2622,2550,19,1361263,2017,152571,2017,1208692,0
2020-10-16,Montana,30,21674,631,235,5,425462,5630,21595,662,403867,4968
2020-10-16,Nebraska,31,56724,1296,556,10,529266,5489,55428,961,473838,4528
2020-10-16,Nevada,32,88832,751,1707,7,747671,2327,88685,716,658986,1611
2020-10-16,New Hampshire,33,9514,88,465,2,305815,2239,9514,88,296301,2151
2020-10-16,New Jersey,34,219593,810,16202,5,4101399,31042,217804,810,3883595,30232
2020-10-16,New Mexico,35,35770,812,928,6,1035851,8459,35770,812,1000081,7647
2020-10-16,New York,36,485838,1703,32944,9,12611431,136039,481107,1707,12130324,134332
2020-10-16,North Carolina,37,242032,2694,3938,39,3539731,38968,241623,2684,3298108,36284
2020-10-16,North Dakota,38,30522,864,393,18,266748,2118,30402,880,236346,1238
2020-10-16,Northern Mariana Islands,69,80,0,2,0,15536,3,80,3,15456,0
2020-10-16,Ohio,39,177991,2148,5054,16,3803487,42508,177991,2148,3625496,40360
2020-10-16,Oklahoma,40,105308,1472,1154,11,1418148,19380,105308,1472,1312840,17908
2020-10-16,Oregon,41,38947,411,620,7,775189,5913,38935,410,736254,5503
2020-10-16,Pennsylvania,42,184185,1683,8524,28,2282130,15413,179086,1566,2103044,13847
2020-10-16,Puerto Rico,72,56412,327,758,15,334146,227,28174,227,305972,0
2020-10-16,Rhode Island,44,27691,253,1152,3,390177,3401,27691,253,362486,3148
2020-10-16,South Carolina,45,162253,1147,3615,8,1566317,19709,162253,1147,1404064,18562
2020-10-16,South Dakota,46,31805,793,307,3,226990,2751,31805,793,195185,1958
2020-10-16,Tennessee,47,220099,744,2847,11,3274513,5850,223493,666,3051020,5184
2020-10-16,Texas,48,859567,5590,17454,92,7480885,68382,815678,5870,6665207,62512
2020-10-16,Utah,49,91966,1478,539,8,925428,1496,91957,1496,833471,0
2020-10-16,Vermont,50,1915,12,58,0,175304,833,1923,13,173381,820
2020-10-16,Virgin Islands,78,1329,0,21,0,22504,139,1329,2,21175,137
2020-10-16,Virginia,51,164124,1183,3408,20,2356897,20271,164124,1183,2192773,19088
2020-10-16,Washington,53,101533,695,2338,7,2172681,22778,99674,771,2073007,22007
2020-10-16,West Virginia,54,19580,498,396,3,667579,11165,19580,498,647999,10667
2020-10-16,Wisconsin,55,175652,4172,1588,20,1765796,14830,175227,4105,1590569,10725
2020-10-16,Wyoming,56,8665,290,57,0,117419,1030,8665,290,108754,740
2020-10-17,Alabama,01,171662,1288,2788,2,1269761,7929,171662,1288,1098099,6641
2020-10-17,Alaska,02,11710,214,63,1,530500,7836,10811,210,519689,7626
2020-10-17,Arizona,04,230412,904,5824,18,1625846,11379,230407,921,1395439,10458
2020-10-17,Arkansas,05,98422,883,1684,19,1213237,9917,98422,883,1114815,9034
2020-10-17,California,06,876257,2156,16940,39,16756711,134755,864455,2979,15892256,131776
2020-10-17,Colorado,08,84804,1092,2199,3,1075777,10293,84369,1139,991408,9154
2020-10-17,Connecticut,09,62830,0,4542,0,1967633,0,62830,0,1904803,0
2020-10-17,Delaware,10,22942,218,664,2,324469,3327,22942,218,301527,3109
2020-10-17,District of Columbia,11,16334,79,641,0,462968,7181,16334,79,446634,7102
2020-10-17,Florida,12,752473,4044,15916,87,5694637,30339,743018,3968,4951619,26371
2020-10-17,Georgia,13,347468,1589,7429,47,3280668,26398,339384,1534,2941284,24864
2020-10-17,Guam,66,4507,0,64,0,58680,558,3617,79,55063,479
2020-10-17,Hawaii,15,14101,94,185,1,309200,85,14047,85,295153,0
2020-10-17,Idaho,16,52582,348,532,3,354136,3164,51704,1094,302432,2070
2020-10-17,Illinois,17,344787,3568,9474,27,6699844,77489,343390,3629,6356454,73860
2020-10-17,Indiana,18,148400,2485,3918,31,1545927,12978,145977,2482,1399950,10496
2020-10-17,Iowa,19,106698,952,1528,4,827884,5109,101103,1157,726781,3952
2020-10-17,Kansas,20,72616,107,859,0,589189,0,70855,0,518334,0
2020-10-17,Kentucky,21,88823,1059,1363,14,1687530,21101,86797,1291,1600733,19810
2020-10-17,Louisiana,22,177726,0,5727,0,2565652,0,177726,0,2387926,0
2020-10-17,Maine,23,5913,48,146,1,533689,48,5913,48,527776,0
2020-10-17,Maryland,24,135463,641,4036,4,1794904,12447,135127,798,1659777,11649
2020-10-17,Massachusetts,25,142930,584,9723,21,2502072,12429,142930,584,2359142,11845
2020-10-17,Michigan,26,159259,115,7323,3,4270757,45347,159119,0,4111638,45347
2020-10-17,Minnesota,27,121143,1694,2270,5,1661623,14668,121090,1694,1540533,12974
2020-10-17,Mississippi,28,110006,751,3171,11,839550,751,110006,751,729544,0
2020-10-17,Missouri,29,160654,1890,2645,95,1378663,17400,154928,2357,1223735,15043
2020-10-17,Montana,30,22284,610,240,5,428128,2666,22233,638,405895,2028
2020-10-17,Nebraska,31,57334,610,557,1,535347,6081,56714,1286,478633,4795
2020-10-17,Nevada,32,89848,1016,1709,2,755234,7563,89652,967,665582,6596
2020-10-17,New Hampshire,33,9625,111,466,1,311615,5800,9625,111,301990,5689
2020-10-17,New Jersey,34,220527,934,16204,2,4135796,34397,218738,934,3917058,33463
2020-10-17,New Mexico,35,36343,573,929,1,1046727,10876,36343,573,1010384,10303
2020-10-17,New York,36,487626,1788,32959,15,12771403,159972,482891,1784,12288512,158188
2020-10-17,North Carolina,37,244020,1988,3955,17,3582572,42841,243725,2102,3338847,40739
2020-10-17,North Dakota,38,31266,744,404,11,268584,1836,31173,771,237411,1065
2020-10-17,Northern Mariana Islands,69,86,6,2,0,15542,6,86,6,15456,0
2020-10-17,Ohio,39,180225,2234,5067,13,3854399,50912,180225,2234,3674174,48678
2020-10-17,Oklahoma,40,106503,1195,1168,14,1434035,15887,106503,1195,1327532,14692
2020-10-17,Oregon,41,39316,369,622,2,781643,6454,39316,381,742327,6073
2020-10-17,Pennsylvania,42,185670,1485,8535,11,2300793,18663,180943,1857,2119850,16806
2020-10-17,Puerto Rico,72,56650,238,761,3,334265,119,28293,119,305972,0
2020-10-17,Rhode Island,44,27691,0,1152,0,394774,4597,27978,287,366796,4310
2020-10-17,South Carolina,45,163214,961,3637,22,1585051,18734,163214,961,1421837,17773
2020-10-17,South Dakota,46,32611,806,315,8,229204,2214,32611,806,196593,1408
2020-10-17,Tennessee,47,222608,2509,2875,28,3305133,30620,226139,2646,3078994,27974
2020-10-17,Texas,48,863993,4426,17518,64,7546873,65988,820563,4885,6726310,61103
2020-10-17,Utah,49,93297,1331,541,2,941244,15816,93297,1340,847947,14476
2020-10-17,Vermont,50,1926,11,58,0,175990,686,1932,9,174058,677
2020-10-17,Virgin Islands,78,1335,6,21,0,22504,0,1329,0,21175,0
2020-10-17,Virginia,51,165238,1114,3422,14,2376550,19653,165238,1114,2211312,18539
2020-10-17,Washington,53,102054,521,2339,1,2197804,25123,100444,770,2097360,24353
2020-10-17,West Virginia,54,19801,221,399,3,672361,4782,19801,221,652560,4561
2020-10-17,Wisconsin,55,175652,0,1588,0,1765796,0,175227,0,1590569,0
2020-10-17,Wyoming,56,8816,151,57,0,117570,151,8816,151,108754,0
2020-10-18,Alabama,01,172626,964,2788,0,1274995,5234,172626,964,1102369,4270
2020-10-18,Alaska,02,11934,224,63,0,532711,2211,11021,210,521690,2001
2020-10-18,Arizona,04,231149,737,5827,3,1636210,10364,231149,742,1405061,9622
2020-10-18,Arkansas,05,99066,644,1704,20,1221654,8417,99066,644,1122588,7773
2020-10-18,California,06,878394,2137,16979,39,16892062,135351,867317,2862,16024745,132489
2020-10-18,Colorado,08,85803,999,2199,0,1085968,10191,85302,933,1000666,9258
2020-10-18,Connecticut,09,62830,0,4542,0,1967633,0,62830,0,1904803,0
2020-10-18,Delaware,10,23093,151,665,1,327296,2827,23093,151,304203,2676
2020-10-18,District of Columbia,11,16370,36,641,0,466805,3837,16370,36,450435,3801
2020-10-18,Florida,12,755012,2539,15966,50,5712864,18227,745492,2474,4967372,15753
2020-10-18,Georgia,13,348773,1305,7460,31,3298458,17790,340558,1174,2957900,16616
2020-10-18,Guam,66,4507,0,64,0,58968,288,3675,58,55293,230
2020-10-18,Hawaii,15,14183,82,186,1,309296,96,14143,96,295153,0
2020-10-18,Idaho,16,53092,510,532,0,356140,2004,52582,878,303558,1126
2020-10-18,Illinois,17,348870,4083,9491,17,6779140,79296,347635,4245,6431505,75051
2020-10-18,Indiana,18,150005,1605,3937,19,1555437,9510,147582,1605,1407855,7905
2020-10-18,Iowa,19,107334,636,1532,4,832536,4652,101960,857,730576,3795
2020-10-18,Kansas,20,72722,106,859,0,589189,0,70855,0,518334,0
2020-10-18,Kentucky,21,89538,715,1372,9,1688340,810,87607,810,1600733,0
2020-10-18,Louisiana,22,178869,1143,5750,23,2592598,26946,178869,1143,2413729,25803
2020-10-18,Maine,23,5939,26,146,0,533715,26,5939,26,527776,0
2020-10-18,Maryland,24,136149,686,4037,1,1806662,11758,135657,530,1671005,11228
2020-10-18,Massachusetts,25,143660,730,9737,14,2517646,15574,143660,730,2373986,14844
2020-10-18,Michigan,26,159337,78,7323,0,4270757,0,159119,0,4111638,0
2020-10-18,Minnesota,27,122865,1722,2287,17,1681318,19695,122812,1722,1558506,17973
2020-10-18,Mississippi,28,110239,233,3171,0,839550,0,110006,0,729544,0
2020-10-18,Missouri,29,162156,1502,2648,3,1386536,7873,156696,1768,1229840,6105
2020-10-18,Montana,30,22821,537,241,1,431134,3006,22821,588,408313,2418
2020-10-18,Nebraska,31,58068,734,557,0,539127,3780,57334,620,481793,3160
2020-10-18,Nevada,32,90374,526,1711,2,759508,4274,90261,609,669247,3665
2020-10-18,New Hampshire,33,9694,69,467,1,313364,1749,9694,69,303670,1680
2020-10-18,New Jersey,34,221802,1275,16211,7,4137071,1275,220013,1275,3917058,0
2020-10-18,New Mexico,35,36788,445,934,5,1054891,8164,36788,445,1018103,7719
2020-10-18,New York,36,489016,1390,32972,13,12900166,128763,484281,1390,12415885,127373
2020-10-18,North Carolina,37,246116,2096,3961,6,3617258,34686,246028,2303,3371230,32383
2020-10-18,North Dakota,38,31983,717,409,5,270463,1879,31886,713,238577,1166
2020-10-18,Northern Mariana Islands,69,86,0,2,0,15542,0,86,0,15456,0
2020-10-18,Ohio,39,181787,1562,5067,0,3900649,46250,181787,1562,3718862,44688
2020-10-18,Oklahoma,40,107299,796,1171,3,1434831,796,107299,796,1327532,0
2020-10-18,Oregon,41,39532,216,622,0,785104,3461,39532,216,745572,3245
2020-10-18,Pennsylvania,42,186772,1102,8555,20,2314863,14070,182212,1269,2132651,12801
2020-10-18,Puerto Rico,72,57293,643,766,5,334683,418,28711,418,305972,0
2020-10-18,Rhode Island,44,27691,0,1152,0,398224,3450,28262,284,369962,3166
2020-10-18,South Carolina,45,163990,776,3650,13,1601263,16212,163990,776,1437273,15436
2020-10-18,South Dakota,46,33269,658,323,8,231047,1843,33269,658,197778,1185
2020-10-18,Tennessee,47,225126,2518,2884,9,3340819,35686,228744,2605,3112075,33081
2020-10-18,Texas,48,869376,5383,17541,23,7579232,32359,823779,3216,6755453,29143
2020-10-18,Utah,49,94394,1097,544,3,948245,7001,94394,1097,853851,5904
2020-10-18,Vermont,50,1937,11,58,0,177029,1039,1943,11,175086,1028
2020-10-18,Virgin Islands,78,1335,0,21,0,22852,348,1335,6,21517,342
2020-10-18,Virginia,51,166138,900,3433,11,2397078,20528,166138,900,2230940,19628
2020-10-18,Washington,53,102403,349,2339,0,2217997,20193,101108,664,2116889,19529
2020-10-18,West Virginia,54,20081,280,399,0,680872,8511,20081,280,660791,8231
2020-10-18,Wisconsin,55,175652,0,1588,0,1765796,0,175227,0,1590569,0
2020-10-18,Wyoming,56,9025,209,57,0,117779,209,9025,209,108754,0
2020-10-19,Alabama,01,173485,859,2789,1,1281313,6318,173485,859,1107828,5459
2020-10-19,Alaska,02,12138,204,63,0,536223,3512,11225,204,524998,3308
2020-10-19,Arizona,04,231933,784,5830,3,1645001,8791,231897,748,1413104,8043
2020-10-19,Arkansas,05,99597,531,1714,10,1229721,8067,99597,531,1130124,7536
2020-10-19,California,06,882665,4271,16987,8,17042408,150346,870791,3474,16171617,146872
2020-10-19,Colorado,08,86727,924,2207,8,1095280,9312,86374,1072,1008906,8240
2020-10-19,Connecticut,09,64021,1191,4554,12,2039597,71964,64021,1191,1975576,70773
2020-10-19,Delaware,10,23196,103,666,1,329018,1722,23196,103,305822,1619
2020-10-19,District of Columbia,11,16395,25,641,0,469040,2235,16395,25,452645,2210
2020-10-19,Florida,12,756719,1707,16020,54,5729739,16875,747183,1691,4982556,15184
2020-10-19,Georgia,13,350654,1881,7479,19,3314279,15821,341310,752,2972969,15069
2020-10-19,Guam,66,4725,218,67,3,59549,581,3756,81,55793,500
2020-10-19,Hawaii,15,14218,35,186,0,309378,82,14225,82,295153,0
2020-10-19,Idaho,16,54123,1031,535,3,359107,2967,53092,510,306015,2457
2020-10-19,Illinois,17,352449,3579,9520,29,6827824,48684,350748,3113,6477076,45571
2020-10-19,Indiana,18,151588,1583,3960,23,1564722,9285,149166,1584,1415556,7701
2020-10-19,Iowa,19,108114,780,1548,16,835573,3037,102517,557,733056,2480
2020-10-19,Kansas,20,74616,1894,872,13,598394,9205,72968,2113,525426,7092
2020-10-19,Kentucky,21,90443,905,1381,9,1711919,23579,88247,640,1623672,22939
2020-10-19,Louisiana,22,179070,201,5766,16,2597464,4866,179070,201,2418394,4665
2020-10-19,Maine,23,5962,23,146,0,549477,15762,5962,23,543515,15739
2020-10-19,Maryland,24,136643,494,4041,4,1816722,10060,136154,497,1680568,9563
2020-10-19,Massachusetts,25,144488,828,9753,16,2535301,17655,144488,828,2390813,16827
2020-10-19,Michigan,26,164055,4718,7364,41,4335624,64867,164123,5004,4171501,59863
2020-10-19,Minnesota,27,124492,1627,2292,5,1694569,13251,124439,1627,1570130,11624
2020-10-19,Mississippi,28,110592,353,3171,0,840136,586,110592,586,729544,0
2020-10-19,Missouri,29,164249,2093,2660,12,1393100,6564,158101,1405,1234999,5159
2020-10-19,Montana,30,23503,682,242,1,442366,11232,23390,569,418976,10663
2020-10-19,Nebraska,31,58817,749,568,11,543213,4086,58068,734,485145,3352
2020-10-19,Nevada,32,90978,604,1714,3,763202,3694,90843,582,672359,3112
2020-10-19,New Hampshire,33,9746,52,468,1,314806,1442,9746,52,305060,1390
2020-10-19,New Jersey,34,222994,1192,16214,3,4217705,80634,221205,1192,3996500,79442
2020-10-19,New Mexico,35,37302,514,935,1,1061268,6377,37302,514,1023966,5863
2020-10-19,New York,36,490015,999,32990,18,12982175,82009,485279,998,12496896,81011
2020-10-19,North Carolina,37,247551,1435,3969,8,3648364,31106,247172,1144,3401192,29962
2020-10-19,North Dakota,38,32642,659,413,4,272644,2181,32544,658,240100,1523
2020-10-19,Northern Mariana Islands,69,86,0,2,0,15542,0,86,0,15456,0
2020-10-19,Ohio,39,183624,1837,5075,8,3941567,40918,183624,1837,3757943,39081
2020-10-19,Oklahoma,40,108073,774,1173,2,1435605,774,108073,774,1327532,0
2020-10-19,Oregon,41,39799,267,630,8,788509,3405,39794,262,748715,3143
2020-10-19,Pennsylvania,42,188442,1670,8562,7,2327281,12418,183315,1103,2143966,11315
2020-10-19,Puerto Rico,72,57950,657,768,2,335110,427,29138,427,305972,0
2020-10-19,Rhode Island,44,28347,656,1159,7,399326,1102,28347,85,370979,1017
2020-10-19,South Carolina,45,164609,619,3661,11,1610200,8937,164609,619,1445591,8318
2020-10-19,South Dakota,46,33836,567,323,0,232450,1403,33836,567,198614,836
2020-10-19,Tennessee,47,228267,3141,2896,12,3383392,42573,232061,3317,3151331,39256
2020-10-19,Texas,48,874080,4704,17564,23,7603161,23929,825673,1894,6777488,22035
2020-10-19,Utah,49,95572,1178,547,3,954879,6634,95562,1168,859317,5466
2020-10-19,Vermont,50,1946,9,58,0,178084,1055,1951,8,176133,1047
2020-10-19,Virgin Islands,78,1335,0,21,0,22852,0,1335,0,21517,0
2020-10-19,Virginia,51,166828,690,3457,24,2408500,11422,166828,690,2241672,10732
2020-10-19,Washington,53,103323,920,2357,18,2234101,16104,101517,409,2132584,15695
2020-10-19,West Virginia,54,20293,212,399,0,687990,7118,20293,212,667697,6906
2020-10-19,Wisconsin,55,183177,7525,1624,36,1886955,121159,183142,7915,1703813,113244
2020-10-19,Wyoming,56,9311,286,57,0,118065,286,9311,286,108754,0
2020-10-20,Alabama,01,174528,1043,2805,16,1287087,5774,174528,1043,1112559,4731
2020-10-20,Alaska,02,12349,211,63,0,546525,10302,11456,231,535069,10071
2020-10-20,Arizona,04,232939,1006,5837,7,1652612,7611,232937,1040,1419675,6571
2020-10-20,Arkansas,05,100441,844,1728,14,1237675,7954,100441,844,1137234,7110
2020-10-20,California,06,887093,4428,17067,80,17189070,146662,874077,3286,16314993,143376
2020-10-20,Colorado,08,87966,1239,2212,5,1101775,6495,87582,1208,1014193,5287
2020-10-20,Connecticut,09,64455,434,4559,5,2054262,14665,64455,434,1989807,14231
2020-10-20,Delaware,10,23325,129,668,2,330726,1708,23325,129,307401,1579
2020-10-20,District of Columbia,11,16445,50,642,1,473807,4767,16445,50,457362,4717
2020-10-20,Florida,12,760381,3662,16104,84,5758297,28558,750739,3556,5007558,25002
2020-10-20,Georgia,13,351990,1336,7494,15,3327836,13557,342438,1128,2985398,12429
2020-10-20,Guam,66,4855,130,67,0,60506,957,3886,130,56620,827
2020-10-20,Hawaii,15,14302,84,188,2,309415,37,14262,37,295153,0
2020-10-20,Idaho,16,55153,1030,541,6,361402,2295,53790,698,307612,1597
2020-10-20,Illinois,17,356151,3702,9562,42,6886901,59077,354462,3714,6532439,55363
2020-10-20,Indiana,18,153088,1500,4008,48,1572350,7628,150664,1498,1421686,6130
2020-10-20,Iowa,19,109210,1096,1576,28,837718,2145,103011,494,734707,1651
2020-10-20,Kansas,20,74883,267,902,30,598394,0,72968,0,525426,0
2020-10-20,Kentucky,21,91731,1288,1403,22,1720328,8409,89544,1297,1630784,7112
2020-10-20,Louisiana,22,179769,699,5772,6,2616457,18993,179769,699,2436688,18294
2020-10-20,Maine,23,5989,27,146,0,554094,4617,5989,27,548105,4590
2020-10-20,Maryland,24,137229,586,4050,9,1824905,8183,136744,590,1688161,7593
2020-10-20,Massachusetts,25,145464,976,9758,5,2552694,17393,145464,976,2407230,16417
2020-10-20,Michigan,26,165949,1894,7386,22,4385791,50167,165994,1871,4219797,48296
2020-10-20,Minnesota,27,125584,1092,2299,7,1700265,5696,125531,1092,1574734,4604
2020-10-20,Mississippi,28,111322,730,3202,31,840866,730,111322,730,729544,0
2020-10-20,Missouri,29,164891,642,2668,8,1394624,1524,159625,1524,1234999,0
2020-10-20,Montana,30,24201,698,252,10,445021,2655,24093,703,420928,1952
2020-10-20,Nebraska,31,59409,592,575,7,546669,3456,58817,749,487852,2707
2020-10-20,Nevada,32,91679,701,1728,14,766312,3110,91499,656,674813,2454
2020-10-20,New Hampshire,33,9828,82,468,0,316091,1285,9828,82,306263,1203
2020-10-20,New Jersey,34,223982,988,16227,13,4235300,17595,222193,988,4013107,16607
2020-10-20,New Mexico,35,37896,594,942,7,1070481,9213,37896,594,1032585,8619
2020-10-20,New York,36,491216,1201,32998,8,13072715,90540,486480,1201,12586235,89339
2020-10-20,North Carolina,37,249158,1607,4018,49,3671793,23429,248750,1578,3423043,21851
2020-10-20,North Dakota,38,33671,1029,417,4,274499,1855,33593,1049,240906,806
2020-10-20,Northern Mariana Islands,69,88,2,2,0,15811,269,88,2,15723,267
2020-10-20,Ohio,39,185639,2015,5083,8,3979414,37847,185639,2015,3793775,35832
2020-10-20,Oklahoma,40,109548,1475,1191,18,1467010,31405,109548,1475,1357462,29930
2020-10-20,Oregon,41,40149,350,636,6,795317,6808,40136,342,755181,6466
2020-10-20,Pennsylvania,42,189988,1546,8591,29,2340511,13230,184872,1557,2155639,11673
2020-10-20,Puerto Rico,72,58643,693,769,1,335557,447,29585,447,305972,0
2020-10-20,Rhode Island,44,28649,302,1164,5,401055,1729,28649,302,372406,1427
2020-10-20,South Carolina,45,165493,884,3696,35,1619922,9722,165493,884,1454429,8838
2020-10-20,South Dakota,46,34457,621,330,7,234726,2276,34457,621,200269,1655
2020-10-20,Tennessee,47,229794,1527,2924,28,3396736,13344,233569,1508,3163167,11836
2020-10-20,Texas,48,879949,5869,17644,80,7687050,83889,833557,7884,6853493,76005
2020-10-20,Utah,49,96643,1071,552,5,959942,5063,96643,1081,863299,3982
2020-10-20,Vermont,50,1956,10,58,0,178444,360,1963,12,176481,348
2020-10-20,Virgin Islands,78,1337,2,21,0,22852,0,1335,0,21517,0
2020-10-20,Virginia,51,167754,926,3485,28,2422481,13981,167754,926,2254727,13055
2020-10-20,Washington,53,103845,522,2380,23,2247490,13389,101815,298,2145675,13091
2020-10-20,West Virginia,54,20519,226,408,9,691809,3819,20519,226,671290,3593
2020-10-20,Wisconsin,55,187898,4721,1660,36,1900711,13756,187828,4686,1712883,9070
2020-10-20,Wyoming,56,9526,215,61,4,118280,215,9526,215,108754,0
2020-10-21,Alabama,01,175674,1146,2828,23,1295035,7948,174528,0,1120507,7948
2020-10-21,Alaska,02,12559,210,64,1,547140,615,11680,224,535460,391
2020-10-21,Arizona,04,233948,1009,5854,17,1662704,10092,233912,975,1428792,9117
2020-10-21,Arkansas,05,101596,1155,1751,23,1248949,11274,101596,1155,1147353,10119
2020-10-21,California,06,890153,3060,17189,122,17293139,104069,877784,3707,16415355,100362
2020-10-21,Colorado,08,89245,1279,2220,8,1110243,8468,88849,1267,1021394,7201
2020-10-21,Connecticut,09,64871,416,4567,8,2070126,15864,64871,416,2005255,15448
2020-10-21,Delaware,10,23375,50,670,2,331480,754,23375,50,308105,704
2020-10-21,District of Columbia,11,16498,53,642,0,476443,2636,16498,53,459945,2583
2020-10-21,Florida,12,762525,2144,16209,105,5760403,2106,752845,2106,5007558,0
2020-10-21,Georgia,13,353449,1459,7523,29,3338315,10479,343750,1312,2994565,9167
2020-10-21,Guam,66,4937,82,69,2,61243,737,3968,82,57275,655
2020-10-21,Hawaii,15,14379,77,202,14,309503,88,14350,88,295153,0
2020-10-21,Idaho,16,55922,769,551,10,363972,2570,54663,873,309309,1697
2020-10-21,Illinois,17,360160,4009,9622,60,6953692,66791,358804,4342,6594888,62449
2020-10-21,Indiana,18,154822,1734,4023,15,1581109,8759,152396,1732,1428713,7027
2020-10-21,Iowa,19,110444,1234,1594,18,842542,4824,104190,1179,738352,3645
2020-10-21,Kansas,20,76299,1416,952,50,605509,7115,74456,1488,531053,5627
2020-10-21,Kentucky,21,93110,1379,1424,21,1728638,8310,90996,1452,1637642,6858
2020-10-21,Louisiana,22,181132,1363,5790,18,2631404,14947,181132,1363,2450272,13584
2020-10-21,Maine,23,6027,38,146,0,560810,6716,6027,38,554783,6678
2020-10-21,Maryland,24,137720,491,4058,8,1832007,7102,137236,492,1694771,6610
2020-10-21,Massachusetts,25,146166,702,9780,22,2565472,12778,146166,702,2419306,12076
2020-10-21,Michigan,26,167857,1908,7420,34,4420831,35040,167872,1878,4252959,33162
2020-10-21,Minnesota,27,126644,1060,2334,35,1708514,8249,126591,1060,1581923,7189
2020-10-21,Mississippi,28,112123,801,3223,21,841667,801,112123,801,729544,0
2020-10-21,Missouri,29,167435,2544,2716,48,1407874,13250,160869,1244,1247005,12006
2020-10-21,Montana,30,24818,617,276,24,447994,2973,24712,619,423282,2354
2020-10-21,Nebraska,31,60308,899,586,11,549922,3253,59409,592,490513,2661
2020-10-21,Nevada,32,92193,514,1735,7,769613,3301,92064,565,677549,2736
2020-10-21,New Hampshire,33,9917,89,469,1,318292,2201,9917,89,308375,2112
2020-10-21,New Jersey,34,225012,1030,16245,18,4264123,28823,223223,1030,4040900,27793
2020-10-21,New Mexico,35,38715,819,950,8,1078087,7606,38715,819,1039372,6787
2020-10-21,New York,36,493245,2029,33005,7,13197504,124789,488506,2026,12708998,122763
2020-10-21,North Carolina,37,251010,1852,4063,45,3692043,20250,250592,1842,3441451,18408
2020-10-21,North Dakota,38,34170,499,427,10,275545,1046,34114,521,241431,525
2020-10-21,Northern Mariana Islands,69,88,0,2,0,15811,0,88,0,15723,0
2020-10-21,Ohio,39,188005,2366,5149,66,4011513,32099,188005,2366,3823508,29733
2020-10-21,Oklahoma,40,110855,1307,1210,19,1478225,11215,110855,1307,1367370,9908
2020-10-21,Oregon,41,40458,309,638,2,799935,4618,40443,307,759492,4311
2020-10-21,Pennsylvania,42,191347,1359,8629,38,2353833,13322,186297,1425,2167536,11897
2020-10-21,Puerto Rico,72,58830,187,774,5,335689,132,29717,132,305972,0
2020-10-21,Rhode Island,44,29123,474,1169,5,404680,3625,29123,474,375557,3151
2020-10-21,South Carolina,45,166357,864,3708,12,1633549,13627,166357,864,1467192,12763
2020-10-21,South Dakota,46,35044,587,333,3,236250,1524,35044,587,201206,937
2020-10-21,Tennessee,47,232100,2306,2946,22,3416255,19519,235861,2292,3180394,17227
2020-10-21,Texas,48,886421,6472,17743,99,7769909,82859,838809,5252,6931100,77607
2020-10-21,Utah,49,98037,1394,558,6,966892,6950,98006,1363,868886,5587
2020-10-21,Vermont,50,1971,15,58,0,179235,791,1983,20,177252,771
2020-10-21,Virgin Islands,78,1337,0,21,0,23105,253,1337,2,21768,251
2020-10-21,Virginia,51,168772,1018,3515,30,2442510,20029,168772,1018,2273738,19011
2020-10-21,Washington,53,104624,779,2384,4,2256366,8876,102728,913,2153638,7963
2020-10-21,West Virginia,54,20734,215,413,5,696597,4788,20734,215,675863,4573
2020-10-21,Wisconsin,55,192225,4327,1707,47,1910755,10044,192191,4363,1718564,5681
2020-10-21,Wyoming,56,9848,322,61,0,121670,3390,9848,322,111822,3068
2020-10-22,Alabama,01,177064,1390,2843,15,1302817,7782,177064,2536,1125753,5246
2020-10-22,Alaska,02,12790,231,64,0,548709,1569,11919,239,536790,1330
2020-10-22,Arizona,04,234914,966,5859,5,1673903,11199,234906,994,1438997,10205
2020-10-22,Arkansas,05,102798,1202,1772,21,1262040,13091,102798,1202,1159242,11889
2020-10-22,California,06,896424,6271,17266,77,17358770,65631,880724,2940,16478046,62691
2020-10-22,Colorado,08,90639,1394,2224,4,1120200,9957,90222,1373,1029978,8584
2020-10-22,Connecticut,09,65373,502,4569,2,2092263,22137,65373,502,2026890,21635
2020-10-22,Delaware,10,23528,153,670,0,333059,1579,23528,153,309531,1426
2020-10-22,District of Columbia,11,16537,39,642,0,479435,2992,16537,39,462898,2953
2020-10-22,Florida,12,768083,5558,16266,57,5812154,51751,758306,5461,5053848,46290
2020-10-22,Georgia,13,355156,1707,7547,24,3367534,29219,345535,1785,3021999,27434
2020-10-22,Guam,66,5025,88,70,1,62287,1044,4056,88,58231,956
2020-10-22,Hawaii,15,14478,99,205,3,309580,77,14427,77,295153,0
2020-10-22,Idaho,16,56944,1022,560,9,366607,2635,55650,987,310957,1648
2020-10-22,Illinois,17,365120,4960,9663,41,7034669,80977,363746,4942,6670923,76035
2020-10-22,Indiana,18,157678,2856,4065,42,1594365,13256,155246,2850,1439119,10406
2020-10-22,Iowa,19,112242,1798,1617,23,848270,5728,105625,1435,742645,4293
2020-10-22,Kansas,20,76546,247,952,0,605509,0,74456,0,531053,0
2020-10-22,Kentucky,21,94582,1472,1439,15,1758052,29414,92299,1303,1665753,28111
2020-10-22,Louisiana,22,181904,772,5799,9,2651160,19756,181904,772,2469256,18984
2020-10-22,Maine,23,6064,37,146,0,567382,6572,6064,37,561318,6535
2020-10-22,Maryland,24,138473,753,4070,12,1843355,11348,137979,743,1705376,10605
2020-10-22,Massachusetts,25,147215,1049,9810,30,2583501,18029,147215,1049,2436286,16980
2020-10-22,Michigan,26,170102,2245,7465,45,4468863,48032,170076,2204,4298787,45828
2020-10-22,Minnesota,27,128205,1561,2354,20,1722897,14383,128152,1561,1594745,12822
2020-10-22,Mississippi,28,113081,958,3231,8,842625,958,113081,958,729544,0
2020-10-22,Missouri,29,169311,1876,2734,18,1432472,24598,162723,1854,1269749,22744
2020-10-22,Montana,30,25736,918,279,3,452846,4852,25640,928,427206,3924
2020-10-22,Nebraska,31,61285,977,589,3,554539,4617,60308,899,494231,3718
2020-10-22,Nevada,32,93028,835,1736,1,774095,4482,92853,789,681242,3693
2020-10-22,New Hampshire,33,9994,77,470,1,323173,4881,9994,77,313179,4804
2020-10-22,New Jersey,34,226174,1162,16263,18,4297612,33489,224385,1162,4073227,32327
2020-10-22,New Mexico,35,39377,662,953,3,1089150,11063,39377,662,1049773,10401
2020-10-22,New York,36,494874,1629,33022,17,13332845,135341,490134,1628,12842711,133713
2020-10-22,North Carolina,37,253418,2408,4110,47,3727675,35632,252992,2400,3474683,33232
2020-10-22,North Dakota,38,35057,887,436,9,277802,2257,35162,1048,242640,1209
2020-10-22,Northern Mariana Islands,69,88,0,2,0,15811,0,88,0,15723,0
2020-10-22,Ohio,39,190430,2425,5161,12,4055125,43612,190430,2425,3864695,41187
2020-10-22,Oklahoma,40,112483,1628,1221,11,1491088,12863,112483,1628,1378605,11235
2020-10-22,Oregon,41,40825,367,647,9,806001,6066,40810,367,765191,5699
2020-10-22,Pennsylvania,42,193401,2054,8660,31,2373439,19606,188360,2063,2185079,17543
2020-10-22,Puerto Rico,72,59037,207,783,9,335776,87,29804,87,305972,0
2020-10-22,Rhode Island,44,29594,471,1173,4,408302,3622,29594,471,378708,3151
2020-10-22,South Carolina,45,167485,1128,3755,47,1649351,15802,167485,1128,1481866,14674
2020-10-22,South Dakota,46,36017,973,347,14,238446,2196,36017,973,202429,1223
2020-10-22,Tennessee,47,234079,1979,2983,37,3436334,20079,237907,2046,3198427,18033
2020-10-22,Texas,48,891714,5293,17760,17,7851327,81418,845100,6291,7006227,75127
2020-10-22,Utah,49,99563,1526,563,5,976126,9234,99549,1543,876577,7691
2020-10-22,Vermont,50,1987,16,58,0,180122,887,1999,16,178123,871
2020-10-22,Virgin Islands,78,1343,6,21,0,23254,149,1343,6,21911,143
2020-10-22,Virginia,51,170104,1332,3524,9,2462742,20232,170104,1332,2292638,18900
2020-10-22,Washington,53,105364,740,2389,5,2280225,23859,103646,918,2176579,22941
2020-10-22,West Virginia,54,21057,323,418,5,705151,8554,21057,323,684094,8231
2020-10-22,Wisconsin,55,195853,3628,1730,23,1926469,15714,195823,3632,1730646,12082
2020-10-22,Wyoming,56,10119,271,68,7,121941,271,10119,271,111822,0
2020-10-23,Alabama,01,180916,3852,2859,16,1314774,11957,180916,3852,1133858,8105
2020-10-23,Alaska,02,13067,277,64,0,552746,4037,12167,248,540579,3789
2020-10-23,Arizona,04,235910,996,5865,6,1686863,12960,235882,976,1450981,11984
2020-10-23,Arkansas,05,104135,1337,1782,10,1274297,12257,104135,1337,1170162,10920
2020-10-23,California,06,902325,5901,17316,50,17483293,124523,886865,6141,16596428,118382
2020-10-23,Colorado,08,92067,1428,2233,9,1130901,10701,91572,1350,1039329,9351
2020-10-23,Connecticut,09,66052,679,4577,8,2115744,23481,66052,679,2049692,22802
2020-10-23,Delaware,10,23687,159,678,8,335112,2053,23687,159,311425,1894
2020-10-23,District of Columbia,11,16609,72,642,0,485753,6318,16609,72,469144,6246
2020-10-23,Florida,12,771772,3689,16339,73,5855896,43742,761924,3618,5093972,40124
2020-10-23,Georgia,13,357319,2163,7584,37,3407623,40089,347759,2224,3059864,37865
2020-10-23,Guam,66,5110,85,70,0,62906,619,4141,85,58765,534
2020-10-23,Hawaii,15,14617,139,208,3,309682,102,14529,102,295153,0
2020-10-23,Idaho,16,58083,1139,568,8,369667,3060,56600,950,313067,2110
2020-10-23,Illinois,17,370134,5014,9704,41,7118051,83382,368746,5000,6749305,78382
2020-10-23,Indiana,18,160145,2467,4092,27,1605596,11231,157713,2467,1447883,8764
2020-10-23,Iowa,19,113596,1354,1629,12,852949,4679,106874,1249,746075,3430
2020-10-23,Kansas,20,78122,1576,975,23,616262,10753,76230,1774,540032,8979
2020-10-23,Kentucky,21,96043,1461,1462,23,1777204,19152,93748,1449,1683456,17703
2020-10-23,Louisiana,22,182603,699,5820,21,2671238,20078,182603,699,2488635,19379
2020-10-23,Maine,23,6095,31,146,0,574283,6901,6095,31,568188,6870
2020-10-23,Maryland,24,139185,712,4078,8,1855294,11939,138691,712,1716603,11227
2020-10-23,Massachusetts,25,148285,1070,9830,20,2599364,15863,148285,1070,2451079,14793
2020-10-23,Michigan,26,172128,2026,7485,20,4525886,57023,172122,2046,4353764,54977
2020-10-23,Minnesota,27,129916,1711,2367,13,1734245,11348,129863,1711,1604382,9637
2020-10-23,Mississippi,28,113876,795,3238,7,843420,795,113876,795,729544,0
2020-10-23,Missouri,29,171871,2560,2764,30,1439316,6844,164534,1811,1274782,5033
2020-10-23,Montana,30,26600,864,283,4,461000,8154,26503,863,434497,7291
2020-10-23,Nebraska,31,62511,1226,594,5,559308,4769,61285,977,498023,3792
2020-10-23,Nevada,32,94044,1016,1739,3,780647,6552,93666,813,686981,5739
2020-10-23,New Hampshire,33,10112,118,471,1,326151,2978,10112,118,316039,2860
2020-10-23,New Jersey,34,227219,1045,16273,10,4337985,40373,225430,1045,4112555,39328
2020-10-23,New Mexico,35,40168,791,960,7,1099484,10334,40168,791,1059316,9543
2020-10-23,New York,36,496510,1636,33038,16,13474353,141508,491771,1637,12982582,139871
2020-10-23,North Carolina,37,255534,2116,4140,30,3763315,35640,255708,2716,3507607,32924
2020-10-23,North Dakota,38,35944,887,445,9,279821,2019,36058,896,243763,1123
2020-10-23,Northern Mariana Islands,69,88,0,2,0,15811,0,88,0,15723,0
2020-10-23,Ohio,39,192948,2518,5184,23,4101393,46268,192948,2518,3908445,43750
2020-10-23,Oklahoma,40,113856,1373,1234,13,1511552,20464,113856,1373,1397696,19091
2020-10-23,Oregon,41,41357,532,651,4,815201,9200,41348,538,773853,8662
2020-10-23,Pennsylvania,42,195659,2258,8695,35,2391447,18008,190579,2219,2200868,15789
2020-10-23,Puerto Rico,72,60984,1947,791,8,336928,1152,30956,1152,305972,0
2020-10-23,Rhode Island,44,30118,524,1177,4,412850,4548,30118,524,382732,4024
2020-10-23,South Carolina,45,168549,1064,3777,22,1667501,18150,168549,1064,1498952,17086
2020-10-23,South Dakota,46,37202,1185,356,9,241002,2556,37202,1185,203800,1371
2020-10-23,Tennessee,47,237607,3528,3043,60,3478495,42161,241513,3606,3236982,38555
2020-10-23,Texas,48,899390,7676,17874,114,7930083,78756,851572,6472,7078511,72284
2020-10-23,Utah,49,101574,2011,567,4,984137,8011,101509,1960,882628,6051
2020-10-23,Vermont,50,2016,29,58,0,181287,1165,2029,30,179258,1135
2020-10-23,Virgin Islands,78,1346,3,21,0,23435,181,1346,3,22089,178
2020-10-23,Virginia,51,171284,1180,3539,15,2483341,20599,171284,1180,2312057,19419
2020-10-23,Washington,53,106189,825,2396,7,2300181,19956,104431,785,2195750,19171
2020-10-23,West Virginia,54,21392,335,422,4,710357,5206,21392,335,688965,4871
2020-10-23,Wisconsin,55,200479,4626,1776,46,1944538,18069,200466,4643,1744072,13426
2020-10-23,Wyoming,56,10545,426,68,0,124231,2290,10545,426,113686,1864
2020-10-24,Alabama,01,183276,2360,2866,7,1322198,7424,183276,2360,1138922,5064
2020-10-24,Alaska,02,13439,372,64,0,552746,0,12523,356,540223,-356
2020-10-24,Arizona,04,236898,988,5870,5,1698966,12103,236772,890,1462194,11213
2020-10-24,Arkansas,05,105318,1183,1797,15,1287123,12826,105318,1183,1181805,11643
2020-10-24,California,06,906644,4319,17345,29,17609179,125886,892810,5945,16716369,119941
2020-10-24,Colorado,08,93989,1922,2241,8,1144155,13254,93400,1828,1050755,11426
2020-10-24,Connecticut,09,66052,0,4577,0,2115744,0,66052,0,2049692,0
2020-10-24,Delaware,10,23847,160,680,2,337276,2164,23847,160,313429,2004
2020-10-24,District of Columbia,11,16706,97,642,0,491553,5800,16706,97,474847,5703
2020-10-24,Florida,12,776243,4471,16416,77,5928115,72219,766305,4381,5161810,67838
2020-10-24,Georgia,13,359001,1682,7625,41,3426110,18487,349605,1846,3076505,16641
2020-10-24,Guam,66,5144,34,72,2,63240,334,4175,34,59065,300
2020-10-24,Hawaii,15,14706,89,211,3,309822,140,14669,140,295153,0
2020-10-24,Idaho,16,58964,881,573,5,372818,3151,57673,1073,315145,2078
2020-10-24,Illinois,17,376034,5900,9765,61,7201568,83517,374907,6161,6826661,77356
2020-10-24,Indiana,18,162886,2741,4118,26,1618331,12735,160454,2741,1457877,9994
2020-10-24,Iowa,19,114952,1356,1634,5,859419,6470,108514,1640,750905,4830
2020-10-24,Kansas,20,78177,55,975,0,616262,0,76230,0,540032,0
2020-10-24,Kentucky,21,97501,1458,1469,7,1799931,22727,95480,1732,1704451,20995
2020-10-24,Louisiana,22,182603,0,5820,0,2671238,0,182603,0,2488635,0
2020-10-24,Maine,23,6137,42,146,0,574325,42,6137,42,568188,0
2020-10-24,Maryland,24,139859,674,4091,13,1866927,11633,139487,796,1727440,10837
2020-10-24,Massachusetts,25,149488,1203,9839,9,2618607,19243,149488,1203,2469119,18040
2020-10-24,Michigan,26,175385,3257,7522,37,4579991,54105,175612,3490,4404379,50615
2020-10-24,Minnesota,27,132175,2259,2381,14,1744115,9870,132122,2259,1611993,7611
2020-10-24,Mississippi,28,115088,1212,3255,17,844632,1212,115088,1212,729544,0
2020-10-24,Missouri,29,173746,1875,2854,90,1450015,10699,167452,2918,1282563,7781
2020-10-24,Montana,30,27149,549,295,12,464032,3032,27142,639,436890,2393
2020-10-24,Nebraska,31,63215,704,603,9,564275,4967,62510,1225,501765,3742
2020-10-24,Nevada,32,94935,891,1746,7,783707,3060,94812,1146,688895,1914
2020-10-24,New Hampshire,33,10238,126,473,2,329057,2906,10238,126,318819,2780
2020-10-24,New Jersey,34,229128,1909,16281,8,4339894,1909,227339,1909,4112555,0
2020-10-24,New Mexico,35,41040,872,965,5,1109095,9611,41040,872,1068055,8739
2020-10-24,New York,36,498568,2058,33049,11,13631293,156940,493832,2061,13137461,154879
2020-10-24,North Carolina,37,258439,2905,4170,30,3809077,45762,258292,2584,3550785,43178
2020-10-24,North Dakota,38,36879,935,453,8,281819,1998,37025,967,244794,1031
2020-10-24,Northern Mariana Islands,69,88,0,2,0,15811,0,88,0,15723,0
2020-10-24,Ohio,39,195806,2858,5206,22,4149769,48376,195806,2858,3953963,45518
2020-10-24,Oklahoma,40,115685,1829,1245,11,1532709,21157,115685,1829,1417024,19328
2020-10-24,Oregon,41,41739,382,654,3,821142,5941,41739,391,779403,5550
2020-10-24,Pennsylvania,42,197370,1711,8721,26,2407679,16232,192622,2043,2215057,14189
2020-10-24,Puerto Rico,72,61280,296,794,3,337044,116,31072,116,305972,0
2020-10-24,Rhode Island,44,30118,0,1177,0,416075,3225,30583,465,385492,2760
2020-10-24,South Carolina,45,169341,792,3793,16,1679084,11583,169341,792,1509743,10791
2020-10-24,South Dakota,46,38141,939,366,10,243680,2678,38141,939,205539,1739
2020-10-24,Tennessee,47,240191,2584,3067,24,3505140,26645,244087,2574,3261053,24071
2020-10-24,Texas,48,906657,7267,17998,124,7999540,69457,858071,6499,7141469,62958
2020-10-24,Utah,49,103137,1563,568,1,992734,8597,103117,1608,889617,6989
2020-10-24,Vermont,50,2043,27,58,0,182928,1641,2057,28,180871,1613
2020-10-24,Virgin Islands,78,1346,0,21,0,23435,0,1346,0,22089,0
2020-10-24,Virginia,51,172372,1088,3578,39,2500546,17205,172372,1088,2328174,16117
2020-10-24,Washington,53,106772,583,2396,0,2322866,22685,105280,849,2217586,21836
2020-10-24,West Virginia,54,21712,320,422,0,715690,5333,21712,320,693978,5013
2020-10-24,Wisconsin,55,205139,4660,1804,28,1962769,18231,205139,4673,1757630,13558
2020-10-24,Wyoming,56,10805,260,68,0,124491,260,10805,260,113686,0
2020-10-25,Alabama,01,184355,1079,2866,0,1329140,6942,184355,1079,1144785,5863
2020-10-25,Alaska,02,13968,529,64,0,559969,7223,13041,518,546928,6705
2020-10-25,Arizona,04,238200,1302,5874,4,1711869,12903,238163,1391,1473706,11512
2020-10-25,Arkansas,05,106115,797,1812,15,1295235,8112,106115,797,1189120,7315
2020-10-25,California,06,909344,2700,17358,13,17787885,178706,898029,5219,16889856,173487
2020-10-25,Colorado,08,95742,1753,2244,3,1156234,12079,95089,1689,1061145,10390
2020-10-25,Connecticut,09,66052,0,4577,0,2115744,0,66052,0,2049692,0
2020-10-25,Delaware,10,23961,114,681,1,339341,2065,23961,114,315380,1951
2020-10-25,District of Columbia,11,16767,61,642,0,496232,4679,16767,61,479465,4618
2020-10-25,Florida,12,778628,2385,16428,12,5942740,14625,768653,2348,5174087,12277
2020-10-25,Georgia,13,360344,1343,7626,1,3445032,18922,350923,1318,3094109,17604
2020-10-25,Guam,66,5185,41,72,0,63494,254,4216,41,59278,213
2020-10-25,Hawaii,15,14823,117,211,0,309911,89,14758,89,295153,0
2020-10-25,Idaho,16,59344,380,574,1,375527,2709,58694,1021,316833,1688
2020-10-25,Illinois,17,380065,4031,9788,23,7273665,72097,378969,4062,6894696,68035
2020-10-25,Indiana,18,165038,2152,4130,12,1629468,11137,162607,2153,1466861,8984
2020-10-25,Iowa,19,116238,1286,1635,1,863361,3942,109657,1143,753704,2799
2020-10-25,Kansas,20,78241,64,975,0,616262,0,76230,0,540032,0
2020-10-25,Kentucky,21,98730,1229,1472,3,1801393,1462,96942,1462,1704451,0
2020-10-25,Louisiana,22,183575,972,5837,17,2697507,26269,183575,972,2513932,25297
2020-10-25,Maine,23,6201,64,146,0,574389,64,6201,64,568188,0
2020-10-25,Maryland,24,140770,911,4096,5,1878929,12002,140279,792,1738650,11210
2020-10-25,Massachusetts,25,150565,1077,9864,25,2635607,17000,150565,1077,2485042,15923
2020-10-25,Michigan,26,175515,130,7522,0,4579991,0,175612,0,4404379,0
2020-10-25,Minnesota,27,133855,1680,2402,21,1770733,26618,133802,1680,1636931,24938
2020-10-25,Mississippi,28,115088,0,3255,0,844632,0,115088,0,729544,0
2020-10-25,Missouri,29,175243,1497,2857,3,1458840,8825,169495,2043,1289345,6782
2020-10-25,Montana,30,27880,731,298,3,465607,1575,27880,738,437727,837
2020-10-25,Nebraska,31,63797,582,604,1,567426,3151,63215,705,504211,2446
2020-10-25,Nevada,32,95798,863,1748,2,787869,4162,95703,891,692166,3271
2020-10-25,New Hampshire,33,10328,90,473,0,331561,2504,10328,90,321233,2414
2020-10-25,New Jersey,34,230257,1129,16285,4,4385882,45988,228468,1129,4157414,44859
2020-10-25,New Mexico,35,41863,823,967,2,1118844,9749,41863,823,1076981,8926
2020-10-25,New York,36,500201,1633,33059,10,13752123,120830,495464,1632,13256659,119198
2020-10-25,North Carolina,37,260128,1689,4183,13,3844453,35376,260099,1807,3584354,33569
2020-10-25,North Dakota,38,37724,845,461,8,283565,1746,37874,849,245691,897
2020-10-25,Northern Mariana Islands,69,88,0,2,0,15811,0,88,0,15723,0
2020-10-25,Ohio,39,198115,2309,5206,0,4199457,49688,198115,2309,4001342,47379
2020-10-25,Oklahoma,40,116736,1051,1249,4,1533760,1051,116736,1051,1417024,0
2020-10-25,Oregon,41,42101,362,654,0,825250,4108,42101,362,783149,3746
2020-10-25,Pennsylvania,42,198756,1386,8730,9,2424265,16586,194288,1666,2229977,14920
2020-10-25,Puerto Rico,72,62503,1223,801,7,337709,665,31737,665,305972,0
2020-10-25,Rhode Island,44,30118,0,1177,0,418420,2345,30857,274,387563,2071
2020-10-25,South Carolina,45,170678,1337,3802,9,1706414,27330,170678,1337,1535736,25993
2020-10-25,South Dakota,46,39203,1062,375,9,245930,2250,39203,1062,206727,1188
2020-10-25,Tennessee,47,243508,3317,3105,38,3546736,41596,247587,3500,3299149,38096
2020-10-25,Texas,48,910592,3935,18042,44,8036693,37153,862375,4304,7174318,32849
2020-10-25,Utah,49,105053,1916,572,4,1001239,8505,104882,1765,896357,6740
2020-10-25,Vermont,50,2073,30,58,0,183729,801,2087,30,181642,771
2020-10-25,Virgin Islands,78,1346,0,21,0,23435,0,1346,0,22089,0
2020-10-25,Virginia,51,173371,999,3579,1,2521816,21270,173371,999,2348445,20271
2020-10-25,Washington,53,107270,498,2396,0,2363589,40723,106115,835,2257474,39888
2020-10-25,West Virginia,54,21906,194,423,1,723207,7517,21906,194,701301,7323
2020-10-25,Wisconsin,55,208917,3778,1814,10,1976943,14174,208917,3778,1768026,10396
2020-10-25,Wyoming,56,11041,236,68,0,124727,236,11041,236,113686,0
2020-10-26,Alabama,01,185322,967,2866,0,1334315,5175,185322,967,1148993,4208
2020-10-26,Alaska,02,14316,348,64,0,570844,10875,13391,350,557453,10525
2020-10-26,Arizona,04,239193,993,5875,1,1720285,8416,238964,801,1481321,7615
2020-10-26,Arkansas,05,106727,612,1833,21,1302162,6927,106727,612,1195435,6315
2020-10-26,California,06,913699,4355,17398,40,17982829,194944,901010,2981,17081819,191963
2020-10-26,Colorado,08,97686,1944,2255,11,1175350,19116,97300,2211,1078050,16905
2020-10-26,Connecticut,09,68099,2047,4589,12,2207937,92193,68099,2047,2139838,90146
2020-10-26,Delaware,10,24168,207,685,4,342071,2730,24168,207,317903,2523
2020-10-26,District of Columbia,11,16812,45,642,0,498190,1958,16812,45,481378,1913
2020-10-26,Florida,12,782005,3377,16448,20,5974725,31985,771989,3336,5202736,28649
2020-10-26,Georgia,13,364275,3931,7644,18,3461388,16356,351881,958,3109507,15398
2020-10-26,Guam,66,5305,120,76,4,64454,960,4336,120,60118,840
2020-10-26,Hawaii,15,14858,35,211,0,310030,119,14877,119,295153,0
2020-10-26,Idaho,16,60400,1056,582,8,377823,2296,59344,650,318479,1646
2020-10-26,Illinois,17,385084,5019,9811,23,7330929,57264,383698,4729,6947231,52535
2020-10-26,Indiana,18,167010,1972,4143,13,1638232,8764,164581,1974,1473651,6790
2020-10-26,Iowa,19,117198,960,1657,22,866323,2962,110404,747,755919,2215
2020-10-26,Kansas,20,80473,2232,976,1,625931,9669,78676,2446,547255,7223
2020-10-26,Kentucky,21,99965,1235,1480,8,1824845,23452,97866,924,1726979,22528
2020-10-26,Louisiana,22,183802,227,5854,17,2702566,5059,183802,227,2518764,4832
2020-10-26,Maine,23,6254,53,146,0,588653,14264,6254,53,582399,14211
2020-10-26,Maryland,24,141334,564,4099,3,1888371,9442,140844,565,1747527,8877
2020-10-26,Massachusetts,25,151777,1212,9881,17,2655689,20082,151777,1212,2503912,18870
2020-10-26,Michigan,26,179624,4109,7551,29,4652388,72397,179669,4057,4472719,68340
2020-10-26,Minnesota,27,135425,1570,2406,4,1784312,13579,135372,1570,1648940,12009
2020-10-26,Mississippi,28,115763,675,3263,8,845307,675,115763,675,729544,0
2020-10-26,Missouri,29,177733,2490,2869,12,1465949,7109,171022,1527,1294927,5582
2020-10-26,Montana,30,28580,700,304,6,476325,10718,28501,621,447824,10097
2020-10-26,Nebraska,31,64506,709,609,5,569834,2408,63797,582,506037,1826
2020-10-26,Nevada,32,96330,532,1751,3,791321,3452,96178,475,695143,2977
2020-10-26,New Hampshire,33,10397,69,475,2,333115,1554,10397,69,322718,1485
2020-10-26,New Jersey,34,231473,1216,16292,7,4455234,69352,229684,1216,4225550,68136
2020-10-26,New Mexico,35,42586,723,976,9,1124922,6078,42586,723,1082336,5355
2020-10-26,New York,36,501393,1192,33073,14,13834240,82117,496655,1191,13337585,80926
2020-10-26,North Carolina,37,262159,2031,4200,17,3872913,28460,261742,1643,3611171,26817
2020-10-26,North Dakota,38,38246,522,466,5,284643,1078,38406,532,246237,546
2020-10-26,Northern Mariana Islands,69,92,4,2,0,15815,4,92,4,15723,0
2020-10-26,Ohio,39,200231,2116,5217,11,4235663,36206,200231,2116,4035432,34090
2020-10-26,Oklahoma,40,117399,663,1251,2,1534423,663,117399,663,1417024,0
2020-10-26,Oregon,41,42454,353,657,3,830284,5034,42436,335,787848,4699
2020-10-26,Pennsylvania,42,201248,2492,8737,7,2437125,12860,195695,1407,2241430,11453
2020-10-26,Puerto Rico,72,63135,632,804,3,338170,461,32198,461,305972,0
2020-10-26,Rhode Island,44,31024,906,1184,7,419892,1472,31024,167,388868,1305
2020-10-26,South Carolina,45,171501,823,3823,21,1733232,26818,171501,823,1561731,25995
2020-10-26,South Dakota,46,39741,538,375,0,247094,1164,39741,538,207353,626
2020-10-26,Tennessee,47,245760,2252,3132,27,3569435,22699,249866,2279,3319569,20420
2020-10-26,Texas,48,917240,6648,18077,35,8063288,26595,867075,4700,7196213,21895
2020-10-26,Utah,49,106083,1030,575,3,1006802,5563,106083,1201,900719,4362
2020-10-26,Vermont,50,2083,10,58,0,184153,424,2096,9,182057,415
2020-10-26,Virgin Islands,78,1348,2,21,0,23617,182,1348,2,22269,180
2020-10-26,Virginia,51,174275,904,3581,2,2537269,15453,174275,904,2362994,14549
2020-10-26,Washington,53,108393,1123,2428,32,2364178,589,106704,589,2257474,0
2020-10-26,West Virginia,54,22223,317,424,1,736376,13169,22223,317,714153,12852
2020-10-26,Wisconsin,55,212116,3199,1825,11,1989820,12877,211928,3011,1777892,9866
2020-10-26,Wyoming,56,11477,436,77,9,125163,436,11477,436,113686,0
2020-10-27,Alabama,01,186437,1115,2892,26,1339885,5570,186437,1115,1153448,4455
2020-10-27,Alaska,02,14699,383,66,2,577429,6585,13779,388,563650,6197
2020-10-27,Arizona,04,240158,965,5891,16,1730162,9877,240122,1158,1490040,8719
2020-10-27,Arkansas,05,107679,952,1857,24,1310854,8692,107679,952,1203175,7740
2020-10-27,California,06,918627,4928,17478,80,18127049,144220,904198,3188,17222851,141032
2020-10-27,Colorado,08,99111,1425,2265,10,1183754,8404,98733,1433,1085021,6971
2020-10-27,Connecticut,09,68637,538,4595,6,2221034,13097,68637,538,2152397,12559
2020-10-27,Delaware,10,24249,81,686,1,343141,1070,24249,81,318892,989
2020-10-27,District of Columbia,11,16906,94,644,2,502538,4348,16906,94,485632,4254
2020-10-27,Florida,12,786303,4298,16504,56,5991638,16913,776215,4226,5215423,12687
2020-10-27,Georgia,13,365498,1223,7661,17,3474891,13503,353372,1491,3121519,12012
2020-10-27,Guam,66,5387,82,76,0,65045,591,4418,82,60627,509
2020-10-27,Hawaii,15,14920,62,214,3,310067,37,14914,37,295153,0
2020-10-27,Idaho,16,61282,882,588,6,380532,2709,60041,697,320491,2012
2020-10-27,Illinois,17,389088,4004,9860,49,7393003,62074,387698,4000,7005305,58074
2020-10-27,Indiana,18,168996,1986,4194,51,1646542,8310,166564,1983,1479978,6327
2020-10-27,Iowa,19,118852,1654,1680,23,869020,2697,111261,857,757759,1840
2020-10-27,Kansas,20,80761,288,979,3,625931,0,78676,0,547255,0
2020-10-27,Kentucky,21,101700,1735,1493,13,1836688,11843,99637,1771,1737051,10072
2020-10-27,Louisiana,22,184724,922,5872,18,2723277,20711,184724,922,2538553,19789
2020-10-27,Maine,23,6311,57,146,0,595786,7133,6311,57,589475,7076
2020-10-27,Maryland,24,142237,903,4108,9,1898094,9723,141741,897,1756353,8826
2020-10-27,Massachusetts,25,153037,1260,9888,7,2669651,13962,153037,1260,2516614,12702
2020-10-27,Michigan,26,182284,2660,7585,34,4693470,41082,182344,2675,4511126,38407
2020-10-27,Minnesota,27,137589,2164,2421,15,1792078,7766,137536,2164,1654542,5602
2020-10-27,Mississippi,28,116617,854,3283,20,846161,854,116617,854,729544,0
2020-10-27,Missouri,29,179457,1724,2912,43,1474405,8456,172717,1695,1301688,6761
2020-10-27,Montana,30,29422,842,309,5,481322,4997,29346,845,451976,4152
2020-10-27,Nebraska,31,65376,870,623,14,572760,2926,64499,702,508261,2224
2020-10-27,Nevada,32,97138,808,1757,6,794921,3600,96908,730,698013,2870
2020-10-27,New Hampshire,33,10530,133,475,0,334409,1294,10531,134,323878,1160
2020-10-27,New Jersey,34,233120,1647,16306,14,4484813,29579,231331,1647,4253482,27932
2020-10-27,New Mexico,35,43169,583,980,4,1129419,4497,43169,583,1086250,3914
2020-10-27,New York,36,503387,1994,33092,19,13945858,111618,498646,1991,13447212,109627
2020-10-27,North Carolina,37,264334,2175,4236,36,3890764,17851,263883,2141,3626881,15710
2020-10-27,North Dakota,38,39135,889,481,15,286375,1732,39309,903,247066,829
2020-10-27,Northern Mariana Islands,69,92,0,2,0,16085,270,92,0,15993,270
2020-10-27,Ohio,39,202740,2509,5239,22,4282604,46941,202740,2509,4079864,44432
2020-10-27,Oklahoma,40,118409,1010,1273,22,1564476,30053,118409,1010,1446067,29043
2020-10-27,Oregon,41,42821,367,665,8,836995,6711,42808,372,794187,6339
2020-10-27,Pennsylvania,42,203520,2272,8760,23,2452969,15844,198446,2751,2254523,13093
2020-10-27,Puerto Rico,72,63497,362,808,4,338433,263,32461,263,305972,0
2020-10-27,Rhode Island,44,31445,421,1188,4,423469,3577,31445,421,392024,3156
2020-10-27,South Carolina,45,172579,1078,3842,19,1745026,11794,172579,1078,1572447,10716
2020-10-27,South Dakota,46,40730,989,375,0,249165,2071,40730,989,208435,1082
2020-10-27,Tennessee,47,247688,1928,3176,44,3586241,16806,251774,1908,3334467,14898
2020-10-27,Texas,48,924475,7235,18155,78,8150614,87326,874367,7292,7276247,80034
2020-10-27,Utah,49,107246,1163,579,4,1013395,6593,107228,1145,906167,5448
2020-10-27,Vermont,50,2113,30,58,0,185042,889,2127,31,182915,858
2020-10-27,Virgin Islands,78,1351,3,21,0,23659,42,1351,3,22308,39
2020-10-27,Virginia,51,175409,1134,3600,19,2555585,18316,175409,1134,2380176,17182
2020-10-27,Washington,53,108966,573,2438,10,2376148,11970,107052,348,2269096,11622
2020-10-27,West Virginia,54,22706,483,432,8,743737,7361,22706,483,721031,6878
2020-10-27,Wisconsin,55,217447,5331,1896,71,2006587,16767,217429,5501,1789158,11266
2020-10-27,Wyoming,56,11806,329,77,0,125492,329,11806,329,113686,0
2020-10-28,Alabama,01,187706,1269,2911,19,1347632,7747,187706,1269,1159926,6478
2020-10-28,Alaska,02,15053,354,67,1,580599,3170,14131,352,566468,2818
2020-10-28,Arizona,04,241259,1101,5906,15,1736979,6817,241165,1043,1495814,5774
2020-10-28,Arkansas,05,108640,961,1875,18,1320831,9977,108640,961,1212191,9016
2020-10-28,California,06,922680,4053,17541,63,18223596,96547,908713,4515,17314883,92032
2020-10-28,Colorado,08,100614,1503,2277,12,1191858,8104,100208,1475,1091650,6629
2020-10-28,Connecticut,09,69127,490,4604,9,2235373,14339,69127,490,2166246,13849
2020-10-28,Delaware,10,24392,143,688,2,344939,1798,24392,143,320547,1655
2020-10-28,District of Columbia,11,16973,67,644,0,505407,2869,16973,67,488434,2802
2020-10-28,Florida,12,790418,4115,16570,66,6030177,38539,780220,4005,5249957,34534
2020-10-28,Georgia,13,367126,1628,7692,31,3495407,20516,355025,1653,3140382,18863
2020-10-28,Guam,66,5435,48,77,1,65664,619,4466,48,61198,571
2020-10-28,Hawaii,15,14975,55,212,-2,310131,64,14978,64,295153,0
2020-10-28,Idaho,16,62197,915,600,12,382784,2252,60923,882,321861,1370
2020-10-28,Illinois,17,395204,6116,9912,52,7463755,70752,393808,6110,7069947,64642
2020-10-28,Indiana,18,171566,2570,4227,33,1657090,10548,169112,2548,1487978,8000
2020-10-28,Iowa,19,120911,2059,1691,11,873362,4342,113042,1781,760320,2561
2020-10-28,Kansas,20,83485,2724,1007,28,633033,7102,82045,3369,550988,3733
2020-10-28,Kentucky,21,103685,1985,1509,16,1847286,10598,101494,1857,1745792,8741
2020-10-28,Louisiana,22,185822,1098,5890,18,2738401,15124,185822,1098,2552579,14026
2020-10-28,Maine,23,6387,76,146,0,603303,7517,6387,76,596916,7441
2020-10-28,Maryland,24,142918,681,4115,7,1905952,7858,142425,684,1763527,7174
2020-10-28,Massachusetts,25,154218,1181,9924,36,2688340,18689,154218,1181,2534122,17508
2020-10-28,Michigan,26,185818,3534,7606,21,4748002,54532,185934,3590,4562068,50942
2020-10-28,Minnesota,27,139497,1908,2440,19,1801504,9426,139444,1908,1662060,7518
2020-10-28,Mississippi,28,117617,1000,3302,19,881604,35443,117617,1000,763987,34443
2020-10-28,Missouri,29,181877,2420,2940,28,1481236,6831,174632,1915,1306604,4916
2020-10-28,Montana,30,30051,629,326,17,484470,3148,29966,620,454504,2528
2020-10-28,Nebraska,31,66545,1169,629,6,577023,4263,65376,877,511647,3386
2020-10-28,Nevada,32,97824,686,1767,10,798250,3329,97479,571,700771,2758
2020-10-28,New Hampshire,33,10641,111,478,3,336063,1654,10641,110,325422,1544
2020-10-28,New Jersey,34,234790,1670,16324,18,4523611,38798,232997,1666,4290614,37132
2020-10-28,New Mexico,35,43826,657,991,11,1141186,11767,43826,657,1097360,11110
2020-10-28,New York,36,505416,2029,33107,15,14075518,129660,500677,2031,13574841,127629
2020-10-28,North Carolina,37,266566,2232,4275,39,3923042,32278,266136,2253,3656906,30025
2020-10-28,North Dakota,38,39912,777,493,12,287744,1369,40127,818,247617,551
2020-10-28,Northern Mariana Islands,69,92,0,2,0,16085,0,92,0,15993,0
2020-10-28,Ohio,39,205347,2607,5256,17,4314037,31433,205347,2607,4108690,28826
2020-10-28,Oklahoma,40,119152,743,1286,13,1575866,11390,119152,743,1456714,10647
2020-10-28,Oregon,41,43228,407,673,8,841049,4054,43228,420,797821,3634
2020-10-28,Pennsylvania,42,205852,2332,8789,29,2469920,16951,200674,2228,2269246,14723
2020-10-28,Puerto Rico,72,63587,90,813,5,338499,66,32527,66,305972,0
2020-10-28,Rhode Island,44,31944,499,1192,4,426355,2886,31944,499,394411,2387
2020-10-28,South Carolina,45,173491,912,3876,34,1753781,8755,173491,912,1580290,7843
2020-10-28,South Dakota,46,42000,1270,384,9,251296,2131,42000,1270,209296,861
2020-10-28,Tennessee,47,250269,2581,3209,33,3608613,22372,254220,2446,3354393,19926
2020-10-28,Texas,48,932245,7770,18251,96,8237976,87362,879994,5627,7357982,81735
2020-10-28,Utah,49,108863,1617,588,9,1019962,6567,108803,1575,911159,4992
2020-10-28,Vermont,50,2120,7,58,0,185577,535,2138,11,183439,524
2020-10-28,Virgin Islands,78,1353,2,21,0,23945,286,1353,2,22592,284
2020-10-28,Virginia,51,176754,1345,3616,16,2575759,20174,176754,1345,2399005,18829
2020-10-28,Washington,53,109865,899,2454,16,2366753,-9395,108185,1133,2258568,-10528
2020-10-28,West Virginia,54,23064,358,436,4,748959,5222,23064,358,725895,4864
2020-10-28,Wisconsin,55,221578,4131,1953,57,2016720,10133,221559,4130,1795161,6003
2020-10-28,Wyoming,56,12146,340,77,0,125832,340,12146,340,113686,0
2020-10-29,Alabama,01,189149,1443,2914,3,1355047,7415,189149,1443,1165898,5972
2020-10-29,Alaska,02,15417,364,72,5,584268,3669,14481,350,569787,3319
2020-10-29,Arizona,04,242510,1251,5920,14,1751307,14328,242480,1315,1508827,13013
2020-10-29,Arkansas,05,109712,1072,1894,19,1333414,12583,109712,1072,1223702,11511
2020-10-29,California,06,926893,4213,17567,26,18323771,100175,912904,4191,17410867,95984
2020-10-29,Colorado,08,102665,2051,2295,18,1203209,11351,102014,1806,1101195,9545
2020-10-29,Connecticut,09,70446,1319,4609,5,2257892,22519,70446,1319,2187446,21200
2020-10-29,Delaware,10,24553,161,689,1,346423,1484,24553,161,321870,1323
2020-10-29,District of Columbia,11,17074,101,645,1,509864,4457,17074,101,492790,4356
2020-10-29,Florida,12,794616,4198,16647,77,6068498,38321,784331,4111,5284167,34210
2020-10-29,Georgia,13,368840,1714,7737,45,3516162,20755,356848,1823,3159314,18932
2020-10-29,Guam,66,5518,83,79,2,66385,721,4549,83,61836,638
2020-10-29,Hawaii,15,15046,71,214,2,310192,61,15039,61,295153,0
2020-10-29,Idaho,16,63195,998,618,18,385806,3022,61785,862,324021,2160
2020-10-29,Illinois,17,401622,6418,9963,51,7546811,83056,400171,6363,7146640,76693
2020-10-29,Indiana,18,175190,3624,4260,33,1671093,14003,172730,3618,1498363,10385
2020-10-29,Iowa,19,123232,2321,1705,14,878864,5502,114982,1940,763882,3562
2020-10-29,Kansas,20,83838,353,1008,1,633033,0,82045,0,550988,0
2020-10-29,Kentucky,21,105517,1832,1524,15,1857453,10167,103305,1811,1754148,8356
2020-10-29,Louisiana,22,186216,394,5908,18,2751797,13396,186216,394,2565581,13002
2020-10-29,Maine,23,6467,80,146,0,611912,8609,6467,80,605445,8529
2020-10-29,Maryland,24,143875,957,4127,12,1916848,10896,143387,962,1773461,9934
2020-10-29,Massachusetts,25,155564,1346,9951,27,2706776,18436,155564,1346,2551212,17090
2020-10-29,Michigan,26,189926,4108,7651,45,4800717,52715,190043,4109,4610674,48606
2020-10-29,Minnesota,27,142364,2867,2472,32,1820395,18891,142311,2867,1678084,16024
2020-10-29,Mississippi,28,118587,970,3310,8,922851,41247,118587,970,804264,40277
2020-10-29,Missouri,29,184847,2970,2978,38,1490617,9381,177693,3061,1312924,6320
2020-10-29,Montana,30,30932,881,339,13,487607,3137,30853,887,456754,2250
2020-10-29,Nebraska,31,68150,1605,641,12,580729,3706,66545,1169,514184,2537
2020-10-29,Nevada,32,98814,990,1770,3,798618,368,98554,1075,700064,-707
2020-10-29,New Hampshire,33,10768,127,482,4,338508,2445,10768,127,327740,2318
2020-10-29,New Jersey,34,236340,1550,16332,8,4572531,48920,234547,1550,4337984,47370
2020-10-29,New Mexico,35,44904,1078,994,3,1153185,11999,44904,1078,1108281,10921
2020-10-29,New York,36,507913,2497,33128,21,14243871,168353,503176,2499,13740695,165854
2020-10-29,North Carolina,37,269419,2853,4307,32,3961343,38301,269021,2885,3692322,35416
2020-10-29,North Dakota,38,41135,1223,504,11,289745,2001,41355,1228,248390,773
2020-10-29,Northern Mariana Islands,69,92,0,2,0,16085,0,92,0,15993,0
2020-10-29,Ohio,39,208937,3590,5275,19,4365090,51053,208937,3590,4156153,47463
2020-10-29,Oklahoma,40,120193,1041,1306,20,1586185,10319,120193,1041,1465992,9278
2020-10-29,Oregon,41,43793,565,674,1,848795,7746,43793,565,805002,7181
2020-10-29,Pennsylvania,42,208087,2235,8828,39,2485704,15784,202876,2202,2282828,13582
2020-10-29,Puerto Rico,72,64798,1211,814,1,339251,752,33279,752,305972,0
2020-10-29,Rhode Island,44,32312,368,1195,3,429340,2985,32312,368,397028,2617
2020-10-29,South Carolina,45,174591,1100,3889,13,1773742,19961,174591,1100,1599151,18861
2020-10-29,South Dakota,46,43000,1000,403,19,253514,2218,43000,1000,210514,1218
2020-10-29,Tennessee,47,252727,2458,3229,20,3637643,29030,256880,2660,3380763,26370
2020-10-29,Texas,48,939355,7110,18372,121,8318780,80804,886820,6826,7431960,73978
2020-10-29,Utah,49,110666,1803,598,10,1029872,9910,110640,1837,919232,8073
2020-10-29,Vermont,50,2141,21,58,0,186570,993,2154,16,184416,977
2020-10-29,Virgin Islands,78,1353,0,21,0,23945,0,1353,0,22592,0
2020-10-29,Virginia,51,178183,1429,3636,20,2596604,20845,178183,1429,2418421,19416
2020-10-29,Washington,53,110748,883,2463,9,2387849,21096,109260,1075,2278589,20021
2020-10-29,West Virginia,54,23466,402,443,7,759646,10687,23466,402,736180,10285
2020-10-29,Wisconsin,55,226712,5134,2008,55,2030170,13450,226705,5146,1803465,8304
2020-10-29,Wyoming,56,12507,361,87,10,129462,3630,12507,361,116955,3269
2020-10-30,Alabama,01,190496,1347,2932,18,1363465,8418,190496,1347,1172969,7071
2020-10-30,Alaska,02,15803,386,76,4,586323,2055,14858,377,571465,1678
2020-10-30,Arizona,04,244099,1589,5934,14,1764784,13477,244045,1565,1520739,11912
2020-10-30,Arkansas,05,110874,1162,1900,6,1345040,11626,110874,1162,1234166,10464
2020-10-30,California,06,931826,4933,17627,60,18444523,120752,916918,4014,17527605,116738
2020-10-30,Colorado,08,104927,2262,2302,7,1214467,11258,104426,2412,1110041,8846
2020-10-30,Connecticut,09,71207,761,4616,7,2288584,30692,71207,761,2217377,29931
2020-10-30,Delaware,10,24751,198,704,15,348527,2104,24751,198,323776,1906
2020-10-30,District of Columbia,11,17144,70,646,1,514130,4266,17144,70,496986,4196
2020-10-30,Florida,12,800208,5592,16719,72,6073881,5383,789714,5383,5284167,0
2020-10-30,Georgia,13,370157,1317,7768,31,3559307,43145,358225,1377,3201082,41768
2020-10-30,Guam,66,5597,79,80,1,67029,644,4628,79,62401,565
2020-10-30,Hawaii,15,15145,99,215,1,310269,77,15116,77,295153,0
2020-10-30,Idaho,16,64175,980,627,9,388785,2979,62746,961,326039,2018
2020-10-30,Illinois,17,410141,8519,10012,49,7643468,96657,408660,8489,7234808,88168
2020-10-30,Indiana,18,178372,3182,4286,26,1684783,13690,175893,3163,1508890,10527
2020-10-30,Iowa,19,125973,2741,1714,9,884252,5388,117185,2203,767067,3185
2020-10-30,Kansas,20,86768,2930,1029,21,642782,9749,85181,3136,557601,6613
2020-10-30,Kentucky,21,107620,2103,1543,19,1892860,35407,105242,1937,1787618,33470
2020-10-30,Louisiana,22,186649,433,5919,11,2763671,11874,186649,433,2577022,11441
2020-10-30,Maine,23,6570,103,146,0,623413,11501,6570,103,616843,11398
2020-10-30,Maryland,24,144800,925,4137,10,1926518,9670,144314,927,1782204,8743
2020-10-30,Massachusetts,25,157146,1582,9975,24,2727118,20342,157146,1582,2569972,18760
2020-10-30,Michigan,26,193360,3434,7664,13,4862083,61366,193388,3345,4668695,58021
2020-10-30,Minnesota,27,145519,3155,2491,19,1836799,16404,145465,3154,1691334,13250
2020-10-30,Mississippi,28,119336,749,3328,18,923600,749,119336,749,804264,0
2020-10-30,Missouri,29,187830,2983,3014,36,1499282,8665,180200,2507,1319082,6158
2020-10-30,Montana,30,31995,1063,368,29,492629,5022,31916,1063,460713,3959
2020-10-30,Nebraska,31,69645,1495,646,5,586098,5369,68150,1605,517948,3764
2020-10-30,Nevada,32,100038,1224,1777,7,803585,4967,99786,1232,703799,3735
2020-10-30,New Hampshire,33,10884,116,482,0,338696,188,10884,116,327812,72
2020-10-30,New Jersey,34,238316,1976,16339,7,4574507,1976,236523,1976,4337984,0
2020-10-30,New Mexico,35,45909,1005,1007,13,1161887,8702,45909,1005,1115978,7697
2020-10-30,New York,36,510171,2258,33143,15,14390756,146885,505431,2255,13885325,144630
2020-10-30,North Carolina,37,272231,2812,4354,47,4005791,44448,271830,2809,3733961,41639
2020-10-30,North Dakota,38,42488,1353,517,13,292188,2443,42733,1378,249455,1065
2020-10-30,Northern Mariana Islands,69,92,0,2,0,16085,0,92,0,15993,0
2020-10-30,Ohio,39,212782,3845,5291,16,4413936,48846,212782,3845,4201154,45001
2020-10-30,Oklahoma,40,121495,1302,1326,20,1601775,15590,121495,1302,1480280,14288
2020-10-30,Oregon,41,44388,595,677,3,854938,6143,44389,596,810549,5547
2020-10-30,Pennsylvania,42,210586,2499,8860,32,2503500,17796,205517,2641,2297983,15155
2020-10-30,Puerto Rico,72,65743,945,820,6,339825,574,33853,574,305972,0
2020-10-30,Rhode Island,44,32874,562,1201,6,432876,3536,32874,562,400002,2974
2020-10-30,South Carolina,45,175594,1003,3896,7,1788360,14618,175594,1003,1612766,13615
2020-10-30,South Dakota,46,44559,1559,415,12,256656,3142,44559,1559,212097,1583
2020-10-30,Tennessee,47,255332,2605,3307,78,3662089,24446,259488,2608,3402601,21838
2020-10-30,Texas,48,946023,6668,18477,105,8400469,81689,893451,6631,7507018,75058
2020-10-30,Utah,49,112932,2266,601,3,1039515,9643,112932,2292,926583,7351
2020-10-30,Vermont,50,2155,14,58,0,187145,575,2173,19,184972,556
2020-10-30,Virgin Islands,78,1362,9,21,0,24219,274,1362,9,22857,265
2020-10-30,Virginia,51,179639,1456,3643,7,2619752,23148,179639,1456,2440113,21692
2020-10-30,Washington,53,111893,1145,2468,5,2410157,22308,110362,1102,2299795,21206
2020-10-30,West Virginia,54,23990,524,451,8,769302,9656,23990,524,745312,9132
2020-10-30,Wisconsin,55,232092,5380,2034,26,2049123,18953,232062,5357,1817061,13596
2020-10-30,Wyoming,56,13028,521,87,0,129983,521,13028,521,116955,0
2020-10-31,Alabama,01,192285,1789,2967,35,1374243,10778,192285,1789,1181958,8989
2020-10-31,Alaska,02,16247,444,77,1,604207,17884,15312,454,588895,17430
2020-10-31,Arizona,04,245962,1863,5979,45,1777369,12585,245946,1901,1531423,10684
2020-10-31,Arkansas,05,112190,1316,1925,25,1355680,10640,112190,1316,1243490,9324
2020-10-31,California,06,935248,3422,17661,34,18602317,157794,922005,5087,17680312,152707
2020-10-31,Colorado,08,107844,2917,2309,7,1229406,14939,107350,2924,1122056,12015
2020-10-31,Connecticut,09,71207,0,4616,0,2288584,0,71207,0,2217377,0
2020-10-31,Delaware,10,24951,200,708,4,350728,2201,24951,200,325777,2001
2020-10-31,District of Columbia,11,17266,122,646,0,514252,122,17266,122,496986,0
2020-10-31,Florida,12,802539,2331,16760,41,6126792,52911,791997,2283,5334795,50628
2020-10-31,Georgia,13,372631,2474,7790,22,3586394,27087,360790,2565,3225604,24522
2020-10-31,Guam,66,5650,53,80,0,67452,423,4681,53,62771,370
2020-10-31,Hawaii,15,15207,62,218,3,310369,100,15216,100,295153,0
2020-10-31,Idaho,16,64797,622,630,3,391890,3105,63810,1064,328080,2041
2020-10-31,Illinois,17,416557,6416,10030,18,7736104,92636,416559,7899,7319545,84737
2020-10-31,Indiana,18,181837,3465,4332,46,1699008,14225,179358,3465,1519650,10760
2020-10-31,Iowa,19,128798,2825,1716,2,890432,6180,119755,2570,770677,3610
2020-10-31,Kansas,20,86771,3,1029,0,642782,0,85181,0,557601,0
2020-10-31,Kentucky,21,109244,1624,1551,8,1912810,19950,107219,1977,1805591,17973
2020-10-31,Louisiana,22,186649,0,5919,0,2763671,0,186649,0,2577022,0
2020-10-31,Maine,23,6668,98,147,1,623511,98,6668,98,616843,0
2020-10-31,Maryland,24,145593,793,4147,10,1938672,12154,145281,967,1793391,11187
2020-10-31,Massachusetts,25,158576,1430,9991,16,2745378,18260,158576,1430,2586802,16830
2020-10-31,Michigan,26,197164,3804,7699,35,4911592,49509,197406,4018,4714186,45491
2020-10-31,Minnesota,27,148526,3007,2511,20,1854258,17459,148472,3007,1705786,14452
2020-10-31,Mississippi,28,120160,824,3334,6,924424,824,120160,824,804264,0
2020-10-31,Missouri,29,189925,2095,3090,76,1510155,10873,183186,2986,1326969,7887
2020-10-31,Montana,30,32801,806,377,9,498915,6286,32801,885,466114,5401
2020-10-31,Nebraska,31,70732,1087,652,6,591018,4920,69645,1495,521373,3425
2020-10-31,Nevada,32,100844,806,1779,2,808487,4902,100763,977,707724,3925
2020-10-31,New Hampshire,33,11084,200,483,1,345085,6389,11084,200,334001,6189
2020-10-31,New Jersey,34,239679,1363,16350,11,4656106,81599,237886,1363,4418220,80236
2020-10-31,New Mexico,35,46490,581,1018,11,1172720,10833,46490,581,1126230,10252
2020-10-31,New York,36,512223,2052,33152,9,14527718,136962,507480,2049,14020238,134913
2020-10-31,North Carolina,37,274805,2574,4400,46,4055156,49365,274635,2805,3780521,46560
2020-10-31,North Dakota,38,43921,1433,529,12,294342,2154,44194,1461,250148,693
2020-10-31,Northern Mariana Islands,69,92,0,2,0,16085,0,92,0,15993,0
2020-10-31,Ohio,39,215697,2915,5301,10,4471680,57744,215697,2915,4255983,54829
2020-10-31,Oklahoma,40,122762,1267,1337,11,1617394,15619,122762,1267,1494632,14352
2020-10-31,Oregon,41,44923,535,690,13,861949,7011,44921,532,817028,6479
2020-10-31,Pennsylvania,42,212816,2230,8883,23,2522661,19161,208027,2510,2314634,16651
2020-10-31,Puerto Rico,72,66128,385,822,2,340110,285,34138,285,305972,0
2020-10-31,Rhode Island,44,32874,0,1201,0,436561,3685,33408,534,403153,3151
2020-10-31,South Carolina,45,176612,1018,3935,39,1802050,13690,176612,1018,1625438,12672
2020-10-31,South Dakota,46,45992,1433,425,10,259532,2876,45992,1433,213540,1443
2020-10-31,Tennessee,47,256923,1591,3322,15,3671773,9684,260672,1184,3411101,8500
2020-10-31,Texas,48,953451,7428,18549,72,8479525,79056,900596,7145,7578929,71911
2020-10-31,Utah,49,114670,1738,604,3,1046819,7304,114656,1724,932163,5580
2020-10-31,Vermont,50,2179,24,58,0,188152,1007,2195,22,185957,985
2020-10-31,Virgin Islands,78,1376,14,21,0,24430,211,1376,14,23054,197
2020-10-31,Virginia,51,181190,1551,3654,11,2639539,19787,181190,1551,2458349,18236
2020-10-31,Washington,53,112580,687,2468,0,2431419,21262,111607,1245,2319812,20017
2020-10-31,West Virginia,54,24460,470,457,6,778494,9192,24460,470,754034,8722
2020-10-31,Wisconsin,55,237870,5778,2092,58,2064506,15383,237870,5808,1826636,9575
2020-10-31,Wyoming,56,13298,270,87,0,130560,577,13298,270,117262,307
2020-11-01,Alabama,01,193985,1700,2973,6,1381326,7083,193985,1700,1187341,5383
2020-11-01,Alaska,02,16597,350,78,1,604207,0,15663,351,588544,-351
2020-11-01,Arizona,04,247484,1522,5981,2,1791644,14275,247473,1527,1544171,12748
2020-11-01,Arkansas,05,113057,867,1958,33,1355680,0,112190,0,1243490,0
2020-11-01,California,06,938883,3635,17671,10,18743315,140998,926534,4529,17816781,136469
2020-11-01,Colorado,08,110640,2796,2312,3,1243467,14061,109910,2560,1133557,11501
2020-11-01,Connecticut,09,71207,0,4616,0,2288584,0,71207,0,2217377,0
2020-11-01,Delaware,10,25126,175,710,2,352348,1620,25126,175,327222,1445
2020-11-01,District of Columbia,11,17369,103,646,0,525246,10994,17369,103,507877,10891
2020-11-01,Florida,12,807404,4865,16788,28,6175891,49099,796802,4805,5379089,44294
2020-11-01,Georgia,13,373700,1069,7792,2,3587586,1192,361982,1192,3225604,0
2020-11-01,Guam,66,5659,9,80,0,67563,111,4690,9,62873,102
2020-11-01,Hawaii,15,15287,80,218,0,310437,68,15284,68,295153,0
2020-11-01,Idaho,16,65272,475,631,1,394191,2301,64608,798,329583,1503
2020-11-01,Illinois,17,424860,8303,10091,61,7814562,78458,423539,6980,7391023,71478
2020-11-01,Indiana,18,184589,2752,4364,32,1709944,10936,182108,2750,1527836,8186
2020-11-01,Iowa,19,131097,2299,1733,17,897175,6743,121967,2212,775208,4531
2020-11-01,Kansas,20,86809,38,1029,0,642782,0,85181,0,557601,0
2020-11-01,Kentucky,21,110600,1356,1554,3,1914233,1423,108642,1423,1805591,0
2020-11-01,Louisiana,22,187720,1071,5926,7,2783118,19447,187720,1071,2595398,18376
2020-11-01,Maine,23,6715,47,147,0,623558,47,6715,47,616843,0
2020-11-01,Maryland,24,146627,1034,4152,5,1949180,10508,146145,864,1803035,9644
2020-11-01,Massachusetts,25,159707,1131,10013,22,2762094,16716,159707,1131,2602387,15585
2020-11-01,Michigan,26,197501,337,7700,1,4911592,0,197406,0,4714186,0
2020-11-01,Minnesota,27,150726,2200,2529,18,1869845,15587,150672,2200,1719173,13387
2020-11-01,Mississippi,28,120500,340,3348,14,924764,340,120500,340,804264,0
2020-11-01,Missouri,29,192141,2216,3091,1,1518716,8561,185535,2349,1333181,6212
2020-11-01,Montana,30,33495,694,378,1,501704,2789,33495,694,468209,2095
2020-11-01,Nebraska,31,71666,934,658,6,594432,3414,70732,1087,523700,2327
2020-11-01,Nevada,32,101594,750,1783,4,813190,4703,101479,716,711711,3987
2020-11-01,New Hampshire,33,11214,130,483,0,347135,2050,11214,130,335921,1920
2020-11-01,New Jersey,34,241422,1743,16354,4,4657849,1743,239629,1743,4418220,0
2020-11-01,New Mexico,35,47232,742,1026,8,1182514,9794,47232,742,1135282,9052
2020-11-01,New York,36,514482,2259,33174,22,14676653,148935,509735,2255,14166918,146680
2020-11-01,North Carolina,37,276706,1901,4405,5,4095365,40209,276692,2057,3818673,38152
2020-11-01,North Dakota,38,45048,1127,536,7,296094,1752,45344,1150,250750,602
2020-11-01,Northern Mariana Islands,69,96,4,2,0,16089,4,96,4,15993,0
2020-11-01,Ohio,39,219000,3303,5303,2,4524758,53078,219000,3303,4305758,49775
2020-11-01,Oklahoma,40,124111,1349,1345,8,1618743,1349,124111,1349,1494632,0
2020-11-01,Oregon,41,45419,496,691,1,867792,5843,45429,508,822363,5335
2020-11-01,Pennsylvania,42,214500,1684,8888,5,2537746,15085,209936,1909,2327810,13176
2020-11-01,Puerto Rico,72,66661,533,832,10,340513,403,34541,403,305972,0
2020-11-01,Rhode Island,44,32874,0,1201,0,439334,2773,33888,480,405446,2293
2020-11-01,South Carolina,45,178023,1411,3936,1,1827352,25302,178023,1411,1649329,23891
2020-11-01,South Dakota,46,47324,1332,437,12,262165,2633,47324,1332,214841,1301
2020-11-01,Tennessee,47,257658,735,3322,0,3683173,11400,261426,754,3421747,10646
2020-11-01,Texas,48,957789,4338,18582,33,8585378,105853,972330,71734,7613048,34119
2020-11-01,Utah,49,116510,1840,614,10,1053391,6572,116510,1854,936881,4718
2020-11-01,Vermont,50,2196,17,58,0,188584,432,2212,17,186372,415
2020-11-01,Virgin Islands,78,1376,0,21,0,24430,0,1376,0,23054,0
2020-11-01,Virginia,51,182392,1202,3655,1,2661376,21837,182392,1202,2478984,20635
2020-11-01,Washington,53,113109,529,2468,0,2455375,23956,112754,1147,2342621,22809
2020-11-01,West Virginia,54,24883,423,457,0,787586,9092,24883,423,762703,8669
2020-11-01,Wisconsin,55,241423,3553,2110,18,2082628,18122,241423,3553,1841205,14569
2020-11-01,Wyoming,56,13723,425,87,0,130985,425,13723,425,117262,0
2020-11-02,Alabama,01,194892,907,2973,0,1385328,4002,194892,907,1190436,3095
2020-11-02,Alaska,02,16948,351,79,1,620170,15963,16007,344,604163,15619
2020-11-02,Arizona,04,248293,809,5982,1,1798521,6877,248139,666,1550382,6211
2020-11-02,Arkansas,05,113641,584,1985,27,1372367,16687,113641,1451,1258726,15236
2020-11-02,California,06,944141,5258,17700,29,18912501,169186,930628,4094,17981873,165092
2020-11-02,Colorado,08,112821,2181,2320,8,1256328,12861,112147,2237,1144181,10624
2020-11-02,Connecticut,09,73858,2651,4627,11,2367994,79410,73858,2651,2294136,76759
2020-11-02,Delaware,10,25311,185,710,0,354670,2322,25311,185,329359,2137
2020-11-02,District of Columbia,11,17438,69,647,1,528174,2928,17438,69,510736,2859
2020-11-02,Florida,12,812055,4651,16833,45,6200385,24494,801371,4569,5399014,19925
2020-11-02,Georgia,13,377261,3561,7810,18,3596700,9114,362921,939,3233779,8175
2020-11-02,Guam,66,5662,3,80,0,67664,101,4693,3,62971,98
2020-11-02,Hawaii,15,15359,72,218,0,310520,83,15367,83,295153,0
2020-11-02,Idaho,16,66249,977,641,10,396267,2076,65088,480,331179,1596
2020-11-02,Illinois,17,431281,6421,10115,24,7882680,68118,429761,6222,7452919,61896
2020-11-02,Indiana,18,187665,3076,4390,26,1722842,12898,185185,3077,1537657,9821
2020-11-02,Iowa,19,132697,1600,1755,22,900994,3819,123372,1405,777622,2414
2020-11-02,Kansas,20,90613,3804,1046,17,655267,12485,89227,4046,566040,8439
2020-11-02,Kentucky,21,111816,1216,1565,11,1943582,29349,109670,1028,1833912,28321
2020-11-02,Louisiana,22,187995,275,5934,8,2788484,5366,187995,275,2600489,5091
2020-11-02,Maine,23,6799,84,148,1,644435,20877,6799,84,637636,20793
2020-11-02,Maryland,24,147477,850,4155,3,1960445,11265,146995,850,1813450,10415
2020-11-02,Massachusetts,25,160549,842,10023,10,2776247,14153,160549,842,2615698,13311
2020-11-02,Michigan,26,204135,6634,7716,16,5008299,96707,204326,6920,4803973,89787
2020-11-02,Minnesota,27,153674,2948,2538,9,1892909,23064,153620,2948,1739289,20116
2020-11-02,Mississippi,28,120865,365,3348,0,958073,33309,120865,365,837208,32944
2020-11-02,Missouri,29,195938,3797,3101,10,1528098,9382,188186,2651,1339912,6731
2020-11-02,Montana,30,34317,822,387,9,508931,7227,34252,757,474679,6470
2020-11-02,Nebraska,31,72631,965,659,1,597204,2772,71666,934,525538,1838
2020-11-02,Nevada,32,102243,649,1785,2,816433,3243,102114,635,714319,2608
2020-11-02,New Hampshire,33,11320,106,483,0,348198,1063,11320,106,336878,957
2020-11-02,New Jersey,34,242790,1368,16357,3,4721797,63948,240997,1368,4480800,62580
2020-11-02,New Mexico,35,48104,872,1036,10,1191327,8813,48104,872,1143223,7941
2020-11-02,New York,36,516114,1632,33187,13,14772754,96101,511368,1633,14261386,94468
2020-11-02,North Carolina,37,278477,1771,4413,8,4127596,32231,278028,1336,3849568,30895
2020-11-02,North Dakota,38,46020,972,545,9,297743,1649,46311,967,251432,682
2020-11-02,Northern Mariana Islands,69,96,0,2,0,16089,0,96,0,15993,0
2020-11-02,Ohio,39,221909,2909,5340,37,4564903,40145,221909,2909,4342994,37236
2020-11-02,Oklahoma,40,125195,1084,1354,9,1619827,1084,125195,1084,1494632,0
2020-11-02,Oregon,41,45978,559,694,3,871900,4108,45978,549,825922,3559
2020-11-02,Pennsylvania,42,217243,2743,8893,5,2550660,12914,211996,2060,2338664,10854
2020-11-02,Puerto Rico,72,68172,1511,839,7,341377,864,35405,864,305972,0
2020-11-02,Rhode Island,44,34120,1246,1210,9,440626,1292,34120,232,406506,1060
2020-11-02,South Carolina,45,178917,894,3946,10,1842038,14686,178917,894,1663121,13792
2020-11-02,South Dakota,46,47850,526,438,1,263137,972,47850,526,215287,446
2020-11-02,Tennessee,47,260275,2617,3347,25,3720657,37484,264587,3161,3456070,34323
2020-11-02,Texas,48,965780,7991,18626,44,8612713,27335,977785,5455,7634928,21880
2020-11-02,Utah,49,117767,1257,614,0,1061170,7779,117706,1196,943464,6583
2020-11-02,Vermont,50,2219,23,58,0,188852,268,2235,23,186617,245
2020-11-02,Virgin Islands,78,1376,0,21,0,24519,89,1378,2,23141,87
2020-11-02,Virginia,51,183418,1026,3658,3,2677061,15685,183418,1026,2493643,14659
2020-11-02,Washington,53,114787,1678,2484,16,2474372,18997,113541,787,2360831,18210
2020-11-02,West Virginia,54,25235,352,458,1,794491,6905,25235,352,769256,6553
2020-11-02,Wisconsin,55,244974,3551,2117,7,2091546,8918,244928,3505,1846618,5413
2020-11-02,Wyoming,56,14167,444,87,0,134018,3033,14167,444,119851,2589
2020-11-03,Alabama,01,195929,1037,2987,14,1392351,7023,195929,1037,1196422,5986
2020-11-03,Alaska,02,17339,391,79,0,624755,4585,16390,383,608365,4202
2020-11-03,Arizona,04,249841,1548,6022,40,1809271,10750,249818,1679,1559453,9071
2020-11-03,Arkansas,05,114519,878,2003,18,1378181,5814,114519,878,1263662,4936
2020-11-03,California,06,949383,5242,17751,51,19074921,162420,934672,4044,18140249,158376
2020-11-03,Colorado,08,115364,2543,2337,17,1267145,10817,114709,2562,1152436,8255
2020-11-03,Connecticut,09,74843,985,4635,8,2367994,0,73858,0,2294136,0
2020-11-03,Delaware,10,25426,115,712,2,355667,997,25426,115,330241,882
2020-11-03,District of Columbia,11,17524,86,647,0,533419,5245,17524,86,515895,5159
2020-11-03,Florida,12,816692,4637,16889,56,6225760,25375,805924,4553,5419836,20822
2020-11-03,Georgia,13,378894,1633,7837,27,3618830,22130,364589,1668,3254241,20462
2020-11-03,Guam,66,5781,119,81,1,69028,1364,4812,119,64216,1245
2020-11-03,Hawaii,15,15441,82,218,0,310597,77,15444,77,295153,0
2020-11-03,Idaho,16,67504,1255,649,8,398739,2472,65845,757,332894,1715
2020-11-03,Illinois,17,437879,6598,10177,62,7965115,82435,436277,6516,7528838,75919
2020-11-03,Indiana,18,190555,2890,4439,49,1733575,10733,188066,2881,1545509,7852
2020-11-03,Iowa,19,134576,1879,1780,25,903136,2142,124464,1092,778672,1050
2020-11-03,Kansas,20,91072,459,1051,5,655267,0,89227,0,566040,0
2020-11-03,Kentucky,21,113457,1641,1578,13,1951791,8209,111379,1709,1840412,6500
2020-11-03,Louisiana,22,189148,1153,5951,17,2817860,29376,189148,1153,2628712,28223
2020-11-03,Maine,23,6926,127,148,0,647961,3526,6926,127,641035,3399
2020-11-03,Maryland,24,148249,772,4162,7,1967900,7455,147766,771,1820134,6684
2020-11-03,Massachusetts,25,161585,1036,10035,12,2790437,14190,161585,1036,2628852,13154
2020-11-03,Michigan,26,207799,3664,7758,42,5050490,42191,207763,3437,4842727,38754
2020-11-03,Minnesota,27,157150,3476,2553,15,1900013,7104,157096,3476,1742917,3628
2020-11-03,Mississippi,28,121509,644,3384,36,958717,644,121509,644,837208,0
2020-11-03,Missouri,29,198312,2374,3136,35,1539263,11165,190424,2238,1348839,8927
2020-11-03,Montana,30,35222,905,400,13,512524,3593,35159,907,477365,2686
2020-11-03,Nebraska,31,74060,1429,662,3,600064,2860,72620,954,527444,1906
2020-11-03,Nevada,32,103305,1062,1807,22,819896,3463,103025,911,716871,2552
2020-11-03,New Hampshire,33,11448,128,483,0,350194,1996,11448,128,338746,1868
2020-11-03,New Jersey,34,244614,1824,16371,14,4766659,44862,242825,1828,4523834,43034
2020-11-03,New Mexico,35,49240,1136,1045,9,1202347,11020,49240,1136,1153107,9884
2020-11-03,New York,36,518431,2317,33198,11,14900623,127869,513689,2321,14386934,125548
2020-11-03,North Carolina,37,280657,2180,4481,68,4157478,29882,280377,2349,3877101,27533
2020-11-03,North Dakota,38,47192,1172,561,16,299835,2092,47532,1221,252303,871
2020-11-03,Northern Mariana Islands,69,96,0,2,0,16089,0,96,0,15993,0
2020-11-03,Ohio,39,226138,4229,5373,33,4604715,39812,226138,4229,4378577,35583
2020-11-03,Oklahoma,40,126526,1331,1375,21,1647339,27512,126526,1331,1520813,26181
2020-11-03,Oregon,41,46460,482,701,7,877404,5504,46460,482,830944,5022
2020-11-03,Pennsylvania,42,220111,2868,8926,33,2569217,18557,214871,2875,2354346,15682
2020-11-03,Puerto Rico,72,68943,771,842,3,341722,345,35750,345,305972,0
2020-11-03,Rhode Island,44,34543,423,1212,2,443524,2898,34543,423,408981,2475
2020-11-03,South Carolina,45,179952,1035,3968,22,1855123,13085,179952,1035,1675171,12050
2020-11-03,South Dakota,46,48854,1004,446,8,265210,2073,48854,1004,216356,1069
2020-11-03,Tennessee,47,262053,1778,3419,72,3734564,13907,266357,1770,3468207,12137
2020-11-03,Texas,48,974292,8512,18722,96,8712370,99657,988450,10665,7723920,88992
2020-11-03,Utah,49,119375,1608,620,6,1068439,7269,119375,1669,949064,5600
2020-11-03,Vermont,50,2237,18,58,0,189137,285,2257,22,186880,263
2020-11-03,Virgin Islands,78,1385,9,22,1,24565,46,1385,7,23180,39
2020-11-03,Virginia,51,184679,1261,3666,8,2699771,22710,184679,1261,2515092,21449
2020-11-03,Washington,53,115608,821,2507,23,2474915,543,114084,543,2360831,0
2020-11-03,West Virginia,54,25593,358,469,11,800408,5917,25593,358,774815,5559
2020-11-03,Wisconsin,55,251227,6253,2179,62,2112994,21448,251032,6104,1861962,15344
2020-11-03,Wyoming,56,14619,452,93,6,135336,1318,14619,452,120717,866
2020-11-04,Alabama,01,197777,1848,3006,19,1401274,8923,197777,1848,1203497,7075
2020-11-04,Alaska,02,17750,411,79,0,627758,3003,16798,408,610960,2595
2020-11-04,Arizona,04,250853,1012,6059,37,1818497,9226,250633,815,1567864,8411
2020-11-04,Arkansas,05,115812,1293,2026,23,1389797,11616,115812,1293,1273985,10323
2020-11-04,California,06,954624,5241,17818,67,19181012,106091,940010,5338,18241002,100753
2020-11-04,Colorado,08,118356,2992,2366,29,1279847,12702,117637,2928,1162210,9774
2020-11-04,Connecticut,09,75373,530,4645,10,2401877,33883,75373,1515,2326504,32368
2020-11-04,Delaware,10,25534,108,712,0,356664,997,25534,108,331130,889
2020-11-04,District of Columbia,11,17601,77,647,0,537091,3672,17601,77,519490,3595
2020-11-04,Florida,12,821115,4423,16921,32,6247167,21407,810256,4332,5436911,17075
2020-11-04,Georgia,13,382113,3219,8303,466,3647278,28448,366452,1863,3280826,26585
2020-11-04,Guam,66,5872,91,84,3,69756,728,4903,91,64853,637
2020-11-04,Hawaii,15,15591,150,218,0,310684,87,15531,87,295153,0
2020-11-04,Idaho,16,68791,1287,665,16,401774,3035,67024,1179,334750,1856
2020-11-04,Illinois,17,445537,7658,10239,62,8036972,71857,443815,7538,7593157,64319
2020-11-04,Indiana,18,194261,3706,4464,25,1748496,14921,191764,3698,1556732,11223
2020-11-04,Iowa,19,137315,2739,1801,21,908054,4918,126740,2276,781314,2642
2020-11-04,Kansas,20,93967,2895,1087,36,663680,8413,92215,2988,571465,5425
2020-11-04,Kentucky,21,115426,1969,1593,15,1999654,47863,113009,1630,1886645,46233
2020-11-04,Louisiana,22,190164,1016,5975,24,2825919,8059,190164,1016,2635755,7043
2020-11-04,Maine,23,7077,151,150,2,657250,9289,7077,151,650173,9138
2020-11-04,Maryland,24,149232,983,4172,10,1979067,11167,148766,1000,1830301,10167
2020-11-04,Massachusetts,25,163299,1714,10062,27,2812539,22102,163299,1714,2649240,20388
2020-11-04,Michigan,26,212126,4327,7783,25,5093676,43186,212160,4397,4881516,38789
2020-11-04,Minnesota,27,160977,3827,2584,31,1920465,20452,160923,3827,1759542,16625
2020-11-04,Mississippi,28,122275,766,3397,13,959483,766,122275,766,837208,0
2020-11-04,Missouri,29,201515,3203,3166,30,1546955,7692,193023,2599,1353932,5093
2020-11-04,Montana,30,36012,790,404,4,517288,4764,35955,796,481333,3968
2020-11-04,Nebraska,31,75888,1828,673,11,603890,3826,74060,1440,529830,2386
2020-11-04,Nevada,32,104514,1209,1816,9,823543,3647,104093,1068,719450,2579
2020-11-04,New Hampshire,33,11563,115,484,1,351136,942,11563,115,339573,827
2020-11-04,New Jersey,34,247057,2443,16391,20,4769091,2432,245257,2432,4523834,0
2020-11-04,New Mexico,35,50251,1011,1059,14,1218805,16458,50251,1011,1168554,15447
2020-11-04,New York,36,520557,2126,33222,24,15034157,133534,515815,2126,14518342,131408
2020-11-04,North Carolina,37,283280,2623,4535,54,4184258,26780,282802,2425,3901456,24355
2020-11-04,North Dakota,38,48306,1114,573,12,301492,1657,48704,1172,252788,485
2020-11-04,Northern Mariana Islands,69,96,0,2,0,16089,0,96,0,15993,0
2020-11-04,Ohio,39,230209,4071,5428,55,4644416,39701,230209,4071,4414207,35630
2020-11-04,Oklahoma,40,127772,1246,1392,17,1657117,9778,127772,1246,1529345,8532
2020-11-04,Oregon,41,47049,589,707,6,882954,5550,47049,589,835905,4961
2020-11-04,Pennsylvania,42,222883,2772,8967,41,2591931,22714,217666,2795,2374265,19919
2020-11-04,Puerto Rico,72,69020,77,850,8,341779,57,35807,57,305972,0
2020-11-04,Rhode Island,44,35122,579,1214,2,447021,3497,35122,579,411899,2918
2020-11-04,South Carolina,45,180870,918,3985,17,1865888,10765,180870,918,1685018,9847
2020-11-04,South Dakota,46,49791,937,460,14,266796,1586,49791,937,217005,649
2020-11-04,Tennessee,47,265407,3354,3446,27,3760384,25820,269802,3445,3490582,22375
2020-11-04,Texas,48,984919,10627,18870,148,8810462,98092,998267,9817,7812195,88275
2020-11-04,Utah,49,121563,2188,625,5,1073952,5513,121485,2110,952467,3403
2020-11-04,Vermont,50,2267,30,58,0,190095,958,2288,31,187807,927
2020-11-04,Virgin Islands,78,1388,3,23,1,24746,181,1388,3,23358,178
2020-11-04,Virginia,51,185836,1157,3677,11,2715175,15404,185836,1157,2529339,14247
2020-11-04,Washington,53,117091,1483,2526,19,2500930,26015,115790,1706,2385140,24309
2020-11-04,West Virginia,54,25987,394,472,3,806208,5800,25987,394,780221,5406
2020-11-04,Wisconsin,55,257365,6138,2237,58,2129582,16588,257287,6255,1872295,10333
2020-11-04,Wyoming,56,15044,425,105,12,135761,425,15044,425,120717,0
2020-11-05,Alabama,01,199158,1381,3026,20,1408999,7725,199158,1381,1209841,6344
2020-11-05,Alaska,02,18064,314,79,0,781826,154068,17111,313,764715,153755
2020-11-05,Arizona,04,252843,1990,6087,28,1832929,14432,252768,2135,1580161,12297
2020-11-05,Arkansas,05,117360,1548,2037,11,1402973,13176,117360,1548,1285613,11628
2020-11-05,California,06,960884,6260,17866,48,19266363,85351,944576,4566,18321787,80785
2020-11-05,Colorado,08,122170,3814,2383,17,1294480,14633,121006,3369,1173474,11264
2020-11-05,Connecticut,09,77060,1687,4656,11,2459921,58044,77060,1687,2382861,56357
2020-11-05,Delaware,10,25753,219,716,4,358386,1722,25753,219,332633,1503
2020-11-05,District of Columbia,11,17682,81,650,3,540502,3411,17682,81,522820,3330
2020-11-05,Florida,12,827372,6257,16960,39,6291105,43938,816376,6120,5474729,37818
2020-11-05,Georgia,13,384531,2418,8359,56,3672160,24882,368368,1916,3303792,22966
2020-11-05,Guam,66,5973,101,84,0,70467,711,5004,101,65463,610
2020-11-05,Hawaii,15,15683,92,218,0,310839,155,15686,155,295153,0
2020-11-05,Idaho,16,70005,1214,673,8,404810,3036,68314,1290,336496,1746
2020-11-05,Illinois,17,455528,9991,10334,95,8122987,86015,453750,9935,7669237,76080
2020-11-05,Indiana,18,198684,4423,4511,47,1761947,13451,196176,4412,1565771,9039
2020-11-05,Iowa,19,142795,5480,1814,13,916404,8350,130732,3992,785672,4358
2020-11-05,Kansas,20,94427,460,1087,0,663680,0,92215,0,571465,0
2020-11-05,Kentucky,21,117654,2228,1611,18,2028170,28516,115277,2268,1912893,26248
2020-11-05,Louisiana,22,190845,681,5995,20,2847666,21747,190845,681,2656821,21066
2020-11-05,Maine,23,7260,183,150,0,667850,10600,7260,183,660590,10417
2020-11-05,Maryland,24,150424,1192,4182,10,1990023,10956,149964,1198,1840059,9758
2020-11-05,Massachusetts,25,165161,1862,10085,23,2837094,24555,165161,1862,2671933,22693
2020-11-05,Michigan,26,218136,6010,7833,50,5154882,61206,218263,6103,4936619,55103
2020-11-05,Minnesota,27,164919,3942,2609,25,1941496,21031,164865,3942,1776631,17089
2020-11-05,Mississippi,28,123887,1612,3405,8,961095,1612,123887,1612,837208,0
2020-11-05,Missouri,29,205036,3521,3197,31,1557001,10046,196576,3553,1360425,6493
2020-11-05,Montana,30,37024,1012,409,5,520024,2736,36968,1013,483056,1723
2020-11-05,Nebraska,31,78012,2124,678,5,608304,4414,75888,1828,532416,2586
2020-11-05,Nevada,32,105706,1192,1825,9,829573,6030,105360,1267,724213,4763
2020-11-05,New Hampshire,33,11808,245,486,2,356358,5222,11808,245,344550,4977
2020-11-05,New Jersey,34,249019,1962,16403,12,4818052,48961,247219,1962,4570833,46999
2020-11-05,New Mexico,35,51110,859,1082,23,1230205,11400,51110,859,1179095,10541
2020-11-05,New York,36,523559,3002,33247,25,15195176,161019,518812,2997,14676364,158022
2020-11-05,North Carolina,37,286210,2930,4572,37,4226942,42684,285661,2859,3941281,39825
2020-11-05,North Dakota,38,49842,1536,601,28,303409,1917,50276,1572,253133,345
2020-11-05,Northern Mariana Islands,69,96,0,2,0,16089,0,96,0,15993,0
2020-11-05,Ohio,39,235170,4961,5461,33,4695806,51390,235170,4961,4460636,46429
2020-11-05,Oklahoma,40,129873,2101,1413,21,1673557,16440,129873,2101,1543684,14339
2020-11-05,Oregon,41,47839,790,710,3,889027,6073,47839,790,841188,5283
2020-11-05,Pennsylvania,42,225698,2815,9009,42,2611902,19971,220566,2900,2391336,17071
2020-11-05,Puerto Rico,72,69416,396,855,5,342073,294,36101,294,305972,0
2020-11-05,Rhode Island,44,35750,628,1222,8,450428,3407,35750,628,414678,2779
2020-11-05,South Carolina,45,181639,769,3992,7,1873285,7397,181639,769,1691646,6628
2020-11-05,South Dakota,46,51151,1360,482,22,269136,2340,51151,1360,217985,980
2020-11-05,Tennessee,47,267557,2150,3474,28,3780132,19748,271771,1969,3508361,17779
2020-11-05,Texas,48,993894,8975,19000,130,8905822,95360,1008438,10171,7897384,85189
2020-11-05,Utah,49,124366,2803,632,7,1086344,12392,124292,2807,962052,9585
2020-11-05,Vermont,50,2303,36,58,0,191033,938,2326,38,188707,900
2020-11-05,Virgin Islands,78,1388,0,23,0,24904,158,1388,0,23516,158
2020-11-05,Virginia,51,187202,1366,3688,11,2733990,18815,187202,1366,2546788,17449
2020-11-05,Washington,53,118459,1368,2542,16,2525399,24469,117385,1595,2408014,22874
2020-11-05,West Virginia,54,26547,560,480,8,817092,10884,26547,560,790545,10324
2020-11-05,Wisconsin,55,263640,6275,2273,36,2145384,15802,263571,6284,1881813,9518
2020-11-05,Wyoming,56,15409,365,105,0,138213,2452,15409,365,122804,2087
2020-11-06,Alabama,01,200714,1556,3049,23,1417716,8717,200714,1556,1217002,7161
2020-11-06,Alaska,02,18589,525,79,0,781301,-525,17618,507,763683,-1032
2020-11-06,Arizona,04,254961,2118,6111,24,1848745,15816,254764,1996,1593981,13820
2020-11-06,Arkansas,05,119230,1870,2056,19,1417494,14521,119230,1870,1298264,12651
2020-11-06,California,06,967597,6713,17939,73,19396349,129986,951094,6518,18445255,123468
2020-11-06,Colorado,08,125397,3227,2404,21,1310846,16366,124469,3463,1186377,12903
2020-11-06,Connecticut,09,78125,1065,4671,15,2489604,29683,78125,1065,2411479,28618
2020-11-06,Delaware,10,26035,282,716,0,360881,2495,26035,282,334846,2213
2020-11-06,District of Columbia,11,17792,110,652,2,546323,5821,17792,110,528531,5711
2020-11-06,Florida,12,832617,5245,17013,53,6325976,34871,821526,5150,5504450,29721
2020-11-06,Georgia,13,387202,2671,8389,30,3691733,19573,370106,1738,3321627,17835
2020-11-06,Guam,66,6046,73,89,5,71104,637,5077,73,66027,564
2020-11-06,Hawaii,15,15816,133,218,0,310938,99,15785,99,295153,0
2020-11-06,Idaho,16,71496,1491,685,12,408235,3425,69579,1265,338656,2160
2020-11-06,Illinois,17,466884,11356,10412,78,8215129,92142,465540,11790,7749589,80352
2020-11-06,Indiana,18,203332,4648,4547,36,1777105,15158,200823,4647,1576282,10511
2020-11-06,Iowa,19,146267,3472,1828,14,922017,5613,133510,2778,788507,2835
2020-11-06,Kansas,20,99605,5178,1172,85,676320,12640,97633,5418,578687,7222
2020-11-06,Kentucky,21,119952,2298,1621,10,2196876,168706,117505,2228,2079371,166478
2020-11-06,Louisiana,22,191715,870,6016,21,2866476,18810,191715,870,2674761,17940
2020-11-06,Maine,23,7444,184,150,0,676065,8215,7444,184,668621,8031
2020-11-06,Maryland,24,151964,1540,4194,12,2003170,13147,151505,1541,1851665,11606
2020-11-06,Massachusetts,25,167274,2113,10123,38,2857859,20765,167274,2113,2690585,18652
2020-11-06,Michigan,26,222423,4287,7883,50,5207467,52585,222509,4246,4984958,48339
2020-11-06,Minnesota,27,170361,5442,2645,36,1963849,22353,170307,5442,1793542,16911
2020-11-06,Mississippi,28,124854,967,3419,14,962062,967,124854,967,837208,0
2020-11-06,Missouri,29,210054,5018,3217,20,1567231,10230,200507,3931,1366724,6299
2020-11-06,Montana,30,38012,988,420,11,523596,3572,37947,979,485649,2593
2020-11-06,Nebraska,31,80693,2681,705,27,614043,5739,78012,2124,536031,3615
2020-11-06,Nevada,32,107258,1552,1846,21,835414,5841,106922,1562,728492,4279
2020-11-06,New Hampshire,33,12012,204,488,2,358730,2372,12012,204,346718,2168
2020-11-06,New Jersey,34,251180,2161,16416,13,4863436,45384,249380,2161,4614056,43223
2020-11-06,New Mexico,35,52394,1284,1088,6,1238575,8370,52394,1284,1186181,7086
2020-11-06,New York,36,526767,3208,33267,20,15355881,160705,522021,3209,14833860,157496
2020-11-06,North Carolina,37,289124,2914,4608,36,4277376,50434,288569,2908,3988807,47526
2020-11-06,North Dakota,38,51607,1765,618,17,306144,2735,52081,1805,254063,930
2020-11-06,Northern Mariana Islands,69,98,2,2,0,16091,2,98,2,15993,0
2020-11-06,Ohio,39,240178,5008,5494,33,4700814,5008,240178,5008,4460636,0
2020-11-06,Oklahoma,40,131751,1878,1429,16,1689601,16044,131751,1878,1557850,14166
2020-11-06,Oregon,41,48608,769,716,6,897602,8575,48608,769,848994,7806
2020-11-06,Pennsylvania,42,229346,3648,9052,43,2632316,20414,223950,3384,2408366,17030
2020-11-06,Puerto Rico,72,70519,1103,862,7,342876,803,36904,803,305972,0
2020-11-06,Rhode Island,44,36380,630,1224,2,453647,3219,36380,630,417267,2589
2020-11-06,South Carolina,45,182872,1233,4005,13,1897097,23812,182872,1233,1714225,22579
2020-11-06,South Dakota,46,52639,1488,510,28,272190,3054,52639,1488,219551,1566
2020-11-06,Tennessee,47,269292,1735,3508,34,3791407,11275,273144,1373,3518263,9902
2020-11-06,Texas,48,1003908,10014,19125,125,9002976,97154,1017677,9239,7985299,87915
2020-11-06,Utah,49,127294,2928,649,17,1096628,10284,127279,2987,969349,7297
2020-11-06,Vermont,50,2326,23,58,0,191728,695,2354,28,189374,667
2020-11-06,Virgin Islands,78,1390,2,23,0,25118,214,1390,2,23728,212
2020-11-06,Virginia,51,188770,1568,3682,-6,2758354,24364,188770,1568,2569584,22796
2020-11-06,Washington,53,120123,1664,2552,10,2547781,22382,119257,1872,2428524,20510
2020-11-06,West Virginia,54,27087,540,487,7,827059,9967,27087,540,799972,9427
2020-11-06,Wisconsin,55,270074,6434,2340,67,2166439,21055,269982,6411,1896457,14644
2020-11-06,Wyoming,56,16405,996,105,0,140174,1961,16405,996,123769,965
2020-11-07,Alabama,01,202482,1768,3082,33,1427077,9361,202482,1768,1224595,7593
2020-11-07,Alaska,02,19194,605,79,0,780694,-607,18221,603,762473,-1210
2020-11-07,Arizona,04,257384,2423,6147,36,1865425,16680,257384,2620,1608041,14060
2020-11-07,Arkansas,05,120828,1598,2068,12,1429305,11811,120828,1598,1308477,10213
2020-11-07,California,06,972801,5204,17964,25,19565151,168802,956957,5863,18608194,162939
2020-11-07,Colorado,08,128611,3214,2417,13,1327974,17128,127967,3498,1200007,13630
2020-11-07,Connecticut,09,78125,0,4671,0,2489604,0,78125,0,2411479,0
2020-11-07,Delaware,10,26258,223,716,0,362931,2050,26258,223,336673,1827
2020-11-07,District of Columbia,11,17891,99,654,2,550585,4262,17891,99,532694,4163
2020-11-07,Florida,12,837069,4452,17099,86,6345029,19053,825906,4380,5519123,14673
2020-11-07,Georgia,13,389257,2055,8427,38,3715270,23537,371825,1719,3343445,21818
2020-11-07,Guam,66,6046,0,89,0,71507,403,5113,36,66394,367
2020-11-07,Hawaii,15,15939,123,219,1,311076,138,15923,138,295153,0
2020-11-07,Idaho,16,72528,1032,685,0,412887,4652,70909,1330,341978,3322
2020-11-07,Illinois,17,479061,12177,10498,86,8313547,98418,477978,12438,7835569,85980
2020-11-07,Indiana,18,208243,4911,4592,45,1794398,17293,205722,4899,1588676,12394
2020-11-07,Iowa,19,150639,4372,1842,14,928259,6242,137228,3718,791031,2524
2020-11-07,Kansas,20,99671,66,1166,-6,676320,0,97633,0,578687,0
2020-11-07,Kentucky,21,122021,2069,1640,19,2066810,-130066,119661,2156,1947149,-132222
2020-11-07,Louisiana,22,191715,0,6016,0,2866476,0,191715,0,2674761,0
2020-11-07,Maine,23,7603,159,152,2,676224,159,7603,159,668621,0
2020-11-07,Maryland,24,153198,1234,4201,7,2015314,12144,152915,1410,1862399,10734
2020-11-07,Massachusetts,25,169576,2302,10146,23,2881767,23908,169576,2302,2712191,21606
2020-11-07,Michigan,26,228706,6283,7943,60,5213961,6494,229003,6494,4984958,0
2020-11-07,Minnesota,27,175008,4647,2679,34,1983443,19594,174954,4647,1808489,14947
2020-11-07,Mississippi,28,125885,1031,3433,14,963093,1031,125885,1031,837208,0
2020-11-07,Missouri,29,213645,3591,3235,18,1578411,11180,205066,4559,1373345,6621
2020-11-07,Montana,30,38948,936,445,25,525176,1580,38948,1001,486228,579
2020-11-07,Nebraska,31,82395,1702,710,5,621532,7489,80693,2681,540839,4808
2020-11-07,Nevada,32,109326,2068,1851,5,842004,6590,108746,1824,733258,4766
2020-11-07,New Hampshire,33,12241,229,489,1,361706,2976,12241,229,349465,2747
2020-11-07,New Jersey,34,254382,3202,16425,9,4963630,100194,252582,3202,4711048,96992
2020-11-07,New Mexico,35,53671,1277,1104,16,1250724,12149,53671,1277,1197053,10872
2020-11-07,New York,36,530354,3587,33287,20,15519172,163291,525608,3587,14993564,159704
2020-11-07,North Carolina,37,291563,2439,4629,21,4324156,46780,291245,2676,4032911,44104
2020-11-07,North Dakota,38,53209,1602,633,15,308494,2350,53727,1646,254767,704
2020-11-07,Northern Mariana Islands,69,98,0,2,0,16091,0,98,0,15993,0
2020-11-07,Ohio,39,245727,5549,5506,12,4808908,108094,245727,5549,4563181,102545
2020-11-07,Oklahoma,40,136258,4507,1438,9,1703072,13471,131751,0,1571321,13471
2020-11-07,Oregon,41,49587,979,729,13,903099,5497,49587,979,853512,4518
2020-11-07,Pennsylvania,42,232582,3236,9089,37,2654106,21790,227985,4035,2426121,17755
2020-11-07,Puerto Rico,72,71532,1013,862,0,343539,663,37567,663,305972,0
2020-11-07,Rhode Island,44,36380,0,1224,0,460515,6868,37175,795,423340,6073
2020-11-07,South Carolina,45,184742,1870,4015,10,1944928,47831,184742,1870,1760186,45961
2020-11-07,South Dakota,46,53976,1337,523,13,274683,2493,53976,1337,220707,1156
2020-11-07,Tennessee,47,273603,4311,3556,48,3836617,45210,278215,5071,3558402,40139
2020-11-07,Texas,48,1009837,5929,19219,94,9095589,92613,1027237,9560,8068352,83053
2020-11-07,Utah,49,130238,2944,658,9,1107994,11366,130235,2956,977759,8410
2020-11-07,Vermont,50,2347,21,59,1,192522,794,2382,28,190140,766
2020-11-07,Virgin Islands,78,1405,15,23,0,25118,0,1390,0,23728,0
2020-11-07,Virginia,51,190873,2103,3704,22,2782039,23685,190873,2103,2591166,21582
2020-11-07,Washington,53,121220,1097,2552,0,2575397,27616,121381,2124,2454016,25492
2020-11-07,West Virginia,54,27742,655,502,15,837704,10645,27742,655,809962,9990
2020-11-07,Wisconsin,55,277568,7494,2385,45,2185823,19384,277503,7521,1908320,11863
2020-11-07,Wyoming,56,16597,192,105,0,140366,192,16597,192,123769,0
2020-11-08,Alabama,01,203687,1205,3084,2,1433504,6427,203687,1205,1229817,5222
2020-11-08,Alaska,02,19712,518,79,0,780174,-520,18732,511,761442,-1031
2020-11-08,Arizona,04,259299,1915,6164,17,1879328,13903,259264,1880,1620064,12023
2020-11-08,Arkansas,05,121866,1038,2085,17,1438805,9500,121866,1038,1316939,8462
2020-11-08,California,06,978844,6043,17975,11,19724628,159477,964639,7682,18759989,151795
2020-11-08,Colorado,08,131870,3259,2421,4,1341956,13982,130984,3017,1210972,10965
2020-11-08,Connecticut,09,78125,0,4671,0,2489604,0,78125,0,2411479,0
2020-11-08,Delaware,10,26603,345,718,2,365279,2348,26603,345,338676,2003
2020-11-08,District of Columbia,11,18001,110,654,0,555449,4864,18001,110,537448,4754
2020-11-08,Florida,12,843889,6820,17120,21,6389831,44802,832525,6619,5557306,38183
2020-11-08,Georgia,13,390617,1360,8428,1,3733960,18690,373078,1253,3360882,17437
2020-11-08,Guam,66,6046,0,89,0,71996,489,5233,120,66763,369
2020-11-08,Hawaii,15,16066,127,220,1,311204,128,16051,128,295153,0
2020-11-08,Idaho,16,73212,684,691,6,415721,2834,72312,1403,343409,1431
2020-11-08,Illinois,17,488980,9919,10548,50,8404304,90757,487987,10009,7916317,80748
2020-11-08,Indiana,18,212895,4652,4629,37,1809940,15542,210374,4652,1599566,10890
2020-11-08,Iowa,19,155583,4944,1845,3,935839,7580,140541,3313,795298,4267
2020-11-08,Kansas,20,99805,134,1166,0,676320,0,97633,0,578687,0
2020-11-08,Kentucky,21,123195,1174,1641,1,2067987,1177,120838,1177,1947149,0
2020-11-08,Louisiana,22,192981,1266,6036,20,2892957,26481,192981,1266,2699976,25215
2020-11-08,Maine,23,7693,90,152,0,676314,90,7693,90,668621,0
2020-11-08,Maryland,24,154451,1253,4212,11,2026292,10978,153996,1081,1872296,9897
2020-11-08,Massachusetts,25,171399,1823,10166,20,2901920,20153,171399,1823,2730521,18330
2020-11-08,Michigan,26,229085,379,7944,1,5213961,0,229003,0,4984958,0
2020-11-08,Minnesota,27,180916,5908,2710,31,2004582,21139,180862,5908,1823720,15231
2020-11-08,Mississippi,28,126689,804,3443,10,963897,804,126689,804,837208,0
2020-11-08,Missouri,29,216654,3009,3238,3,1599615,21204,209197,4131,1390418,17073
2020-11-08,Montana,30,39679,731,456,11,526591,1415,39679,731,486912,684
2020-11-08,Nebraska,31,83969,1574,710,0,626287,4755,82395,1702,543892,3053
2020-11-08,Nevada,32,110308,982,1852,1,846248,4244,110022,1276,736226,2968
2020-11-08,New Hampshire,33,12488,247,489,0,362828,1122,12488,247,350340,875
2020-11-08,New Jersey,34,256395,2013,16429,4,4965643,2013,254595,2013,4711048,0
2020-11-08,New Mexico,35,54881,1210,1118,14,1262482,11758,54881,1210,1207601,10548
2020-11-08,New York,36,533784,3430,33314,27,15664814,145642,529036,3428,15135778,142214
2020-11-08,North Carolina,37,293431,1868,4630,1,4365061,40905,293339,2094,4071722,38811
2020-11-08,North Dakota,38,54310,1101,644,11,310037,1543,54844,1117,255193,426
2020-11-08,Northern Mariana Islands,69,98,0,2,0,16091,0,98,0,15993,0
2020-11-08,Ohio,39,250268,4541,5517,11,4868460,59552,250268,4541,4618192,55011
2020-11-08,Oklahoma,40,136258,0,1438,0,1707579,4507,136258,4507,1571321,0
2020-11-08,Oregon,41,50448,861,730,1,909301,6202,50448,861,858853,5341
2020-11-08,Pennsylvania,42,235162,2580,9093,4,2672529,18423,230894,2909,2441635,15514
2020-11-08,Puerto Rico,72,71715,183,872,10,344072,533,38100,533,305972,0
2020-11-08,Rhode Island,44,36380,0,1224,0,463584,3069,37743,568,425841,2501
2020-11-08,South Carolina,45,185688,946,4036,21,1959102,14174,185688,946,1773414,13228
2020-11-08,South Dakota,46,55404,1428,536,13,277035,2352,55404,1428,221631,924
2020-11-08,Tennessee,47,277073,3470,3561,5,3873139,36522,281851,3636,3591288,32886
2020-11-08,Texas,48,1016772,6935,19256,37,9148490,52901,1034115,6878,8114375,46023
2020-11-08,Utah,49,132621,2383,659,1,1116732,8738,132621,2386,984111,6352
2020-11-08,Vermont,50,2392,45,59,0,193404,882,2436,54,190968,828
2020-11-08,Virgin Islands,78,1405,0,23,0,25417,299,1405,15,24012,284
2020-11-08,Virginia,51,192175,1302,3707,3,2803062,21023,192175,1302,2610887,19721
2020-11-08,Washington,53,122310,1090,2552,0,2600067,24670,123312,1931,2476755,22739
2020-11-08,West Virginia,54,28404,662,502,0,849461,11757,28404,662,821057,11095
2020-11-08,Wisconsin,55,281910,4342,2396,11,2198711,12888,281910,4407,1916801,8481
2020-11-08,Wyoming,56,17310,713,114,9,141079,713,17310,713,123769,0
2020-11-09,Alabama,01,204857,1170,3084,0,1437832,4328,204857,1170,1232975,3158
2020-11-09,Alaska,02,20185,473,79,0,767997,-12177,19196,464,748801,-12641
2020-11-09,Arizona,04,260646,1347,6164,0,1889905,10577,259699,435,1630206,10142
2020-11-09,Arkansas,05,122811,945,2108,23,1447466,8661,122811,945,1324655,7716
2020-11-09,California,06,985598,6754,18035,60,19918479,193851,971851,7212,18946628,186639
2020-11-09,Colorado,08,135747,3877,2438,17,1359195,17239,134537,3553,1224658,13686
2020-11-09,Connecticut,09,81463,3338,4698,27,2579578,89974,81463,3338,2498115,86636
2020-11-09,Delaware,10,26908,305,719,1,367580,2301,26908,305,340672,1996
2020-11-09,District of Columbia,11,18087,86,655,1,558814,3365,18087,86,540727,3279
2020-11-09,Florida,12,847813,3924,17178,58,6410130,20299,836370,3845,5573760,16454
2020-11-09,Georgia,13,392246,1629,8457,29,3749894,15934,374181,1103,3375713,14831
2020-11-09,Guam,66,6442,396,91,2,72954,958,5473,240,67481,718
2020-11-09,Hawaii,15,16124,58,220,0,311332,128,16179,128,295153,0
2020-11-09,Idaho,16,74713,1501,704,13,418504,2783,72961,649,345543,2134
2020-11-09,Illinois,17,500015,11035,10577,29,8469064,64760,498560,10573,7970504,54187
2020-11-09,Indiana,18,217028,4133,4664,35,1823029,13089,214509,4135,1608520,8954
2020-11-09,Iowa,19,159910,4327,1872,27,945621,9782,144922,4381,800699,5401
2020-11-09,Kansas,20,105298,5493,1181,15,689982,13662,103553,5920,586429,7742
2020-11-09,Kentucky,21,125332,2137,1655,14,2106069,38082,122567,1729,1983502,36353
2020-11-09,Louisiana,22,193372,391,6048,12,2898463,5506,193372,391,2705091,5115
2020-11-09,Maine,23,7888,195,153,1,698403,22089,7888,195,690515,21894
2020-11-09,Maryland,24,155824,1373,4221,9,2037645,11353,155371,1375,1882274,9978
2020-11-09,Massachusetts,25,172727,1328,10180,14,2916246,14326,172727,1328,2743519,12998
2020-11-09,Michigan,26,238136,9051,8008,64,5368310,154349,238308,9305,5130002,145044
2020-11-09,Minnesota,27,184842,3926,2729,19,2018855,14273,184788,3926,1834067,10347
2020-11-09,Mississippi,28,127205,516,3443,0,1001068,37171,127205,516,873863,36655
2020-11-09,Missouri,29,221874,5220,3241,3,1607875,8260,212441,3244,1395434,5016
2020-11-09,Montana,30,40118,439,463,7,540913,14322,40053,374,500860,13948
2020-11-09,Nebraska,31,85551,1582,714,4,630137,3850,83969,1574,546168,2276
2020-11-09,Nevada,32,111323,1015,1853,1,850941,4693,110982,960,739959,3733
2020-11-09,New Hampshire,33,12699,211,489,0,363544,716,12699,211,350845,505
2020-11-09,New Jersey,34,258453,2058,16440,11,5037287,71644,256653,2058,4780634,69586
2020-11-09,New Mexico,35,56289,1408,1130,12,1269523,7041,56289,1408,1213234,5633
2020-11-09,New York,36,536933,3149,33343,29,15776230,111416,532180,3144,15244050,108272
2020-11-09,North Carolina,37,295105,1674,4638,8,4399616,34555,294860,1521,4104756,33034
2020-11-09,North Dakota,38,55463,1153,649,5,311537,1500,55997,1153,255540,347
2020-11-09,Northern Mariana Islands,69,100,2,2,0,16093,2,100,2,15993,0
2020-11-09,Ohio,39,254974,4706,5524,7,4918126,49666,254974,4706,4663152,44960
2020-11-09,Oklahoma,40,138455,2197,1444,6,1709776,2197,138455,2197,1571321,0
2020-11-09,Oregon,41,51155,707,738,8,914677,5376,51155,707,863522,4669
2020-11-09,Pennsylvania,42,239724,4562,9098,5,2690152,17623,234296,3402,2455856,14221
2020-11-09,Puerto Rico,72,72196,481,882,10,344553,481,38581,481,305972,0
2020-11-09,Rhode Island,44,38009,1629,1233,9,465031,1447,38009,266,427022,1181
2020-11-09,South Carolina,45,186391,703,4041,5,1967225,8123,186391,703,1780834,7420
2020-11-09,South Dakota,46,56311,907,537,1,278803,1768,56311,907,222492,861
2020-11-09,Tennessee,47,282746,5673,3577,16,3928231,55092,287770,5919,3640461,49173
2020-11-09,Texas,48,1026570,9798,19298,42,9181210,32720,1038964,4849,8142246,27871
2020-11-09,Utah,49,134868,2247,661,2,1125403,8671,134868,2247,990535,6424
2020-11-09,Vermont,50,2415,23,59,0,193838,434,2461,25,191377,409
2020-11-09,Virgin Islands,78,1405,0,23,0,25417,0,1405,0,24012,0
2020-11-09,Virginia,51,193477,1302,3713,6,2819087,16025,193477,1302,2625610,14723
2020-11-09,Washington,53,124560,2250,2577,25,2619586,19519,124719,1407,2494867,18112
2020-11-09,West Virginia,54,28805,401,530,28,857085,7624,28805,401,828280,7223
2020-11-09,Wisconsin,55,286446,4536,2421,25,2212898,14187,286380,4470,1926518,9717
2020-11-09,Wyoming,56,18010,700,114,0,145158,4079,18010,700,127148,3379
2020-11-10,Alabama,01,206567,1710,3120,36,1437719,-113,206567,1710,1231152,-1823
2020-11-10,Alaska,02,20715,530,87,8,828140,60143,19734,538,808406,59605
2020-11-10,Arizona,04,263445,2799,6198,34,1905430,15525,263133,3434,1642297,12091
2020-11-10,Arkansas,05,124235,1424,2112,4,1456243,8777,124235,1424,1332008,7353
2020-11-10,California,06,994341,8743,18073,38,20094641,176162,977218,5367,19117423,170795
2020-11-10,Colorado,08,139246,3499,2469,31,1374786,15591,138427,3890,1236359,11701
2020-11-10,Connecticut,09,82987,1524,4707,9,2602262,22684,82987,1524,2519275,21160
2020-11-10,Delaware,10,27112,204,722,3,369131,1551,27112,204,342019,1347
2020-11-10,District of Columbia,11,18173,86,657,2,561833,3019,18173,86,543660,2933
2020-11-10,Florida,12,852166,4353,17247,69,6434241,24111,840652,4282,5593589,19829
2020-11-10,Georgia,13,396498,4252,8507,50,3772524,22630,376054,1873,3396470,20757
2020-11-10,Guam,66,6623,181,92,1,73859,905,5654,181,68205,724
2020-11-10,Hawaii,15,16193,69,221,1,311395,63,16242,63,295153,0
2020-11-10,Idaho,16,76010,1297,720,16,420811,2307,74227,1266,346584,1041
2020-11-10,Illinois,17,512688,12673,10658,81,8571019,101955,511183,12623,8059836,89332
2020-11-10,Indiana,18,221894,4866,4731,67,1837630,14601,219338,4829,1618292,9772
2020-11-10,Iowa,19,163827,3917,1898,26,950191,4570,147656,2734,802535,1836
2020-11-10,Kansas,20,105760,462,1181,0,689982,0,103553,0,586429,0
2020-11-10,Kentucky,21,127472,2140,1674,19,2126356,20287,124646,2079,2001710,18208
2020-11-10,Louisiana,22,194702,1330,6058,10,2924923,26460,194702,1330,2730221,25130
2020-11-10,Maine,23,8060,172,156,3,704431,6028,8060,172,696371,5856
2020-11-10,Maryland,24,157149,1325,4233,12,2047847,10202,156709,1338,1891138,8864
2020-11-10,Massachusetts,25,174881,2154,10201,21,2932097,15851,174881,2154,2757216,13697
2020-11-10,Michigan,26,245005,6869,8095,87,5427625,59315,245252,6944,5182373,52371
2020-11-10,Minnesota,27,189735,4893,2752,23,2033885,15030,189681,4893,1844204,10137
2020-11-10,Mississippi,28,128138,933,3480,37,1002001,933,128138,933,873863,0
2020-11-10,Missouri,29,226372,4498,3375,134,1599170,-8705,216697,4256,1382473,-12961
2020-11-10,Montana,30,41219,1101,468,5,544566,3653,41151,1098,503415,2555
2020-11-10,Nebraska,31,87733,2182,741,27,633716,3579,85551,1582,548165,1997
2020-11-10,Nevada,32,112602,1279,1863,10,854534,3593,112304,1322,742230,2271
2020-11-10,New Hampshire,33,12919,220,489,0,368085,4541,12919,220,355166,4321
2020-11-10,New Jersey,34,262230,3777,16461,21,5041064,3777,260430,3777,4780634,0
2020-11-10,New Mexico,35,57547,1258,1144,14,1281951,12428,57547,1258,1224404,11170
2020-11-10,New York,36,540897,3964,33373,30,15904266,128036,536145,3965,15368121,124071
2020-11-10,North Carolina,37,298089,2984,4685,47,4429912,30296,297442,2582,4132470,27714
2020-11-10,North Dakota,38,56357,894,679,30,312484,947,56944,947,255540,0
2020-11-10,Northern Mariana Islands,69,100,0,2,0,16567,474,100,0,16467,474
2020-11-10,Ohio,39,261482,6508,5547,23,4964229,46103,261482,6508,4702747,39595
2020-11-10,Oklahoma,40,140157,1702,1451,7,1733198,23422,140157,1702,1593041,21720
2020-11-10,Oregon,41,51909,754,741,3,921216,6539,51909,754,869307,5785
2020-11-10,Pennsylvania,42,244046,4322,9156,58,2709442,19290,238657,4361,2470785,14929
2020-11-10,Puerto Rico,72,72471,275,889,7,344828,275,38856,275,305972,0
2020-11-10,Rhode Island,44,38798,789,1237,4,467877,2846,38798,789,429079,2057
2020-11-10,South Carolina,45,187738,1347,4062,21,1988512,21287,187738,1347,1800774,19940
2020-11-10,South Dakota,46,57334,1023,540,3,280699,1896,57334,1023,223365,873
2020-11-10,Tennessee,47,284725,1979,3639,62,3943804,15573,289749,1979,3654055,13594
2020-11-10,Texas,48,1038214,11644,19423,125,9299045,117835,1051899,12935,8247146,104900
2020-11-10,Utah,49,137523,2655,672,11,1135628,10225,137385,2517,998243,7708
2020-11-10,Vermont,50,2462,47,59,0,194531,693,2513,52,192018,641
2020-11-10,Virgin Islands,78,1413,8,23,0,25487,70,1410,5,24077,65
2020-11-10,Virginia,51,194912,1435,3726,13,2837139,18052,194912,1435,2642227,16617
2020-11-10,Washington,53,126091,1531,2594,17,2634441,14855,125496,777,2508945,14078
2020-11-10,West Virginia,54,29316,511,546,16,864043,6958,29316,511,834727,6447
2020-11-10,Wisconsin,55,293862,7416,2497,76,2233256,20358,293812,7432,1939444,12926
2020-11-10,Wyoming,56,19242,1232,127,13,146390,1232,19242,1232,127148,0
2020-11-11,Alabama,01,208637,2070,3201,81,1453872,16153,208637,2070,1245235,14083
2020-11-11,Alaska,02,21211,496,90,3,834590,6450,20221,487,814369,5963
2020-11-11,Arizona,04,265195,1750,6228,30,1915235,9805,265163,2030,1650072,7775
2020-11-11,Arkansas,05,126197,1962,2126,14,1469248,13005,126197,1962,1343051,11043
2020-11-11,California,06,999498,5157,18109,36,20222093,127452,984682,7464,19237411,119988
2020-11-11,Colorado,08,143553,4307,2481,12,1395052,20266,142402,3975,1252650,16291
2020-11-11,Connecticut,09,84741,1754,4716,9,2639205,36943,84741,1754,2554464,35189
2020-11-11,Delaware,10,27342,230,724,2,370625,1494,27342,230,343283,1264
2020-11-11,District of Columbia,11,18379,206,657,0,567072,5239,18379,206,548693,5033
2020-11-11,Florida,12,858004,5838,17299,52,6466981,32740,846321,5669,5620660,27071
2020-11-11,Georgia,13,398769,2271,8582,75,3786046,13522,377694,1640,3408352,11882
2020-11-11,Guam,66,6724,101,92,0,74549,690,5755,101,68794,589
2020-11-11,Hawaii,15,16309,116,221,0,311473,78,16320,78,295153,0
2020-11-11,Idaho,16,77536,1526,738,18,424391,3580,75428,1201,348963,2379
2020-11-11,Illinois,17,525072,12384,10805,147,8664483,93464,523840,12657,8140643,80807
2020-11-11,Indiana,18,226935,5041,4762,31,1853700,16070,224374,5036,1629326,11034
2020-11-11,Iowa,19,168457,4630,1927,29,958353,8162,151953,4297,806400,3865
2020-11-11,Kansas,20,110977,5217,1215,34,703647,13665,109225,5672,594422,7993
2020-11-11,Kentucky,21,130308,2836,1689,15,2129054,2698,127344,2698,2001710,0
2020-11-11,Louisiana,22,194702,0,6058,0,2924923,0,194702,0,2730221,0
2020-11-11,Maine,23,8202,142,158,2,704573,142,8202,142,696371,0
2020-11-11,Maryland,24,158836,1687,4249,16,2060836,12989,158423,1714,1902413,11275
2020-11-11,Massachusetts,25,177541,2660,10222,21,2952714,20617,177541,2660,2775173,17957
2020-11-11,Michigan,26,251499,6494,8137,42,5482476,54851,251872,6620,5230604,48231
2020-11-11,Minnesota,27,194626,4891,2810,58,2045316,11431,194570,4889,1850746,6542
2020-11-11,Mississippi,28,129394,1256,3497,17,1003257,1256,129394,1256,873863,0
2020-11-11,Missouri,29,230003,3631,3411,36,1627919,28749,220768,4071,1407151,24678
2020-11-11,Montana,30,42132,913,475,7,547728,3162,42070,919,505658,2243
2020-11-11,Nebraska,31,89942,2209,741,0,639462,5746,87733,2182,551729,3564
2020-11-11,Nevada,32,113856,1254,1877,14,859319,4785,113411,1107,745908,3678
2020-11-11,New Hampshire,33,13148,229,492,3,370830,2745,13148,229,357682,2516
2020-11-11,New Jersey,34,265295,3065,16476,15,5084793,43729,263495,3065,4821298,40664
2020-11-11,New Mexico,35,59034,1487,1158,14,1317248,35297,59034,1487,1258214,33810
2020-11-11,New York,36,545718,4821,33398,25,16068566,164300,540965,4820,15527601,159480
2020-11-11,North Carolina,37,300725,2636,4723,38,4460288,30376,300561,3119,4159727,27257
2020-11-11,North Dakota,38,57378,1021,691,12,314274,1790,58040,1096,256234,694
2020-11-11,Northern Mariana Islands,69,100,0,2,0,16567,0,100,0,16467,0
2020-11-11,Ohio,39,267356,5874,5623,76,5009783,45554,267356,5874,4742427,39680
2020-11-11,Oklahoma,40,142334,2177,1470,19,1748137,14939,142334,2177,1605803,12762
2020-11-11,Oregon,41,52770,861,746,5,928343,7127,52770,861,875573,6266
2020-11-11,Pennsylvania,42,248144,4098,9217,61,2732129,22687,243368,4711,2488761,17976
2020-11-11,Puerto Rico,72,72735,264,901,12,345092,264,39120,264,305972,0
2020-11-11,Rhode Island,44,39776,978,1243,6,471284,3407,39776,978,431508,2429
2020-11-11,South Carolina,45,188995,1257,4076,14,2000709,12197,188995,1257,1811714,10940
2020-11-11,South Dakota,46,58696,1362,567,27,283120,2421,58696,1362,224424,1059
2020-11-11,Tennessee,47,288311,3586,3727,88,3974023,30219,293381,3632,3680642,26587
2020-11-11,Texas,48,1051071,12857,19544,121,9411043,111998,1065065,13166,8345978,98832
2020-11-11,Utah,49,139815,2292,678,6,1144013,8385,139720,2335,1004293,6050
2020-11-11,Vermont,50,2535,73,59,0,195392,861,2602,89,192790,772
2020-11-11,Virgin Islands,78,1413,0,23,0,25487,0,1410,0,24077,0
2020-11-11,Virginia,51,196506,1594,3741,15,2858627,21488,196506,1594,2662121,19894
2020-11-11,Washington,53,126886,795,2595,1,2652623,18182,128209,2713,2524414,15469
2020-11-11,West Virginia,54,30201,885,553,7,875117,11074,30201,885,844916,10189
2020-11-11,Wisconsin,55,301349,7487,2562,65,2251217,17961,301349,7537,1949868,10424
2020-11-11,Wyoming,56,19374,132,127,0,146613,223,19374,132,127239,91
2020-11-12,Alabama,01,210637,2000,3213,12,1455872,2000,210637,2000,1245235,0
2020-11-12,Alaska,02,21689,478,90,0,844666,10076,20702,481,823964,9595
2020-11-12,Arizona,04,266644,1449,6240,12,1930540,15305,266562,1399,1663978,13906
2020-11-12,Arkansas,05,128006,1809,2144,18,1482925,13677,128006,1809,1354919,11868
2020-11-12,California,06,1009187,9689,18141,32,20342072,119979,991609,6927,19350463,113052
2020-11-12,Colorado,08,149262,5709,2512,31,1400249,5197,147599,5197,1252650,0
2020-11-12,Connecticut,09,85899,1158,4726,10,2663481,24276,85899,1158,2577582,23118
2020-11-12,Delaware,10,27546,204,732,8,372234,1609,27546,204,344688,1405
2020-11-12,District of Columbia,11,18507,128,657,0,571530,4458,18507,128,553023,4330
2020-11-12,Florida,12,863611,5607,17371,72,6493713,26732,851825,5504,5641888,21228
2020-11-12,Georgia,13,401750,2981,8655,73,3807413,21367,380190,2496,3427223,18871
2020-11-12,Guam,66,6819,95,92,0,75449,900,5850,95,69599,805
2020-11-12,Hawaii,15,16403,94,221,0,311590,117,16437,117,295153,0
2020-11-12,Idaho,16,78877,1341,753,15,428367,3976,77121,1693,351246,2283
2020-11-12,Illinois,17,537860,12788,10855,50,8765100,100617,536542,12702,8228558,87915
2020-11-12,Indiana,18,233540,6605,4813,51,1876317,22617,230965,6591,1645352,16026
2020-11-12,Iowa,19,173401,4944,1947,20,964756,6403,155603,3650,809153,2753
2020-11-12,Kansas,20,111503,526,1215,0,700505,-3142,109225,0,591280,-3142
2020-11-12,Kentucky,21,132686,2378,1702,13,2167395,38341,129680,2336,2037715,36005
2020-11-12,Louisiana,22,198531,3829,6097,39,2958488,33565,198531,3829,2759957,29736
2020-11-12,Maine,23,8395,193,159,1,725560,20987,8395,193,717165,20794
2020-11-12,Maryland,24,160311,1475,4261,12,2071985,11149,159900,1477,1912085,9672
2020-11-12,Massachusetts,25,180189,2648,10242,20,2974611,21897,180189,2648,2794422,19249
2020-11-12,Michigan,26,258973,7474,8187,50,5549792,67316,259183,7311,5290609,60005
2020-11-12,Minnesota,27,201851,7225,2849,39,2070714,25398,201795,7225,1868919,18173
2020-11-12,Mississippi,28,130665,1271,3514,17,1004528,1271,130665,1271,873863,0
2020-11-12,Missouri,29,235341,5338,3441,30,1639564,11645,225371,4603,1414193,7042
2020-11-12,Montana,30,43084,952,478,3,557951,10223,43031,961,514920,9262
2020-11-12,Nebraska,31,92553,2611,768,27,644851,5389,89942,2209,554909,3180
2020-11-12,Nevada,32,115360,1504,1880,3,865363,6044,114880,1469,750483,4575
2020-11-12,New Hampshire,33,13470,322,495,3,375048,4218,13470,322,361578,3896
2020-11-12,New Jersey,34,268787,3492,16495,19,5124598,39805,266986,3491,4857612,36314
2020-11-12,New Mexico,35,60776,1742,1176,18,1330403,13155,60776,1742,1269627,11413
2020-11-12,New York,36,550516,4798,33424,26,16231193,162627,545762,4797,15685431,157830
2020-11-12,North Carolina,37,303931,3206,4730,7,4500774,40486,303454,2893,4197320,37593
2020-11-12,North Dakota,38,59179,1801,703,12,317096,2822,59875,1835,257221,987
2020-11-12,Northern Mariana Islands,69,100,0,2,0,16567,0,100,0,16467,0
2020-11-12,Ohio,39,274457,7101,5658,35,5066497,56714,274457,7101,4792040,49613
2020-11-12,Oklahoma,40,144691,2357,1481,11,1750494,2357,144691,2357,1605803,0
2020-11-12,Oregon,41,53879,1109,748,2,935877,7534,53879,1109,881998,6425
2020-11-12,Pennsylvania,42,254167,6023,9272,55,2755505,23376,248856,5488,2506649,17888
2020-11-12,Puerto Rico,72,74067,1332,909,8,346424,1332,40452,1332,305972,0
2020-11-12,Rhode Island,44,40764,988,1250,7,474414,3130,40764,988,433650,2142
2020-11-12,South Carolina,45,190490,1495,4084,8,2020945,20236,190490,1495,1830455,18741
2020-11-12,South Dakota,46,60716,2020,567,0,286088,2968,60716,2020,225372,948
2020-11-12,Tennessee,47,291482,3171,3751,24,3995978,21955,296725,3344,3699253,18611
2020-11-12,Texas,48,1060798,9727,19705,161,9509989,98946,1075654,10589,8434335,88357
2020-11-12,Utah,49,143639,3824,689,11,1155716,11703,143639,3919,1012077,7784
2020-11-12,Vermont,50,2651,116,59,0,196748,1356,2727,125,194021,1231
2020-11-12,Virgin Islands,78,1413,0,23,0,25487,0,1410,0,24077,0
2020-11-12,Virginia,51,198027,1521,3758,17,2871201,12574,198027,1521,2673174,11053
2020-11-12,Washington,53,129672,2786,2619,24,2655007,2384,130593,2384,2524414,0
2020-11-12,West Virginia,54,30897,696,555,2,888299,13182,30897,696,857402,12486
2020-11-12,Wisconsin,55,309605,8256,2626,64,2274371,23154,309572,8223,1964799,14931
2020-11-12,Wyoming,56,20479,1105,127,0,149287,2674,20479,1105,128808,1569
2020-11-13,Alabama,01,213617,2980,3231,18,1474217,18345,213617,2980,1260600,15365
2020-11-13,Alaska,02,22282,593,91,1,844666,0,21286,584,823380,-584
2020-11-13,Arizona,04,270596,3952,6257,17,1949839,19299,269577,3015,1680262,16284
2020-11-13,Arkansas,05,130318,2312,2148,4,1497395,14470,130318,2312,1367077,12158
2020-11-13,California,06,1019052,9865,18218,77,20478500,136428,998502,6893,19479998,129535
2020-11-13,Colorado,08,155761,6499,2541,29,1423901,23652,154038,6439,1269863,17213
2020-11-13,Connecticut,09,88645,2746,4737,11,2706667,43186,88645,2746,2618022,40440
2020-11-13,Delaware,10,28016,470,734,2,375223,2989,28016,470,347207,2519
2020-11-13,District of Columbia,11,18666,159,657,0,577601,6071,18666,159,558935,5912
2020-11-13,Florida,12,870544,6933,17444,73,6522985,29272,858585,6760,5664400,22512
2020-11-13,Georgia,13,404577,2827,8678,23,3838550,31137,382505,2315,3456045,28822
2020-11-13,Guam,66,6893,74,93,1,76292,843,5924,74,70368,769
2020-11-13,Hawaii,15,16514,111,221,0,311687,97,16534,97,295153,0
2020-11-13,Idaho,16,80440,1563,756,3,431982,3615,78279,1158,353703,2457
2020-11-13,Illinois,17,553083,15223,10907,52,8871640,106540,551957,15415,8319683,91125
2020-11-13,Indiana,18,239139,5599,4863,50,1893070,16753,236565,5600,1656505,11153
2020-11-13,Iowa,19,178890,5489,1972,25,971644,6888,159635,4032,812009,2856
2020-11-13,Kansas,20,117282,5779,1256,41,706787,6282,115507,6282,591280,0
2020-11-13,Kentucky,21,135855,3169,1729,27,2196131,28736,132844,3164,2063287,25572
2020-11-13,Louisiana,22,201981,3450,6121,24,2992468,33980,201981,3450,2790487,30530
2020-11-13,Maine,23,8639,244,162,3,734410,8850,8639,244,725771,8606
2020-11-13,Maryland,24,162181,1870,4273,12,2084302,12317,161769,1869,1922533,10448
2020-11-13,Massachusetts,25,183095,2906,10265,23,2996729,22118,183095,2906,2813634,19212
2020-11-13,Michigan,26,268072,9099,8312,125,5623152,73360,268362,9179,5354790,64181
2020-11-13,Minnesota,27,207395,5544,2895,46,2095513,24799,207339,5544,1888174,19255
2020-11-13,Mississippi,28,131970,1305,3519,5,1005833,1305,131970,1305,873863,0
2020-11-13,Missouri,29,241236,5895,3452,11,1647747,8183,229376,4005,1418371,4178
2020-11-13,Montana,30,44297,1213,483,5,566544,8593,44244,1213,522300,7380
2020-11-13,Nebraska,31,94922,2369,789,21,650659,5808,92553,2611,558106,3197
2020-11-13,Nevada,32,117322,1962,1896,16,871005,5642,116737,1857,754268,3785
2020-11-13,New Hampshire,33,13929,459,498,3,378305,3257,13929,459,364376,2798
2020-11-13,New Jersey,34,272184,3397,16522,27,5169231,44633,270383,3397,4898848,41236
2020-11-13,New Mexico,35,62006,1230,1198,22,1348194,17791,62006,1230,1286188,16561
2020-11-13,New York,36,555917,5401,33452,28,16434914,203721,551163,5401,15883751,198320
2020-11-13,North Carolina,37,306498,2567,4749,19,4536767,35993,305233,1779,4231534,34214
2020-11-13,North Dakota,38,60608,1429,713,10,319501,2405,61365,1490,258136,915
2020-11-13,Northern Mariana Islands,69,100,0,2,0,16567,0,100,0,16467,0
2020-11-13,Ohio,39,282528,8071,5700,42,5132781,66284,282528,8071,4850253,58213
2020-11-13,Oklahoma,40,147358,2667,1493,12,1791023,40529,147358,2667,1643665,37862
2020-11-13,Oregon,41,54937,1058,759,11,943147,7270,54937,1058,888210,6212
2020-11-13,Pennsylvania,42,260001,5834,9306,34,2778371,22866,254387,5531,2523984,17335
2020-11-13,Puerto Rico,72,74734,667,914,5,347091,667,41119,667,305972,0
2020-11-13,Rhode Island,44,41529,765,1254,4,476930,2516,41529,765,435401,1751
2020-11-13,South Carolina,45,192101,1611,4101,17,2030994,10049,192101,1611,1838893,8438
2020-11-13,South Dakota,46,62327,1611,568,1,288661,2573,62327,1611,226334,962
2020-11-13,Tennessee,47,295135,3653,3814,63,4019449,23471,300458,3733,3718991,19738
2020-11-13,Texas,48,1073382,12584,19917,212,9606477,96488,1089078,13424,8517399,83064
2020-11-13,Utah,49,146155,2516,703,14,1164731,9015,145789,2150,1018942,6865
2020-11-13,Vermont,50,2743,92,59,0,197774,1026,2829,102,194945,924
2020-11-13,Virgin Islands,78,1426,13,23,0,25487,0,1410,0,24077,0
2020-11-13,Virginia,51,199262,1235,3785,27,2881795,10594,199262,1235,2682533,9359
2020-11-13,Washington,53,132183,2511,2634,15,2703570,48563,132756,2163,2570814,46400
2020-11-13,West Virginia,54,31639,742,565,10,902293,13994,31639,742,870654,13252
2020-11-13,Wisconsin,55,318023,8418,2694,68,2293535,19164,318023,8451,1975512,10713
2020-11-13,Wyoming,56,21341,862,127,0,151549,2262,21341,862,130208,1400
2020-11-14,Alabama,01,215843,2226,3246,15,1487103,12886,215843,2226,1271260,10660
2020-11-14,Alaska,02,23029,747,92,1,862264,17598,22020,734,840244,16864
2020-11-14,Arizona,04,273400,2804,6300,43,1968659,18820,273053,3476,1695606,15344
2020-11-14,Arkansas,05,132166,1848,2159,11,1497395,0,130318,0,1367077,0
2020-11-14,California,06,1027016,7964,18254,36,20671596,193096,1008377,9875,19663219,183221
2020-11-14,Colorado,08,160459,4698,2554,13,1444324,20423,159234,5196,1285090,15227
2020-11-14,Connecticut,09,88645,0,4737,0,2706667,0,88645,0,2618022,0
2020-11-14,Delaware,10,28395,379,736,2,377364,2141,28395,379,348969,1762
2020-11-14,District of Columbia,11,18814,148,658,1,583319,5718,18814,148,564505,5570
2020-11-14,Florida,12,875088,4544,17488,44,6554952,31967,862990,4405,5691962,27562
2020-11-14,Georgia,13,407596,3019,8729,51,3865939,27389,384997,2492,3480942,24897
2020-11-14,Guam,66,6893,0,93,0,76757,465,5965,41,70792,424
2020-11-14,Hawaii,15,16619,105,221,0,311805,118,16652,118,295153,0
2020-11-14,Idaho,16,81625,1185,763,7,435863,3881,79798,1519,356065,2362
2020-11-14,Illinois,17,564086,11003,11098,191,8986010,114370,562985,11028,8423025,103342
2020-11-14,Indiana,18,247466,8327,4888,25,1917951,24881,244887,8322,1673064,16559
2020-11-14,Iowa,19,183557,4667,1985,13,979886,8242,163728,4093,816158,4149
2020-11-14,Kansas,20,117728,446,1256,0,706787,0,115507,0,591280,0
2020-11-14,Kentucky,21,138854,2999,1739,10,2217321,21190,136137,3293,2081184,17897
2020-11-14,Louisiana,22,201981,0,6121,0,2992468,0,201981,0,2790487,0
2020-11-14,Maine,23,8791,152,163,1,734562,152,8791,152,725771,0
2020-11-14,Maryland,24,164239,2058,4293,20,2098169,13867,164090,2321,1934079,11546
2020-11-14,Massachusetts,25,186142,3047,10293,28,3024727,27998,186142,3047,2838585,24951
2020-11-14,Michigan,26,275393,7321,8375,63,5692584,69432,275792,7430,5416792,62002
2020-11-14,Minnesota,27,216084,8689,2930,35,2119079,23566,216028,8689,1903051,14877
2020-11-14,Mississippi,28,133340,1370,3540,21,1007203,1370,133340,1370,873863,0
2020-11-14,Missouri,29,248400,7164,3463,11,1661030,13283,235722,6346,1425308,6937
2020-11-14,Montana,30,45919,1622,519,36,569694,3150,45886,1642,523808,1508
2020-11-14,Nebraska,31,96834,1912,790,1,655959,5300,94922,2369,561037,2931
2020-11-14,Nevada,32,119228,1906,1908,12,877838,6833,119006,2269,758832,4564
2020-11-14,New Hampshire,33,14311,382,499,1,381412,3107,14311,382,367101,2725
2020-11-14,New Jersey,34,276537,4353,16548,26,5210727,41496,274736,4353,4935991,37143
2020-11-14,New Mexico,35,63171,1165,1208,10,1360452,12258,63171,1165,1297281,11093
2020-11-14,New York,36,561308,5391,33477,25,16619076,184162,556551,5388,16062525,178774
2020-11-14,North Carolina,37,309703,3205,4783,34,4591525,54758,309118,3885,4282407,50873
2020-11-14,North Dakota,38,62878,2270,732,19,323050,3549,63694,2329,259356,1220
2020-11-14,Northern Mariana Islands,69,100,0,2,0,16567,0,100,0,16467,0
2020-11-14,Ohio,39,290243,7715,5714,14,5195015,62234,290243,7715,4904772,54519
2020-11-14,Oklahoma,40,150205,2847,1516,23,1803804,12781,150205,2847,1653599,9934
2020-11-14,Oregon,41,56018,1081,760,1,951565,8418,56018,1081,895547,7337
2020-11-14,Pennsylvania,42,264396,4395,9353,47,2798085,19714,259938,5551,2538147,14163
2020-11-14,Puerto Rico,72,75387,653,921,7,347744,653,41772,653,305972,0
2020-11-14,Rhode Island,44,41529,0,1254,0,480477,3547,42763,1234,437714,2313
2020-11-14,South Carolina,45,194014,1913,4110,9,2072140,41146,194014,1913,1878126,39233
2020-11-14,South Dakota,46,64182,1855,621,53,291823,3162,64182,1855,227641,1307
2020-11-14,Tennessee,47,299597,4462,3839,25,4054301,34852,305120,4662,3749181,30190
2020-11-14,Texas,48,1083132,9750,20035,118,9705429,98952,1100479,11401,8604950,87551
2020-11-14,Utah,49,151141,4986,712,9,1180724,15993,151141,5352,1029583,10641
2020-11-14,Vermont,50,2843,100,59,0,198824,1050,2927,98,195897,952
2020-11-14,Virgin Islands,78,1434,8,23,0,26069,582,1434,24,24635,558
2020-11-14,Virginia,51,200799,1537,3799,14,2905317,23522,200799,1537,2704518,21985
2020-11-14,Washington,53,133612,1429,2638,4,2732255,28685,135666,2910,2596589,25775
2020-11-14,West Virginia,54,32792,1153,574,9,915656,13363,32792,1153,882864,12210
2020-11-14,Wisconsin,55,323604,5581,2748,54,2312924,19389,323604,5581,1989320,13808
2020-11-14,Wyoming,56,21881,540,144,17,152089,540,21881,540,130208,0
2020-11-15,Alabama,01,217822,1979,3248,2,1493737,6634,217822,1979,1275915,4655
2020-11-15,Alaska,02,23688,659,92,0,867382,5118,22662,642,844720,4476
2020-11-15,Arizona,04,275523,2123,6302,2,1981831,13172,275436,2383,1706395,10789
2020-11-15,Arkansas,05,133040,874,2183,24,1519751,22356,133040,2722,1386711,19634
2020-11-15,California,06,1035981,8965,18265,11,20866785,195189,1019345,10968,19847440,184221
2020-11-15,Colorado,08,164408,3949,2574,20,1462983,18659,163417,4183,1299566,14476
2020-11-15,Connecticut,09,88645,0,4737,0,2706667,0,88645,0,2618022,0
2020-11-15,Delaware,10,28803,408,736,0,379815,2451,28803,408,351012,2043
2020-11-15,District of Columbia,11,18977,163,660,2,588620,5301,18977,163,569643,5138
2020-11-15,Florida,12,885193,10105,17517,29,6599305,44353,872810,9820,5726495,34533
2020-11-15,Georgia,13,409504,1908,8730,1,3887286,21347,386949,1952,3500337,19395
2020-11-15,Guam,66,6893,0,93,0,77376,619,6121,156,71255,463
2020-11-15,Hawaii,15,16619,0,221,0,311912,107,16759,107,295153,0
2020-11-15,Idaho,16,82545,920,763,0,439714,3851,81317,1519,358397,2332
2020-11-15,Illinois,17,574722,10636,11170,72,9070841,84831,573616,10631,8497225,74200
2020-11-15,Indiana,18,254172,6706,4910,22,1938289,20338,251597,6710,1686692,13628
2020-11-15,Iowa,19,186314,2757,1989,4,988601,8715,167282,3554,821319,5161
2020-11-15,Kansas,20,117851,123,1256,0,706787,0,115507,0,591280,0
2020-11-15,Kentucky,21,140267,1413,1742,3,2218770,1449,137586,1449,2081184,0
2020-11-15,Louisiana,22,204513,2532,6132,11,3029596,37128,204513,2532,2825083,34596
2020-11-15,Maine,23,8944,153,165,2,734715,153,8944,153,725771,0
2020-11-15,Maryland,24,166317,2078,4302,9,2110466,12297,165930,1840,1944536,10457
2020-11-15,Massachusetts,25,188275,2133,10329,36,3042924,18197,188275,2133,2854649,16064
2020-11-15,Michigan,26,275892,499,8378,3,5692584,0,275792,0,5416792,0
2020-11-15,Minnesota,27,223637,7553,2961,31,2151282,32203,223581,7553,1927701,24650
2020-11-15,Mississippi,28,134309,969,3543,3,1008172,969,134309,969,873863,0
2020-11-15,Missouri,29,249608,1208,3463,0,1669473,8443,239451,3729,1430022,4714
2020-11-15,Montana,30,47158,1239,525,6,572561,2867,47158,1272,525403,1595
2020-11-15,Nebraska,31,98161,1327,791,1,661243,5284,96834,1912,564409,3372
2020-11-15,Nevada,32,120744,1516,1913,5,882523,4685,120183,1177,762340,3508
2020-11-15,New Hampshire,33,14671,360,499,0,384752,3340,14671,360,370081,2980
2020-11-15,New Jersey,34,281075,4538,16566,18,5339070,128343,279274,4538,5059796,123805
2020-11-15,New Mexico,35,64201,1030,1215,7,1372867,12415,64201,1030,1308666,11385
2020-11-15,New York,36,564952,3644,33508,31,16752278,133202,560200,3649,16192078,129553
2020-11-15,North Carolina,37,312406,2703,4830,47,4632609,41084,312235,3117,4320374,37967
2020-11-15,North Dakota,38,63802,924,742,10,324518,1468,64654,960,259864,508
2020-11-15,Northern Mariana Islands,69,100,0,2,0,16567,0,100,0,16467,0
2020-11-15,Ohio,39,298096,7853,5722,8,5262026,67011,298096,7853,4963930,59158
2020-11-15,Oklahoma,40,154128,3923,1528,12,1807727,3923,154128,3923,1653599,0
2020-11-15,Oregon,41,56880,862,762,2,957979,6414,56880,862,901099,5552
2020-11-15,Pennsylvania,42,269043,4647,9385,32,2824633,26548,265137,5199,2559496,21349
2020-11-15,Puerto Rico,72,76094,707,935,14,348451,707,42479,707,305972,0
2020-11-15,Rhode Island,44,41529,0,1254,0,483583,3106,43442,679,440141,2427
2020-11-15,South Carolina,45,195507,1493,4112,2,2090589,18449,195507,1493,1895082,16956
2020-11-15,South Dakota,46,65381,1199,644,23,294114,2291,65381,1199,228733,1092
2020-11-15,Tennessee,47,305211,5614,3856,17,4100329,46028,310937,5817,3789392,40211
2020-11-15,Texas,48,1090500,7368,20110,75,9762352,56923,1108402,7923,8653950,49000
2020-11-15,Utah,49,153808,2667,718,6,1189268,8544,153808,2667,1035460,5877
2020-11-15,Vermont,50,2889,46,59,0,199534,710,2971,44,196563,666
2020-11-15,Virgin Islands,78,1434,0,23,0,26069,0,1434,0,24635,0
2020-11-15,Virginia,51,201960,1161,3800,1,2939243,33926,201960,1161,2737283,32765
2020-11-15,Washington,53,135365,1753,2638,0,2759327,27072,138276,2610,2621051,24462
2020-11-15,West Virginia,54,33659,867,582,8,926879,11223,33659,867,893220,10356
2020-11-15,Wisconsin,55,329924,6320,2759,11,2331163,18239,329924,6320,2001239,11919
2020-11-15,Wyoming,56,22494,613,144,0,152702,613,22494,613,130208,0
2020-11-16,Alabama,01,219232,1410,3249,1,1501190,7453,219232,1410,1281958,6043
2020-11-16,Alaska,02,24268,580,92,0,872347,4965,23240,578,849107,4387
2020-11-16,Arizona,04,277179,1656,6302,0,1995236,13405,276912,1476,1718324,11929
2020-11-16,Arkansas,05,134348,1308,2225,42,1531206,11455,134348,1308,1396858,10147
2020-11-16,California,06,1047360,11379,18304,39,21068894,202109,1029235,9890,20039659,192219
2020-11-16,Colorado,08,168890,4482,2605,31,1481306,18323,167713,4296,1313593,14027
2020-11-16,Connecticut,09,93284,4639,4759,22,2793152,86485,93284,4639,2699868,81846
2020-11-16,Delaware,10,29200,397,736,0,382909,3094,29200,397,353709,2697
2020-11-16,District of Columbia,11,19064,87,660,0,590352,1732,19064,87,571288,1645
2020-11-16,Florida,12,889856,4663,17558,41,6625477,26172,877340,4530,5748137,21642
2020-11-16,Georgia,13,410581,1077,8740,10,3900708,13422,387930,981,3512778,12441
2020-11-16,Guam,66,7144,251,99,6,78133,757,6175,54,71958,703
2020-11-16,Hawaii,15,16711,92,221,0,312006,94,16853,94,295153,0
2020-11-16,Idaho,16,83906,1361,773,10,442233,2519,82245,928,359988,1591
2020-11-16,Illinois,17,586569,11847,11217,47,9161453,90612,585248,11632,8576205,78980
2020-11-16,Indiana,18,259318,5146,4936,26,1952202,13913,256744,5147,1695458,8766
2020-11-16,Iowa,19,189597,3283,2023,34,992851,4250,169353,2071,823498,2179
2020-11-16,Kansas,20,124697,6846,1266,10,733756,26969,122741,7234,611015,19735
2020-11-16,Kentucky,21,142277,2010,1750,8,2265659,46889,139097,1511,2126562,45378
2020-11-16,Louisiana,22,205059,546,6139,7,3037236,7640,205059,546,2832177,7094
2020-11-16,Maine,23,9117,173,165,0,756172,21457,9117,173,747055,21284
2020-11-16,Maryland,24,168041,1724,4309,7,2123275,12809,167656,1726,1955619,11083
2020-11-16,Massachusetts,25,190439,2164,10340,11,3060081,17157,190439,2164,2869642,14993
2020-11-16,Michigan,26,288543,12651,8437,59,5808470,115886,288954,13162,5519516,102724
2020-11-16,Minnesota,27,231074,7437,2973,12,2176285,25003,231018,7437,1945267,17566
2020-11-16,Mississippi,28,134898,589,3545,2,1041889,33717,134898,589,906991,33128
2020-11-16,Missouri,29,255942,6334,3485,22,1678572,9099,243169,3718,1435403,5381
2020-11-16,Montana,30,48101,943,528,3,573334,773,48027,869,525307,-96
2020-11-16,Nebraska,31,101601,3440,805,14,664980,3737,98161,1327,566819,2410
2020-11-16,Nevada,32,122441,1697,1919,6,887159,4636,122097,1914,765062,2722
2020-11-16,New Hampshire,33,15029,358,500,1,387608,2856,15029,358,372579,2498
2020-11-16,New Jersey,34,283294,2219,16580,14,5341289,2219,281493,2219,5059796,0
2020-11-16,New Mexico,35,65454,1253,1236,21,1386121,13254,65454,1253,1320667,12001
2020-11-16,New York,36,568450,3498,33540,32,16876843,124565,563690,3490,16313153,121075
2020-11-16,North Carolina,37,315314,2908,4843,13,4659829,27220,314207,1972,4345622,25248
2020-11-16,North Dakota,38,64891,1089,749,7,326344,1826,65738,1084,260606,742
2020-11-16,Northern Mariana Islands,69,102,2,2,0,16569,2,102,2,16467,0
2020-11-16,Ohio,39,305364,7268,5742,20,5318839,56813,305364,7268,5013475,49545
2020-11-16,Oklahoma,40,156857,2729,1538,10,1810456,2729,156857,2729,1653599,0
2020-11-16,Oregon,41,57646,766,772,10,962982,5003,57646,766,905336,4237
2020-11-16,Pennsylvania,42,275257,6214,9399,14,2843234,18601,269613,4476,2573621,14125
2020-11-16,Puerto Rico,72,76631,537,942,7,348988,537,43016,537,305972,0
2020-11-16,Rhode Island,44,43923,2394,1270,16,485400,1817,43923,481,441477,1336
2020-11-16,South Carolina,45,196617,1110,4143,31,2105533,14944,196617,1110,1908916,13834
2020-11-16,South Dakota,46,66278,897,644,0,296147,2033,66278,897,229869,1136
2020-11-16,Tennessee,47,312710,7499,3884,28,4161846,61517,318888,7951,3842958,53566
2020-11-16,Texas,48,1101781,11281,20157,47,9801355,39003,1116230,7828,8685125,31175
2020-11-16,Utah,49,155779,1971,725,7,1198557,9289,155779,1971,1042778,7318
2020-11-16,Vermont,50,3008,119,59,0,200472,938,3095,124,197377,814
2020-11-16,Virgin Islands,78,1434,0,23,0,26069,0,1434,0,24635,0
2020-11-16,Virginia,51,204637,2677,3806,6,2957245,18002,204637,2677,2752608,15325
2020-11-16,Washington,53,138602,3237,2661,23,2788212,28885,140157,1881,2648055,27004
2020-11-16,West Virginia,54,34460,801,585,3,938911,12032,34460,801,904451,11231
2020-11-16,Wisconsin,55,334640,4716,2775,16,2343710,12547,334562,4638,2009148,7909
2020-11-16,Wyoming,56,23193,699,144,0,153401,699,23193,699,130208,0
2020-11-17,Alabama,01,220848,1616,3301,52,1508520,7330,220848,1616,1287672,5714
2020-11-17,Alaska,02,24909,641,94,2,878622,6275,23874,634,854748,5641
2020-11-17,Arizona,04,281284,4105,6320,18,2011792,16556,279896,2984,1731896,13572
2020-11-17,Arkansas,05,135902,1554,2245,20,1540028,8822,135902,1554,1404126,7268
2020-11-17,California,06,1058096,10736,18360,56,21259076,190182,1037978,8743,20221098,181439
2020-11-17,Colorado,08,173220,4330,2626,21,1500349,19043,172044,4331,1328305,14712
2020-11-17,Connecticut,09,94986,1702,4771,12,2826458,33306,94986,1702,2731472,31604
2020-11-17,Delaware,10,29552,352,739,3,385476,2567,29552,352,355924,2215
2020-11-17,District of Columbia,11,19309,245,660,0,596742,6390,19309,245,577433,6145
2020-11-17,Florida,12,897315,7459,17643,85,6663538,38061,884625,7285,5778913,30776
2020-11-17,Georgia,13,414821,4240,8778,38,3954422,53714,391466,3536,3562956,50178
2020-11-17,Guam,66,7203,59,101,2,78948,815,6234,59,72714,756
2020-11-17,Hawaii,15,16755,44,221,0,312058,52,16905,52,295153,0
2020-11-17,Idaho,16,85383,1477,803,30,445207,2974,83344,1099,361863,1875
2020-11-17,Illinois,17,599358,12789,11327,110,9255658,94205,597849,12601,8657809,81604
2020-11-17,Indiana,18,264810,5492,5025,89,1969088,16886,262207,5463,1706881,11423
2020-11-17,Iowa,19,193196,3599,2064,41,997034,4183,171545,2192,825489,1991
2020-11-17,Kansas,20,125668,971,1266,0,733756,0,122741,0,611015,0
2020-11-17,Kentucky,21,145220,2943,1787,37,2287167,21508,142008,2911,2145159,18597
2020-11-17,Louisiana,22,207685,2626,6156,17,3068330,31094,207685,2626,2860645,28468
2020-11-17,Maine,23,9363,246,166,1,764918,8746,9363,246,755555,8500
2020-11-17,Maryland,24,170193,2152,4335,26,2135601,12326,169805,2149,1965796,10177
2020-11-17,Massachusetts,25,192964,2525,10360,20,3078086,18005,192964,2525,2885122,15480
2020-11-17,Michigan,26,296436,7893,8513,76,5865787,57317,296840,7886,5568947,49431
2020-11-17,Minnesota,27,237005,5931,2999,26,2191193,14908,236949,5931,1954244,8977
2020-11-17,Mississippi,28,135803,905,3581,36,1042794,905,135803,905,906991,0
2020-11-17,Missouri,29,261105,5163,3552,67,1692549,13977,248886,5717,1443663,8260
2020-11-17,Montana,30,49496,1395,548,20,583828,10494,49398,1371,534430,9123
2020-11-17,Nebraska,31,103805,2204,827,22,674139,9159,101601,3440,572538,5719
2020-11-17,Nevada,32,124082,1641,1946,27,892492,5333,123794,1697,768698,3636
2020-11-17,New Hampshire,33,15303,274,502,2,388900,1292,15303,274,373597,1018
2020-11-17,New Jersey,34,287320,4026,16618,38,5374691,33402,285519,4026,5089172,29376
2020-11-17,New Mexico,35,67559,2105,1264,28,1398339,12218,67559,2105,1330780,10113
2020-11-17,New York,36,573544,5094,33576,36,17036695,159852,568778,5088,16467917,154764
2020-11-17,North Carolina,37,318537,3223,4881,38,4697561,37732,317495,3288,4380066,34444
2020-11-17,North Dakota,38,65973,1082,775,26,328240,1896,66867,1129,261373,767
2020-11-17,Northern Mariana Islands,69,103,1,2,0,16570,1,103,1,16467,0
2020-11-17,Ohio,39,312443,7079,5772,30,5364520,45681,312443,7079,5052077,38602
2020-11-17,Oklahoma,40,158408,1551,1544,6,1851019,40563,158408,1551,1692611,39012
2020-11-17,Oregon,41,58570,924,779,7,969822,6840,58570,924,911252,5916
2020-11-17,Pennsylvania,42,280978,5721,9433,34,2863980,20746,275513,5900,2588467,14846
2020-11-17,Puerto Rico,72,77200,569,951,9,349557,569,43585,569,305972,0
2020-11-17,Rhode Island,44,44528,605,1278,8,488250,2850,44528,605,443722,2245
2020-11-17,South Carolina,45,197900,1283,4156,13,2122323,16790,197900,1283,1924423,15507
2020-11-17,South Dakota,46,67284,1006,644,0,298359,2212,67284,1006,231075,1206
2020-11-17,Tennessee,47,314553,1843,3953,69,4176151,14305,320729,1841,3855422,12464
2020-11-17,Texas,48,1112681,10900,20278,121,9920871,119516,1129874,13644,8790997,105872
2020-11-17,Utah,49,159006,3227,734,9,1208117,9560,158957,3178,1049160,6382
2020-11-17,Vermont,50,3104,96,59,0,201487,1015,3201,106,198286,909
2020-11-17,Virgin Islands,78,1450,16,23,0,26433,364,1450,16,24983,348
2020-11-17,Virginia,51,206762,2125,3835,29,2982632,25387,206762,2125,2775870,23262
2020-11-17,Washington,53,140923,2321,2686,25,2805530,17318,141326,1169,2664204,16149
2020-11-17,West Virginia,54,35324,864,598,13,947444,8533,35324,864,912120,7669
2020-11-17,Wisconsin,55,342155,7515,2876,101,2366956,23246,342155,7593,2024801,15653
2020-11-17,Wyoming,56,24453,1260,155,11,152140,-1261,24453,1260,127687,-2521
2020-11-18,Alabama,01,223486,2638,3347,46,1517531,9011,223486,2638,1294045,6373
2020-11-18,Alaska,02,25454,545,94,0,885558,6936,24419,545,861139,6391
2020-11-18,Arizona,04,284554,3270,6365,45,2026755,14963,283102,3206,1743653,11757
2020-11-18,Arkansas,05,137617,1715,2275,30,1552919,12891,137617,1715,1415302,11176
2020-11-18,California,06,1069517,11421,18467,107,21418543,159467,1047789,9811,20370754,149656
2020-11-18,Colorado,08,178224,5004,2669,43,1520268,19919,176694,4650,1343574,15269
2020-11-18,Connecticut,09,97028,2042,4784,13,2860684,34226,97028,2042,2763656,32184
2020-11-18,Delaware,10,29755,203,742,3,386673,1197,29755,203,356918,994
2020-11-18,District of Columbia,11,19465,156,665,5,601412,4670,19465,156,581947,4514
2020-11-18,Florida,12,905240,7925,17730,87,6704999,41461,892352,7727,5812647,33734
2020-11-18,Georgia,13,417934,3113,8833,55,3975069,20647,393890,2424,3581179,18223
2020-11-18,Guam,66,7315,112,101,0,79060,112,6346,112,72714,0
2020-11-18,Hawaii,15,16817,62,222,1,312127,69,16974,69,295153,0
2020-11-18,Idaho,16,87020,1637,815,12,448393,3186,85125,1781,363268,1405
2020-11-18,Illinois,17,608056,8698,11488,161,9359227,103569,606771,8922,8752456,94647
2020-11-18,Indiana,18,270847,6037,5084,59,1989456,20368,268222,6015,1721234,14353
2020-11-18,Iowa,19,197532,4336,2102,38,1003986,6952,174839,3294,829147,3658
2020-11-18,Kansas,20,131051,5383,1326,60,748261,14505,128594,5853,619667,8652
2020-11-18,Kentucky,21,148069,2849,1816,29,2318785,31618,144753,2745,2174032,28873
2020-11-18,Louisiana,22,209914,2229,6184,28,3085849,17519,209914,2229,2875935,15290
2020-11-18,Maine,23,9519,156,170,4,775369,10451,9519,156,765850,10295
2020-11-18,Maryland,24,172204,2011,4351,16,2149335,13734,171823,2018,1977512,11716
2020-11-18,Massachusetts,25,195868,2904,10407,47,3101308,23222,195868,2904,2905440,20318
2020-11-18,Michigan,26,302541,6105,8576,63,5922691,56904,303058,6218,5619633,50686
2020-11-18,Minnesota,27,242099,5094,3066,67,2207809,16616,242043,5094,1965766,11522
2020-11-18,Mississippi,28,137396,1593,3601,20,1044387,1593,137396,1593,906991,0
2020-11-18,Missouri,29,266079,4974,3591,39,1702476,9927,253473,4587,1449003,5340
2020-11-18,Montana,30,50650,1154,568,20,591406,7578,50582,1184,540824,6394
2020-11-18,Nebraska,31,106617,2812,838,11,678985,4846,103805,2204,575180,2642
2020-11-18,Nevada,32,126106,2024,1947,1,895771,3279,125459,1665,770312,1614
2020-11-18,New Hampshire,33,15749,446,504,2,391151,2251,15749,446,375402,1805
2020-11-18,New Jersey,34,291374,4054,16655,37,5466148,91457,289562,4043,5176586,87414
2020-11-18,New Mexico,35,70452,2893,1290,26,1409823,11484,70451,2892,1339372,8592
2020-11-18,New York,36,578826,5282,33607,31,17191129,154434,574072,5294,16617057,149140
2020-11-18,North Carolina,37,322258,3721,4927,46,4731171,33610,320862,3367,4410309,30243
2020-11-18,North Dakota,38,67236,1263,791,16,329888,1648,68208,1341,261680,307
2020-11-18,Northern Mariana Islands,69,103,0,2,0,16570,0,103,0,16467,0
2020-11-18,Ohio,39,318828,6385,5827,55,5370905,6385,318828,6385,5052077,0
2020-11-18,Oklahoma,40,161425,3017,1570,26,1868941,17922,161425,3017,1707516,14905
2020-11-18,Oregon,41,59670,1100,791,12,976850,7028,59669,1099,917181,5929
2020-11-18,Pennsylvania,42,287464,6486,9541,108,2890838,26858,281852,6339,2608986,20519
2020-11-18,Puerto Rico,72,77525,325,971,20,349882,325,43910,325,305972,0
2020-11-18,Rhode Island,44,45911,1383,1284,6,493071,4821,45911,1383,447160,3438
2020-11-18,South Carolina,45,199447,1547,4182,26,2138289,15966,199447,1547,1938842,14419
2020-11-18,South Dakota,46,68671,1387,674,30,300973,2614,68671,1387,232302,1227
2020-11-18,Tennessee,47,319021,4468,4005,52,4200984,24833,325201,4472,3875783,20361
2020-11-18,Texas,48,1125906,13225,20471,193,10039363,118492,1140861,10987,8898502,107505
2020-11-18,Utah,49,162091,3085,742,8,1218943,10826,162028,3071,1056915,7755
2020-11-18,Vermont,50,3161,57,60,1,202100,613,3255,54,198845,559
2020-11-18,Virgin Islands,78,1463,13,23,0,26698,265,1463,13,25235,252
2020-11-18,Virginia,51,208833,2071,3860,25,3003410,20778,208833,2071,2794577,18707
2020-11-18,Washington,53,142511,1588,2704,18,2823740,18210,144780,3454,2678960,14756
2020-11-18,West Virginia,54,36277,953,612,14,960384,12940,36277,953,924107,11987
2020-11-18,Wisconsin,55,350665,8510,2939,63,2387606,20650,350665,8510,2036941,12140
2020-11-18,Wyoming,56,25275,822,155,0,152962,822,25275,822,127687,0
2020-11-19,Alabama,01,225910,2424,3419,72,1533166,15635,225910,2424,1307256,13211
2020-11-19,Alaska,02,25946,492,95,1,898799,13241,24909,490,873890,12751
2020-11-19,Arizona,04,288807,4253,6384,19,2045295,18540,287225,4123,1758070,14417
2020-11-19,Arkansas,05,139855,2238,2297,22,1568140,15221,139855,2238,1428285,12983
2020-11-19,California,06,1082674,13157,18555,88,21552528,133985,1059267,11478,20493261,122507
2020-11-19,Colorado,08,184260,6036,2734,65,1546507,26239,182801,6107,1363706,20132
2020-11-19,Connecticut,09,99381,2353,4805,21,2897280,36596,99381,2353,2797899,34243
2020-11-19,Delaware,10,30153,398,742,0,389021,2348,30153,398,358868,1950
2020-11-19,District of Columbia,11,19678,213,667,2,607834,6422,19678,213,588156,6209
2020-11-19,Florida,12,914325,9085,17809,79,6755524,50525,901234,8882,5854290,41643
2020-11-19,Georgia,13,421381,3447,8867,34,4010676,35607,396641,2751,3614035,32856
2020-11-19,Guam,66,7385,70,102,1,79388,328,6416,70,72972,258
2020-11-19,Hawaii,15,16917,100,222,0,312234,107,17081,107,295153,0
2020-11-19,Idaho,16,88642,1622,838,23,452950,4557,86435,1310,366515,3247
2020-11-19,Illinois,17,622869,14813,11671,183,9472674,113447,621383,14612,8851291,98835
2020-11-19,Indiana,18,278142,7295,5143,59,2009763,20307,275503,7281,1734260,13026
2020-11-19,Iowa,19,201572,4040,2127,25,1011476,7490,178313,3474,833163,4016
2020-11-19,Kansas,20,131408,357,1326,0,748261,0,128594,0,619667,0
2020-11-19,Kentucky,21,151706,3637,1843,27,2355104,36319,148390,3637,2206714,32682
2020-11-19,Louisiana,22,211966,2052,6199,15,3111627,25778,211966,2052,2899661,23726
2020-11-19,Maine,23,9734,215,171,1,788349,12980,9734,215,778615,12765
2020-11-19,Maryland,24,175092,2888,4372,21,2169508,20173,174733,2910,1994775,17263
2020-11-19,Massachusetts,25,198550,2682,10435,28,3123408,22100,198550,2682,2924858,19418
2020-11-19,Michigan,26,310396,7855,8717,141,5992927,70236,311041,7983,5681886,62253
2020-11-19,Minnesota,27,249962,7863,3138,72,2236816,29007,249906,7863,1986910,21144
2020-11-19,Mississippi,28,138791,1395,3619,18,1045782,1395,138791,1395,906991,0
2020-11-19,Missouri,29,270387,4308,3618,27,1712709,10233,257822,4349,1454887,5884
2020-11-19,Montana,30,51872,1222,569,1,595829,4423,51818,1236,544011,3187
2020-11-19,Nebraska,31,109280,2663,863,25,685788,6803,106617,2812,579171,3991
2020-11-19,Nevada,32,128234,2128,1958,11,903173,7402,127875,2416,775298,4986
2020-11-19,New Hampshire,33,16277,528,506,2,395483,4332,16277,528,379206,3804
2020-11-19,New Jersey,34,295556,4182,16689,34,5470330,4182,293744,4182,5176586,0
2020-11-19,New Mexico,35,74116,3664,1302,12,1420797,10974,74116,3665,1346681,7309
2020-11-19,New York,36,584128,5302,33648,41,17386368,195239,579382,5310,16806986,189929
2020-11-19,North Carolina,37,325658,3400,4968,41,4786263,55092,325158,4296,4461105,50796
2020-11-19,North Dakota,38,68618,1382,801,10,332223,2335,69658,1450,262565,885
2020-11-19,Northern Mariana Islands,69,103,0,2,0,16570,0,103,0,16467,0
2020-11-19,Ohio,39,326615,7787,5890,63,5475735,104830,326615,7787,5149120,97043
2020-11-19,Oklahoma,40,164340,2915,1588,18,1890561,21620,164340,2915,1726221,18705
2020-11-19,Oregon,41,60874,1204,809,18,985292,8442,60873,1204,924419,7238
2020-11-19,Pennsylvania,42,294345,6881,9643,102,2918505,27667,288978,7126,2629527,20541
2020-11-19,Puerto Rico,72,78046,521,982,11,350403,521,44431,521,305972,0
2020-11-19,Rhode Island,44,46951,1040,1288,4,496789,3718,46951,1040,449838,2678
2020-11-19,South Carolina,45,201160,1713,4201,19,2162127,23838,201160,1713,1960967,22125
2020-11-19,South Dakota,46,69742,1071,705,31,303269,2296,69742,1071,233527,1225
2020-11-19,Tennessee,47,321832,2811,4082,77,4218632,17648,328088,2887,3890544,14761
2020-11-19,Texas,48,1139695,13789,20689,218,10158442,119079,1155130,14269,9003312,104810
2020-11-19,Utah,49,166040,3949,758,16,1233330,14387,165996,3968,1067334,10419
2020-11-19,Vermont,50,3310,149,61,1,205126,3026,3407,152,201719,2874
2020-11-19,Virgin Islands,78,1469,6,23,0,26940,242,1469,6,25471,236
2020-11-19,Virginia,51,210787,1954,3896,36,3028092,24682,210787,1954,2817305,22728
2020-11-19,Washington,53,144968,2457,2717,13,2848044,24304,147996,3216,2700048,21088
2020-11-19,West Virginia,54,37399,1122,623,11,977539,17155,37399,1122,940140,16033
2020-11-19,Wisconsin,55,358113,7448,3021,82,2407639,20033,358113,7448,2049526,12585
2020-11-19,Wyoming,56,26169,894,176,21,156299,3337,26169,894,130130,2443
2020-11-20,Alabama,01,228373,2463,3451,32,1545177,12011,228373,2463,1316804,9548
2020-11-20,Alaska,02,26403,457,95,0,904712,5913,25369,460,879343,5453
2020-11-20,Arizona,04,292880,4073,6427,43,2072188,26893,291696,4471,1780492,22422
2020-11-20,Arkansas,05,141916,2061,2321,24,1582006,13866,141916,2061,1440090,11805
2020-11-20,California,06,1096401,13727,18649,94,21730551,178023,1072272,13005,20658279,165018
2020-11-20,Colorado,08,190100,5840,2752,18,1572964,26457,188566,5765,1384398,20692
2020-11-20,Connecticut,09,101469,2088,4828,23,2929060,31780,101469,2088,2827591,29692
2020-11-20,Delaware,10,30816,663,746,4,393282,4261,30816,663,362466,3598
2020-11-20,District of Columbia,11,19808,130,669,2,612204,4370,19808,130,592396,4240
2020-11-20,Florida,12,923410,9085,17888,79,6802690,47166,910065,8831,5892625,38335
2020-11-20,Georgia,13,424759,3378,8904,37,4043126,32450,399410,2769,3643716,29681
2020-11-20,Guam,66,7421,36,104,2,79788,400,6452,36,73336,364
2020-11-20,Hawaii,15,17029,112,222,0,312352,118,17199,118,295153,0
2020-11-20,Idaho,16,90346,1704,849,11,457120,4170,87978,1543,369142,2627
2020-11-20,Illinois,17,635823,12954,11814,143,9588698,116024,634395,13012,8954303,103012
2020-11-20,Indiana,18,284960,6818,5206,63,2030938,21175,282311,6808,1748627,14367
2020-11-20,Iowa,19,205918,4346,2159,32,1019474,7998,181790,3477,837684,4521
2020-11-20,Kansas,20,137224,5816,1410,84,763893,15632,134533,5939,629360,9693
2020-11-20,Kentucky,21,155625,3919,1862,19,2381856,26752,152206,3816,2229650,22936
2020-11-20,Louisiana,22,216709,4743,6233,34,3209377,97750,216709,4743,2992668,93007
2020-11-20,Maine,23,9958,224,173,2,795391,7042,9958,224,785433,6818
2020-11-20,Maryland,24,177239,2147,4398,26,2185431,15923,177086,2353,2008345,13570
2020-11-20,Massachusetts,25,200949,2399,10469,34,3148397,24989,200949,2399,2947448,22590
2020-11-20,Michigan,26,320621,10225,8776,59,6076686,83759,321181,10140,5755505,73619
2020-11-20,Minnesota,27,256756,6794,3206,68,2264278,27462,256700,6794,2007578,20668
2020-11-20,Mississippi,28,140429,1638,3642,23,1047420,1638,140429,1638,906991,0
2020-11-20,Missouri,29,275917,5530,3675,57,1724526,11817,262436,4614,1462090,7203
2020-11-20,Montana,30,53346,1474,575,6,601675,5846,53293,1475,548382,4371
2020-11-20,Nebraska,31,111661,2381,917,54,692154,6366,109280,2663,582874,3703
2020-11-20,Nevada,32,130102,1868,1987,29,906394,3221,129714,1839,776680,1382
2020-11-20,New Hampshire,33,16797,520,507,1,399806,4323,16797,520,383009,3803
2020-11-20,New Jersey,34,299182,3626,16712,23,5517700,47370,297370,3626,5220330,43744
2020-11-20,New Mexico,35,77098,2982,1327,25,1433609,12812,77098,2982,1356511,9830
2020-11-20,New York,36,589605,5477,33696,48,17591834,205466,584850,5468,17006984,199998
2020-11-20,North Carolina,37,330021,4363,5012,44,4819029,32766,328846,3688,4490183,29078
2020-11-20,North Dakota,38,70022,1404,824,23,334404,2181,71092,1434,263312,747
2020-11-20,Northern Mariana Islands,69,103,0,2,0,16570,0,103,0,16467,0
2020-11-20,Ohio,39,335423,8808,5955,65,5544189,68454,335423,8808,5208766,59646
2020-11-20,Oklahoma,40,167261,2921,1603,15,1907186,16625,167261,2921,1739925,13704
2020-11-20,Oregon,41,62176,1302,815,6,993753,8461,62175,1302,931578,7159
2020-11-20,Pennsylvania,42,301373,7028,9748,105,2944656,26151,295786,6808,2648870,19343
2020-11-20,Puerto Rico,72,78950,904,991,9,351307,904,45335,904,305972,0
2020-11-20,Rhode Island,44,48001,1050,1294,6,500932,4143,48001,1050,452931,3093
2020-11-20,South Carolina,45,203161,2001,4231,30,2192748,30621,203161,2001,1989587,28620
2020-11-20,South Dakota,46,71070,1328,741,36,306869,3600,71070,1328,235799,2272
2020-11-20,Tennessee,47,325282,3450,4156,74,4240548,21916,331532,3444,3909016,18472
2020-11-20,Texas,48,1153399,13704,20872,183,10279302,120860,1168925,13795,9110377,107065
2020-11-20,Utah,49,170644,4604,776,18,1247675,14345,170584,4588,1077091,9757
2020-11-20,Vermont,50,3459,149,62,1,206450,1324,3551,144,202899,1180
2020-11-20,Virgin Islands,78,1482,13,23,0,27091,151,1482,13,25609,138
2020-11-20,Virginia,51,213331,2544,3912,16,3056992,28900,213331,2544,2843661,26356
2020-11-20,Washington,53,147251,2283,2738,21,2870129,22085,151066,3070,2719063,19015
2020-11-20,West Virginia,54,38480,1081,639,16,994372,16833,38480,1081,955892,15752
2020-11-20,Wisconsin,55,365190,7077,3106,85,2427381,19742,365190,7077,2062191,12665
2020-11-20,Wyoming,56,27129,960,176,0,158917,2618,27129,960,131788,1658
2020-11-21,Alabama,01,230708,2335,3457,6,1555799,10622,230708,2335,1325091,8287
2020-11-21,Alaska,02,27079,676,95,0,918745,14033,26044,675,892701,13358
2020-11-21,Arizona,04,296997,4117,6459,32,2092097,19909,295334,3638,1796763,16271
2020-11-21,Arkansas,05,143821,1905,2337,16,1597546,15540,143821,1905,1453725,13635
2020-11-21,California,06,1109844,13443,18709,60,21971832,241281,1087714,15442,20884118,225839
2020-11-21,Colorado,08,195220,5120,2791,39,1598694,25730,194679,6113,1404015,19617
2020-11-21,Connecticut,09,101469,0,4828,0,2929060,0,101469,0,2827591,0
2020-11-21,Delaware,10,31321,505,746,0,396943,3661,31321,505,365622,3156
2020-11-21,District of Columbia,11,19961,153,670,1,618784,6580,19961,153,598823,6427
2020-11-21,Florida,12,931819,8409,17929,41,6850174,47484,918240,8175,5931934,39309
2020-11-21,Georgia,13,430687,5928,8940,36,4086142,43016,402435,3025,3683707,39991
2020-11-21,Guam,66,7421,0,104,0,79812,24,6476,24,73336,0
2020-11-21,Hawaii,15,17182,153,229,7,312514,162,17361,162,295153,0
2020-11-21,Idaho,16,91312,966,851,2,461195,4075,89764,1786,371431,2289
2020-11-21,Illinois,17,647474,11651,11967,153,9708982,120284,646286,11891,9062696,108393
2020-11-21,Indiana,18,291838,6878,5246,40,2053143,22205,289183,6872,1763960,15333
2020-11-21,Iowa,19,209203,3285,2191,32,1027073,7599,184968,3178,842105,4421
2020-11-21,Kansas,20,137295,71,1411,1,763893,0,134533,0,629360,0
2020-11-21,Kentucky,21,159035,3410,1886,24,2434836,52980,155908,3702,2278928,49278
2020-11-21,Louisiana,22,216709,0,6233,0,3209377,0,216709,0,2992668,0
2020-11-21,Maine,23,10123,165,174,1,795556,165,10123,165,785433,0
2020-11-21,Maryland,24,180125,2886,4415,17,2206289,20858,179971,2885,2026318,17973
2020-11-21,Massachusetts,25,204155,3206,10488,19,3181171,32774,204155,3206,2977016,29568
2020-11-21,Michigan,26,328178,7557,8874,98,6164253,87567,329021,7840,5835232,79727
2020-11-21,Minnesota,27,263008,6252,3257,51,2282358,18080,262952,6252,2019406,11828
2020-11-21,Mississippi,28,142401,1972,3657,15,1049392,1972,142401,1972,906991,0
2020-11-21,Missouri,29,279987,4070,3684,9,1727217,2691,267312,4876,1459905,-2185
2020-11-21,Montana,30,54542,1196,604,29,608502,6827,54542,1249,553960,5578
2020-11-21,Nebraska,31,113029,1368,929,12,698840,6686,111661,2381,587179,4305
2020-11-21,Nevada,32,132610,2508,2017,30,919379,12985,131733,2019,787646,10966
2020-11-21,New Hampshire,33,17281,484,508,1,400533,727,17281,484,383252,243
2020-11-21,New Jersey,34,303851,4669,16746,34,5567342,49642,302039,4669,5265303,44973
2020-11-21,New Mexico,35,79440,2342,1352,25,1444121,10512,79440,2342,1364681,8170
2020-11-21,New York,36,595581,5976,33737,41,17799741,207907,590822,5972,17208919,201935
2020-11-21,North Carolina,37,333074,3053,5035,23,4878076,59047,332261,3415,4545815,55632
2020-11-21,North Dakota,38,71546,1524,840,16,336812,2408,72664,1572,264148,836
2020-11-21,Northern Mariana Islands,69,103,0,2,0,16570,0,103,0,16467,0
2020-11-21,Ohio,39,343286,7863,5984,29,5609595,65406,343286,7863,5266309,57543
2020-11-21,Oklahoma,40,170924,3663,1624,21,1960569,53383,170924,3663,1789645,49720
2020-11-21,Oregon,41,63668,1492,822,7,1001247,7494,63668,1493,937579,6001
2020-11-21,Pennsylvania,42,307247,5874,9862,114,2971240,26584,302564,6778,2668676,19806
2020-11-21,Puerto Rico,72,80049,1099,1012,21,352406,1099,46434,1099,305972,0
2020-11-21,Rhode Island,44,48001,0,1294,0,505662,4730,49406,1405,456256,3325
2020-11-21,South Carolina,45,205018,1857,4274,43,2225252,32504,205018,1857,2020234,30647
2020-11-21,South Dakota,46,72214,1144,777,36,309170,2301,72214,1144,236956,1157
2020-11-21,Tennessee,47,329490,4208,4163,7,4269060,28512,335887,4355,3933173,24157
2020-11-21,Texas,48,1164314,10915,21004,132,10402711,123409,1183847,14922,9218864,108487
2020-11-21,Utah,49,173987,3343,789,13,1259782,12107,173979,3395,1085803,8712
2020-11-21,Vermont,50,3546,87,63,1,209730,3280,3639,88,206091,3192
2020-11-21,Virgin Islands,78,1491,9,23,0,27267,176,1491,9,25776,167
2020-11-21,Virginia,51,215679,2348,3938,26,3093060,36068,215679,2348,2877381,33720
2020-11-21,Washington,53,148691,1440,2738,0,2892499,22370,154148,3082,2738351,19288
2020-11-21,West Virginia,54,39598,1118,658,19,1013043,18671,39598,1118,973445,17553
2020-11-21,Wisconsin,55,372219,7029,3155,49,2446079,18698,372219,7029,2073860,11669
2020-11-21,Wyoming,56,27410,281,176,0,159198,281,27410,281,131788,0
2020-11-22,Alabama,01,232506,1798,3457,0,1563307,7508,232506,1798,1330801,5710
2020-11-22,Alaska,02,27629,550,97,2,926361,7616,26587,543,899774,7073
2020-11-22,Arizona,04,299698,2701,6464,5,2112974,20877,299665,4331,1813309,16546
2020-11-22,Arkansas,05,145173,1352,2357,20,1611627,14081,145173,1352,1466454,12729
2020-11-22,California,06,1118652,8808,18726,17,22237309,265477,1102033,14319,21135276,251158
2020-11-22,Colorado,08,199296,4076,2811,20,1620879,22185,198600,3921,1422279,18264
2020-11-22,Connecticut,09,101469,0,4828,0,2929060,0,101469,0,2827591,0
2020-11-22,Delaware,10,31808,487,748,2,400436,3493,31808,487,368628,3006
2020-11-22,District of Columbia,11,20151,190,670,0,630532,11748,20151,190,610381,11558
2020-11-22,Florida,12,938406,6587,17990,61,6898401,48227,924614,6374,5973787,41853
2020-11-22,Georgia,13,432954,2267,8955,15,4112780,26638,404411,1976,3708369,24662
2020-11-22,Guam,66,7518,97,107,3,79885,73,6549,73,73336,0
2020-11-22,Hawaii,15,17302,120,231,2,312636,122,17483,122,295153,0
2020-11-22,Idaho,16,91935,623,852,1,464547,3352,90834,1070,373713,2282
2020-11-22,Illinois,17,657402,9928,12064,97,9801419,92437,656298,10012,9145121,82425
2020-11-22,Indiana,18,298021,6183,5305,59,2072690,19547,295357,6174,1777333,13373
2020-11-22,Iowa,19,211664,2461,2202,11,1033800,6727,187505,2537,846295,4190
2020-11-22,Kansas,20,137530,235,1410,-1,763893,0,134533,0,629360,0
2020-11-22,Kentucky,21,161222,2187,1887,1,2437028,2192,158100,2192,2278928,0
2020-11-22,Louisiana,22,220192,3483,6260,27,3251946,42569,220192,3483,3031754,39086
2020-11-22,Maine,23,10359,236,176,2,795792,236,10359,236,785433,0
2020-11-22,Maryland,24,182482,2357,4434,19,2225389,19100,182139,2168,2043250,16932
2020-11-22,Massachusetts,25,206850,2695,10512,24,3207055,25884,206850,2695,3000205,23189
2020-11-22,Michigan,26,328833,655,8874,0,6164253,0,329021,0,5835232,0
2020-11-22,Minnesota,27,270213,7205,3297,40,2318754,36396,270157,7205,2048597,29191
2020-11-22,Mississippi,28,143180,779,3676,19,1050171,779,143180,779,906991,0
2020-11-22,Missouri,29,283756,3769,3688,4,1739720,12503,271527,4215,1468193,8288
2020-11-22,Montana,30,55680,1138,607,3,613009,4507,55680,1138,557329,3369
2020-11-22,Nebraska,31,114061,1032,933,4,703689,4849,113029,1368,590660,3481
2020-11-22,Nevada,32,134761,2151,2022,5,925814,6435,133888,2155,791926,4280
2020-11-22,New Hampshire,33,17598,317,512,4,404324,3791,17598,317,386726,3474
2020-11-22,New Jersey,34,307819,3968,16761,15,5621149,53807,306007,3968,5315142,49839
2020-11-22,New Mexico,35,81896,2456,1385,33,1454997,10876,81896,2456,1373101,8420
2020-11-22,New York,36,600967,5386,33767,30,17996351,196610,596214,5392,17400137,191218
2020-11-22,North Carolina,37,336983,3909,5062,27,4947614,69538,336775,4514,4610839,65024
2020-11-22,North Dakota,38,72689,1143,846,6,339048,2236,73844,1180,265204,1056
2020-11-22,Northern Mariana Islands,69,104,1,2,0,16571,1,104,1,16467,0
2020-11-22,Ohio,39,351419,8133,5996,12,5672104,62509,351419,8133,5320685,54376
2020-11-22,Oklahoma,40,174330,3406,1634,10,1963975,3406,174330,3406,1789645,0
2020-11-22,Oregon,41,65170,1502,822,0,1009614,8367,65170,1502,944444,6865
2020-11-22,Pennsylvania,42,313788,6541,9901,39,3000624,29384,309639,7075,2690985,22309
2020-11-22,Puerto Rico,72,81074,1025,1017,5,353431,1025,47459,1025,305972,0
2020-11-22,Rhode Island,44,48001,0,1294,0,509556,3894,50144,738,459412,3156
2020-11-22,South Carolina,45,206295,1277,4283,9,2246568,21316,206295,1277,2040273,20039
2020-11-22,South Dakota,46,73065,851,819,42,311218,2048,73065,851,238153,1197
2020-11-22,Tennessee,47,333853,4363,4218,55,4305687,36627,340476,4589,3965211,32038
2020-11-22,Texas,48,1172848,8534,21083,79,10479272,76561,1193616,9769,9285656,66792
2020-11-22,Utah,49,177176,3189,793,4,1272248,12466,177176,3197,1095072,9269
2020-11-22,Vermont,50,3629,83,63,0,213237,3507,3727,88,209510,3419
2020-11-22,Virgin Islands,78,1504,13,23,0,27479,212,1504,13,25975,199
2020-11-22,Virginia,51,217796,2117,3938,0,3141191,48131,217796,2117,2923395,46014
2020-11-22,Washington,53,149703,1012,2738,0,2910448,17949,157341,3193,2753107,14756
2020-11-22,West Virginia,54,40478,880,662,4,1026969,13926,40478,880,986491,13046
2020-11-22,Wisconsin,55,376238,4019,3162,7,2461490,15411,376238,4019,2085252,11392
2020-11-22,Wyoming,56,28169,759,176,0,159957,759,28169,759,131788,0
2020-11-23,Alabama,01,234080,1574,3459,2,1571821,8514,234080,1574,1337741,6940
2020-11-23,Alaska,02,28128,499,97,0,933016,6655,27085,498,905931,6157
2020-11-23,Arizona,04,303188,3490,6465,1,2133623,20649,302324,2659,1831299,17990
2020-11-23,Arkansas,05,146190,1017,2387,30,1621958,10331,146190,1017,1475768,9314
2020-11-23,California,06,1136346,17694,18768,42,22457544,220235,1110370,8337,21347174,211898
2020-11-23,Colorado,08,203578,4282,2821,10,1640217,19338,202289,3689,1437928,15649
2020-11-23,Connecticut,09,106740,5271,4871,43,3038489,109429,106740,5271,2931749,104158
2020-11-23,Delaware,10,32211,403,752,4,402841,2405,32211,403,370630,2002
2020-11-23,District of Columbia,11,20290,139,672,2,639461,8929,20290,139,619171,8790
2020-11-23,Florida,12,944737,6331,18084,94,6928502,30101,930728,6114,5997774,23987
2020-11-23,Georgia,13,434916,1962,8972,17,4139509,26729,406220,1809,3733289,24920
2020-11-23,Guam,66,7571,53,107,0,80999,1114,6602,53,74397,1061
2020-11-23,Hawaii,15,17405,103,231,0,312749,113,17596,113,295153,0
2020-11-23,Idaho,16,93602,1667,869,17,467362,2815,91653,819,375709,1996
2020-11-23,Illinois,17,665865,8463,12141,77,9892981,91562,664620,8322,9228361,83240
2020-11-23,Indiana,18,303575,5554,5332,27,2090728,18038,300913,5556,1789815,12482
2020-11-23,Iowa,19,214792,3128,2222,20,1040373,6573,189856,2351,850517,4222
2020-11-23,Kansas,20,144831,7301,1462,52,784288,20395,142059,7526,642229,12869
2020-11-23,Kentucky,21,163767,2545,1906,19,2469063,32035,160232,2132,2308831,29903
2020-11-23,Louisiana,22,221160,968,6284,24,3262192,10246,221160,968,3041032,9278
2020-11-23,Maine,23,10544,185,177,1,825349,29557,10544,185,814805,29372
2020-11-23,Maryland,24,184140,1658,4448,14,2238492,13103,183797,1658,2054695,11445
2020-11-23,Massachusetts,25,208623,1773,10531,19,3222588,15533,208623,1773,3013965,13760
2020-11-23,Michigan,26,340223,11390,8937,63,6263536,99283,340964,11943,5922572,87340
2020-11-23,Minnesota,27,276556,6343,3321,24,2345719,26965,276500,6343,2069219,20622
2020-11-23,Mississippi,28,143879,699,3676,0,1091151,40980,143879,699,947272,40281
2020-11-23,Missouri,29,288308,4552,3697,9,1750096,10376,274897,3370,1475199,7006
2020-11-23,Montana,30,56428,748,615,8,617974,4965,56381,701,561593,4264
2020-11-23,Nebraska,31,115921,1860,958,25,706758,3069,114061,1032,592697,2037
2020-11-23,Nevada,32,136672,1911,2030,8,933588,7774,136227,2339,797361,5435
2020-11-23,New Hampshire,33,18042,444,512,0,406227,1903,18042,444,388185,1459
2020-11-23,New Jersey,34,311400,3581,16772,11,5675266,54117,309588,3581,5365678,50536
2020-11-23,New Mexico,35,84148,2252,1402,17,1464452,9455,84148,2252,1380304,7203
2020-11-23,New York,36,606878,5911,33804,37,18187840,191489,602120,5906,17585720,185583
2020-11-23,North Carolina,37,339672,2689,5076,14,4983768,36154,339194,2419,4644574,33735
2020-11-23,North Dakota,38,73403,714,852,6,340642,1594,74556,712,266086,882
2020-11-23,Northern Mariana Islands,69,104,0,2,0,16851,280,104,0,16747,280
2020-11-23,Ohio,39,363304,11885,6020,24,5683989,11885,363304,11885,5320685,0
2020-11-23,Oklahoma,40,177874,3544,1649,15,1967519,3544,177874,3544,1789645,0
2020-11-23,Oregon,41,66334,1164,830,8,1016282,6668,66333,1163,949949,5505
2020-11-23,Pennsylvania,42,320250,6462,9932,31,3019571,18947,314401,4762,2705170,14185
2020-11-23,Puerto Rico,72,81815,741,1032,15,354172,741,48200,741,305972,0
2020-11-23,Rhode Island,44,50573,2572,1309,15,511665,2109,50573,429,461092,1680
2020-11-23,South Carolina,45,207552,1257,4288,5,2267605,21037,207552,1257,2060053,19780
2020-11-23,South Dakota,46,73848,783,819,0,313297,2079,73848,783,239449,1296
2020-11-23,Tennessee,47,337637,3784,4254,36,4334644,28957,344550,4074,3990094,24883
2020-11-23,Texas,48,1184041,11193,21144,61,10535383,56111,1201257,7641,9334126,48470
2020-11-23,Utah,49,179420,2244,799,6,1279344,7096,179420,2244,1099924,4852
2020-11-23,Vermont,50,3714,85,63,0,214996,1759,3795,68,211201,1691
2020-11-23,Virgin Islands,78,1507,3,23,0,27479,0,1504,0,25975,0
2020-11-23,Virginia,51,221038,3242,3942,4,3183955,42764,221038,3242,2962917,39522
2020-11-23,Washington,53,155336,5633,2775,37,2912338,1890,159231,1890,2753107,0
2020-11-23,West Virginia,54,41114,636,667,5,1038846,11877,41114,636,997732,11241
2020-11-23,Wisconsin,55,379693,3455,3175,13,2474141,12651,379693,3455,2094448,9196
2020-11-23,Wyoming,56,29431,1262,202,26,161219,1262,29431,1262,131788,0
2020-11-24,Alabama,01,236865,2785,3472,13,1583882,12061,236865,2785,1347017,9276
2020-11-24,Alaska,02,28708,580,110,13,943401,10385,27669,584,915732,9801
2020-11-24,Arizona,04,307943,4755,6515,50,2148901,15278,306868,4544,1842033,10734
2020-11-24,Arkansas,05,148312,2122,2405,18,1635389,13431,148312,2122,1487077,11309
2020-11-24,California,06,1153005,16659,18875,107,22741363,283819,1125699,15329,21615664,268490
2020-11-24,Colorado,08,207882,4304,2868,47,1654599,14382,206439,4150,1448160,10232
2020-11-24,Connecticut,09,107280,540,4881,10,3051730,13241,107280,540,2944450,12701
2020-11-24,Delaware,10,32664,453,757,5,406207,3366,32664,453,373543,2913
2020-11-24,District of Columbia,11,20409,119,673,1,648922,9461,20409,119,628513,9342
2020-11-24,Florida,12,953292,8555,18156,72,6982425,53923,938830,8102,6043595,45821
2020-11-24,Georgia,13,438441,3525,8979,7,4173943,34434,408644,2424,3765299,32010
2020-11-24,Guam,66,7624,53,108,1,81600,601,6655,53,74945,548
2020-11-24,Hawaii,15,17461,56,231,0,312809,60,17656,60,295153,0
2020-11-24,Idaho,16,95588,1986,881,12,470788,3426,93090,1437,377698,1989
2020-11-24,Illinois,17,675543,9678,12294,153,9990304,97323,674089,9469,9316215,87854
2020-11-24,Indiana,18,309218,5643,5435,103,2107744,17016,306538,5625,1801206,11391
2020-11-24,Iowa,19,217786,2994,2271,49,1044789,4416,191152,1296,853637,3120
2020-11-24,Kansas,20,145272,441,1456,-6,784288,0,142059,0,642229,0
2020-11-24,Kentucky,21,166478,2711,1938,32,2498456,29393,162838,2606,2335618,26787
2020-11-24,Louisiana,22,224403,3243,6323,39,3296384,34192,224403,3243,3071981,30949
2020-11-24,Maine,23,10799,255,189,12,833554,8205,10799,255,822755,7950
2020-11-24,Maryland,24,185812,1672,4481,33,2252024,13532,185464,1667,2066560,11865
2020-11-24,Massachusetts,25,211199,2576,10551,20,3245573,22985,211199,2576,3034374,20409
2020-11-24,Michigan,26,347076,6853,9094,157,6334377,70841,347746,6782,5986631,64059
2020-11-24,Minnesota,27,282972,6416,3359,38,2370205,24486,282916,6416,2087289,18070
2020-11-24,Mississippi,28,144544,665,3729,53,1091816,665,144544,665,947272,0
2020-11-24,Missouri,29,292786,4478,3869,172,1759203,9107,278661,3764,1480542,5343
2020-11-24,Montana,30,57559,1131,630,15,622796,4822,57504,1123,565292,3699
2020-11-24,Nebraska,31,117682,1761,981,23,711971,5213,115921,1860,596050,3353
2020-11-24,Nevada,32,140572,3900,2053,23,943726,10138,139080,2853,804646,7285
2020-11-24,New Hampshire,33,18382,340,513,1,407668,1441,18382,340,389286,1101
2020-11-24,New Jersey,34,315675,4275,16819,47,5725579,50313,313863,4275,5411716,46038
2020-11-24,New Mexico,35,86247,2099,1430,28,1477284,12832,86247,2099,1391037,10733
2020-11-24,New York,36,611756,4878,33847,43,18352601,164761,607001,4881,17745600,159880
2020-11-24,North Carolina,37,343566,3894,5114,38,5028737,44969,342294,3100,4686443,41869
2020-11-24,North Dakota,38,74407,1004,889,37,342254,1612,75622,1066,266632,546
2020-11-24,Northern Mariana Islands,69,104,0,2,0,16851,0,104,0,16747,0
2020-11-24,Ohio,39,371908,8604,6118,98,5804292,120303,371908,8604,5432384,111699
2020-11-24,Oklahoma,40,180610,2736,1664,15,2011009,43490,180610,2736,1830399,40754
2020-11-24,Oregon,41,67337,1003,848,18,1024582,8300,67333,1000,957249,7300
2020-11-24,Pennsylvania,42,326615,6365,10014,82,3044438,24867,321070,6669,2723368,18198
2020-11-24,Puerto Rico,72,82163,348,1038,6,354520,348,48548,348,305972,0
2020-11-24,Rhode Island,44,51424,851,1325,16,515643,3978,51424,851,464219,3127
2020-11-24,South Carolina,45,209230,1678,4313,25,2287492,19887,209230,1678,2078262,18209
2020-11-24,South Dakota,46,74859,1011,821,2,315794,2497,74859,1011,240935,1486
2020-11-24,Tennessee,47,339059,1422,4325,71,4340462,5818,345854,1304,3994608,4514
2020-11-24,Texas,48,1204464,20423,21338,194,10685278,149895,1217837,16580,9467441,133315
2020-11-24,Utah,49,182121,2701,810,11,1291122,11778,182121,2701,1109001,9077
2020-11-24,Vermont,50,3762,48,64,1,216292,1296,3845,50,212447,1246
2020-11-24,Virgin Islands,78,1521,14,23,0,27734,255,1507,3,26227,252
2020-11-24,Virginia,51,223582,2544,3979,37,3210565,26610,223582,2544,2986983,24066
2020-11-24,Washington,53,158234,2898,2807,32,2913743,1405,160636,1405,2753107,0
2020-11-24,West Virginia,54,42083,969,682,15,1053635,14789,42083,969,1011552,13820
2020-11-24,Wisconsin,55,386441,6748,3295,120,2491197,17056,386441,6748,2104756,10308
2020-11-24,Wyoming,56,29959,528,202,0,161747,528,29959,528,131788,0
2020-11-25,Alabama,01,239318,2453,3532,60,1593279,9397,239318,2453,1353961,6944
2020-11-25,Alaska,02,29386,678,110,0,954276,10875,28339,670,925937,10205
2020-11-25,Arizona,04,311727,3784,6529,14,2166252,17351,310850,3982,1855402,13369
2020-11-25,Arkansas,05,150277,1965,2425,20,1650534,15145,150277,1965,1500257,13180
2020-11-25,California,06,1167149,14144,18982,107,22910351,168988,1144049,18350,21766302,150638
2020-11-25,Colorado,08,212416,4534,2930,62,1671722,17123,210630,4191,1461092,12932
2020-11-25,Connecticut,09,109152,1872,4926,45,3083113,31383,109152,1872,2973961,29511
2020-11-25,Delaware,10,32995,331,760,3,408654,2447,32995,331,375659,2116
2020-11-25,District of Columbia,11,20516,107,677,4,650235,1313,20516,107,629719,1206
2020-11-25,Florida,12,961668,8376,18253,97,7028635,46210,946956,8126,6081679,38084
2020-11-25,Georgia,13,441737,3296,9054,75,4195929,21986,411002,2358,3784927,19628
2020-11-25,Guam,66,7674,50,110,2,82709,1109,6705,50,76004,1059
2020-11-25,Hawaii,15,17561,100,233,2,312917,108,17764,108,295153,0
2020-11-25,Idaho,16,97007,1419,901,20,474042,3254,94730,1640,379312,1614
2020-11-25,Illinois,17,686855,11312,12465,171,10104537,114233,685467,11378,9419070,102855
2020-11-25,Indiana,18,315212,5994,5498,63,2126395,18651,312521,5983,1813874,12668
2020-11-25,Iowa,19,221288,3502,2312,41,1050640,5851,194395,3243,856245,2608
2020-11-25,Kansas,20,150515,5243,1503,47,799185,14897,147797,5738,651388,9159
2020-11-25,Kentucky,21,169822,3344,1975,37,2508849,10393,166139,3301,2342710,7092
2020-11-25,Louisiana,22,225638,1235,6350,27,3310705,14321,225638,1235,3085067,13086
2020-11-25,Maine,23,11027,228,190,1,841090,7536,11027,228,830063,7308
2020-11-25,Maryland,24,188509,2697,4518,37,2270660,18636,188161,2697,2082499,15939
2020-11-25,Massachusetts,25,214594,3395,10604,53,3275409,29836,214594,3395,3060815,26441
2020-11-25,Michigan,26,352052,4976,9168,74,6392563,58186,352433,4687,6040130,53499
2020-11-25,Minnesota,27,289362,6390,3434,75,2403190,32985,289303,6387,2113887,26598
2020-11-25,Mississippi,28,145636,1092,3745,16,1092908,1092,145636,1092,947272,0
2020-11-25,Missouri,29,297374,4588,3908,39,1770305,11102,282792,4131,1487513,6971
2020-11-25,Montana,30,58620,1061,653,23,627851,5055,58565,1061,569286,3994
2020-11-25,Nebraska,31,120076,2394,1004,23,716768,4797,117682,1761,599086,3036
2020-11-25,Nevada,32,142951,2379,2077,24,950716,6990,142239,3159,808477,3831
2020-11-25,New Hampshire,33,18776,394,514,1,411047,3379,18776,394,392271,2985
2020-11-25,New Jersey,34,319734,4059,16886,67,5827339,101760,317905,4042,5509434,97718
2020-11-25,New Mexico,35,88102,1855,1451,21,1487840,10556,88102,1855,1399738,8701
2020-11-25,New York,36,618023,6267,33890,43,18525686,173085,613266,6265,17912420,166820
2020-11-25,North Carolina,37,348102,4536,5177,63,5084569,55832,346506,4212,4738063,51620
2020-11-25,North Dakota,38,75484,1077,893,4,344165,1911,76806,1184,267359,727
2020-11-25,Northern Mariana Islands,69,104,0,2,0,16851,0,104,0,16747,0
2020-11-25,Ohio,39,382743,10835,6274,156,5856888,52596,382743,10835,5474145,41761
2020-11-25,Oklahoma,40,184342,3732,1680,16,2032905,21896,184342,3732,1848563,18164
2020-11-25,Oregon,41,68504,1167,871,23,1028972,4390,68503,1170,960469,3220
2020-11-25,Pennsylvania,42,333571,6956,10162,148,3071050,26612,327829,6759,2743221,19853
2020-11-25,Puerto Rico,72,82340,177,1052,14,354697,177,48725,177,305972,0
2020-11-25,Rhode Island,44,52317,893,1335,10,515106,-537,52317,893,462789,-1430
2020-11-25,South Carolina,45,210905,1675,4317,4,2308163,20671,210905,1675,2097258,18996
2020-11-25,South Dakota,46,76142,1283,849,28,318354,2560,76142,1283,242212,1277
2020-11-25,Tennessee,47,341456,2397,4415,90,4354895,14433,347972,2118,4006923,12315
2020-11-25,Texas,48,1219392,14928,21536,198,10819214,133936,1236648,18811,9582566,115125
2020-11-25,Utah,49,183960,1839,834,24,1297873,6751,183902,1781,1113971,4970
2020-11-25,Vermont,50,3827,65,64,0,218195,1903,3938,93,214257,1810
2020-11-25,Virgin Islands,78,1521,0,23,0,28036,302,1521,14,26515,288
2020-11-25,Virginia,51,226300,2718,4008,29,3237740,27175,226300,2718,3011440,24457
2020-11-25,Washington,53,161207,2973,2825,18,2917421,3678,164314,3678,2753107,0
2020-11-25,West Virginia,54,43050,967,695,13,1069343,15708,43050,967,1026293,14741
2020-11-25,Wisconsin,55,392443,6002,3363,68,2508987,17790,392438,5997,2116549,11793
2020-11-25,Wyoming,56,30761,802,215,13,162549,802,30761,802,131788,0
2020-11-26,Alabama,01,241957,2639,3572,40,1603144,9865,241957,2639,1361187,7226
2020-11-26,Alaska,02,29940,554,113,3,969573,15297,28892,553,940681,14744
2020-11-26,Arizona,04,314326,2599,6568,39,2188188,21936,314326,3476,1873862,18460
2020-11-26,Arkansas,05,152625,2348,2436,11,1665827,15293,152625,2348,1513202,12945
2020-11-26,California,06,1176137,8988,19025,43,23096745,186394,1158689,14640,21938056,171754
2020-11-26,Colorado,08,217655,5239,2977,47,1699645,27923,216683,6053,1482962,21870
2020-11-26,Connecticut,09,109152,0,4926,0,3083113,0,109152,0,2973961,0
2020-11-26,Delaware,10,33579,584,761,1,412412,3758,33579,584,378833,3174
2020-11-26,District of Columbia,11,20736,220,677,0,663201,12966,20736,220,642465,12746
2020-11-26,Florida,12,961668,0,18253,0,7028635,0,946956,0,6081679,0
2020-11-26,Georgia,13,445204,3467,9089,35,4226691,30762,413909,2907,3812782,27855
2020-11-26,Guam,66,7717,43,112,2,82752,43,6748,43,76004,0
2020-11-26,Hawaii,15,17678,117,235,2,313034,117,17881,117,295153,0
2020-11-26,Idaho,16,97007,0,901,0,478886,4844,96503,1773,382383,3071
2020-11-26,Illinois,17,698364,11509,12609,144,10212093,107556,697489,12022,9514604,95534
2020-11-26,Indiana,18,321595,6383,5561,63,2145727,19332,318894,6373,1826833,12959
2020-11-26,Iowa,19,223323,2035,2349,37,1057718,7078,197086,2691,860632,4387
2020-11-26,Kansas,20,150522,7,1503,0,799185,0,147797,0,651388,0
2020-11-26,Kentucky,21,170081,259,1983,8,2508849,0,166139,0,2342710,0
2020-11-26,Louisiana,22,225638,0,6350,0,3310705,0,225638,0,3085067,0
2020-11-26,Maine,23,11265,238,190,0,841328,238,11265,238,830063,0
2020-11-26,Maryland,24,190635,2126,4547,29,2287167,16507,190480,2319,2096687,14188
2020-11-26,Massachusetts,25,214594,0,10604,0,3275409,0,214594,0,3060815,0
2020-11-26,Michigan,26,352342,290,9169,1,6392563,0,352433,0,6040130,0
2020-11-26,Minnesota,27,289362,0,3434,0,2403190,0,289303,0,2113887,0
2020-11-26,Mississippi,28,147382,1746,3763,18,1094654,1746,147382,1746,947272,0
2020-11-26,Missouri,29,300825,3451,3932,24,1782717,12412,287263,4471,1495454,7941
2020-11-26,Montana,30,59682,1062,658,5,631927,4076,59682,1117,572245,2959
2020-11-26,Nebraska,31,122952,2876,1008,4,723010,6242,120076,2394,602934,3848
2020-11-26,Nevada,32,144794,1843,2093,16,959193,8477,144781,2542,814412,5935
2020-11-26,New Hampshire,33,18776,0,514,0,411047,0,18776,0,392271,0
2020-11-26,New Jersey,34,324207,4473,16925,39,5831812,4473,322378,4473,5509434,0
2020-11-26,New Mexico,35,89796,1694,1469,18,1504856,17016,89796,1694,1415060,15322
2020-11-26,New York,36,624961,6938,33959,69,18743407,217721,620199,6933,18123208,210788
2020-11-26,North Carolina,37,348148,46,5177,0,5084569,0,346506,0,4738063,0
2020-11-26,North Dakota,38,76448,964,903,10,346125,1960,77813,1007,268312,953
2020-11-26,Northern Mariana Islands,69,104,0,2,0,16851,0,104,0,16747,0
2020-11-26,Ohio,39,382743,0,6274,0,5856888,0,382743,0,5474145,0
2020-11-26,Oklahoma,40,184342,0,1680,0,2057810,24905,184342,0,1873468,24905
2020-11-26,Oregon,41,70006,1502,884,13,1030663,1691,70006,1503,960657,188
2020-11-26,Pennsylvania,42,340998,7427,10271,109,3101483,30433,336254,8425,2765229,22008
2020-11-26,Puerto Rico,72,82841,501,1069,17,355198,501,49226,501,305972,0
2020-11-26,Rhode Island,44,52317,0,1335,0,518855,3749,53491,1174,465364,2575
2020-11-26,South Carolina,45,210905,0,4317,0,2308163,0,210905,0,2097258,0
2020-11-26,South Dakota,46,76142,0,849,0,318354,0,76142,0,242212,0
2020-11-26,Tennessee,47,345371,3915,4468,53,4391717,36822,352376,4404,4039341,32418
2020-11-26,Texas,48,1223896,4504,21709,173,10935976,116762,1251345,14697,9684631,102065
2020-11-26,Utah,49,184382,422,834,0,1297873,0,183902,0,1113971,0
2020-11-26,Vermont,50,3827,0,64,0,219897,1702,4017,79,215880,1623
2020-11-26,Virgin Islands,78,1521,0,23,0,28036,0,1521,0,26515,0
2020-11-26,Virginia,51,228900,2600,4029,21,3261387,23647,228900,2600,3032487,21047
2020-11-26,Washington,53,161911,704,2825,0,2920578,3157,167471,3157,2753107,0
2020-11-26,West Virginia,54,44180,1130,712,17,1085099,15756,44180,1130,1040919,14626
2020-11-26,Wisconsin,55,398104,5661,3431,68,2523306,14319,398104,5666,2125202,8653
2020-11-26,Wyoming,56,30761,0,215,0,162549,0,30761,0,131788,0
2020-11-27,Alabama,01,242874,917,3572,0,1608114,4970,242874,917,1365240,4053
2020-11-27,Alaska,02,30612,672,113,0,990773,21200,29554,662,961219,20538
2020-11-27,Arizona,04,318695,4369,6588,20,2213289,25101,318638,4312,1894651,20789
2020-11-27,Arkansas,05,153677,1052,2436,0,1674767,8940,153677,1052,1521090,7888
2020-11-27,California,06,1193071,16934,19100,75,23315918,219173,1171324,12635,22144594,206538
2020-11-27,Colorado,08,222544,4889,2998,21,1717407,17762,220953,4270,1496454,13492
2020-11-27,Connecticut,09,112581,3429,4961,35,3154617,71504,112581,3429,3042036,68075
2020-11-27,Delaware,10,34170,591,763,2,416059,3647,34170,591,381889,3056
2020-11-27,District of Columbia,11,20937,201,677,0,672439,9238,20937,201,651502,9037
2020-11-27,Florida,12,979012,17344,18362,109,7130836,102201,963751,16795,6167085,85406
2020-11-27,Georgia,13,447942,2738,9130,41,4258413,31722,416303,2394,3842110,29328
2020-11-27,Guam,66,7737,20,113,1,83201,449,6768,20,76433,429
2020-11-27,Hawaii,15,17796,118,238,3,313159,125,18006,125,295153,0
2020-11-27,Idaho,16,99148,2141,914,13,478886,0,96503,0,382383,0
2020-11-27,Illinois,17,706123,7759,12705,96,10289223,77130,705063,7574,9584160,69556
2020-11-27,Indiana,18,327234,5639,5594,33,2162110,16383,324537,5643,1837573,10740
2020-11-27,Iowa,19,225065,1742,2360,11,1060478,2760,198222,1136,862256,1624
2020-11-27,Kansas,20,155245,4723,1529,26,812424,13239,153021,5224,659403,8015
2020-11-27,Kentucky,21,174684,4603,2009,26,2558059,49210,171755,5616,2386304,43594
2020-11-27,Louisiana,22,230602,4964,6391,41,3378743,68038,230602,4964,3148141,63074
2020-11-27,Maine,23,11265,0,190,0,841328,0,11265,0,830063,0
2020-11-27,Maryland,24,193205,2570,4569,22,2305545,18378,192858,2378,2112687,16000
2020-11-27,Massachusetts,25,219252,4658,10635,31,3309180,33771,219252,4658,3089928,29113
2020-11-27,Michigan,26,369022,16680,9352,183,6513757,121194,369801,17368,6143956,103826
2020-11-27,Minnesota,27,295060,5698,3535,101,2426221,23031,295001,5698,2131220,17333
2020-11-27,Mississippi,28,148387,1005,3769,6,1095659,1005,148387,1005,947272,0
2020-11-27,Missouri,29,304234,3409,3943,11,1791413,8696,290536,3273,1500877,5423
2020-11-27,Montana,30,59796,114,658,0,642514,10587,59796,114,582718,10473
2020-11-27,Nebraska,31,124068,1116,1014,6,731641,8631,122952,2876,608689,5755
2020-11-27,Nevada,32,147145,2351,2103,10,965745,6552,146317,1536,819428,5016
2020-11-27,New Hampshire,33,19313,537,517,3,413290,2243,19313,537,393977,1706
2020-11-27,New Jersey,34,328302,4095,16942,17,5835907,4095,326473,4095,5509434,0
2020-11-27,New Mexico,35,91852,2056,1504,35,1521747,16891,91852,2056,1429895,14835
2020-11-27,New York,36,633140,8179,34004,45,18962849,219442,628375,8176,18334474,211266
2020-11-27,North Carolina,37,355664,7516,5240,63,5192822,108253,354514,8008,4838308,100245
2020-11-27,North Dakota,38,77238,790,908,5,347403,1278,78564,751,268839,527
2020-11-27,Northern Mariana Islands,69,104,0,2,0,16851,0,104,0,16747,0
2020-11-27,Ohio,39,399808,17065,6346,72,5919541,62653,399808,17065,5519733,45588
2020-11-27,Oklahoma,40,187567,3225,1704,24,2061035,3225,187567,3225,1873468,0
2020-11-27,Oregon,41,70833,827,890,6,1031436,773,70832,826,960604,-53
2020-11-27,Pennsylvania,42,349360,8362,10295,24,3129689,28206,343614,7360,2786075,20846
2020-11-27,Puerto Rico,72,84293,1452,1076,7,356650,1452,50678,1452,305972,0
2020-11-27,Rhode Island,44,53954,1637,1346,11,520851,1996,53954,463,466897,1533
2020-11-27,South Carolina,45,213120,2215,4346,29,2339037,30874,213120,2215,2125917,28659
2020-11-27,South Dakota,46,78280,2138,888,39,323484,5130,78280,2138,245204,2992
2020-11-27,Tennessee,47,349506,4135,4475,7,4426634,34917,356716,4340,4069918,30577
2020-11-27,Texas,48,1228649,4753,21762,53,10949176,13200,1255332,3987,9693844,9213
2020-11-27,Utah,49,190044,5662,849,15,1318355,20482,190044,6142,1128311,14340
2020-11-27,Vermont,50,4005,178,67,3,220964,1067,4115,98,216849,969
2020-11-27,Virgin Islands,78,1521,0,23,0,28036,0,1521,0,26515,0
2020-11-27,Virginia,51,230444,1544,4044,15,3294522,33135,230444,1544,3064078,31591
2020-11-27,Washington,53,165230,3319,2828,3,2923514,2936,170407,2936,2753107,0
2020-11-27,West Virginia,54,45046,866,712,0,1102054,16955,45046,866,1057008,16089
2020-11-27,Wisconsin,55,399557,1453,3444,13,2533226,9920,399526,1422,2133700,8498
2020-11-27,Wyoming,56,31773,1012,215,0,170677,8128,31773,1012,138904,7116
2020-11-28,Alabama,01,244993,2119,3572,0,1614785,6671,244993,2119,1369792,4552
2020-11-28,Alaska,02,31279,667,115,2,999054,8281,30204,650,968850,7631
2020-11-28,Arizona,04,322774,4079,6624,36,2227793,14504,322774,4136,1905019,10368
2020-11-28,Arkansas,05,155026,1349,2449,13,1684540,9773,155026,1349,1529514,8424
2020-11-28,California,06,1206278,13207,19132,32,23573182,257264,1183320,11996,22389862,245268
2020-11-28,Colorado,08,226567,4023,3012,14,1735542,18135,225283,4330,1510259,13805
2020-11-28,Connecticut,09,112581,0,4961,0,3154617,0,112581,0,3042036,0
2020-11-28,Delaware,10,34670,500,763,0,419244,3185,34670,500,384574,2685
2020-11-28,District of Columbia,11,21308,371,678,1,685338,12899,21308,371,664030,12528
2020-11-28,Florida,12,985289,6277,18441,79,7167102,36266,969813,6062,6197289,30204
2020-11-28,Georgia,13,450627,2685,9173,43,4289024,30611,418936,2633,3870088,27978
2020-11-28,Guam,66,7751,14,113,0,83215,14,6782,14,76433,0
2020-11-28,Hawaii,15,17871,75,238,0,313235,76,18082,76,295153,0
2020-11-28,Idaho,16,99984,836,919,5,483659,4773,98500,1997,385159,2776
2020-11-28,Illinois,17,714070,7947,12852,147,10368278,79055,712936,7873,9655342,71182
2020-11-28,Indiana,18,331725,4491,5663,69,2174751,12641,329008,4471,1845743,8170
2020-11-28,Iowa,19,227181,2116,2375,15,1063681,3203,199683,1461,863998,1742
2020-11-28,Kansas,20,155265,20,1529,0,812424,0,153021,0,659403,0
2020-11-28,Kentucky,21,177453,2769,2028,19,2578361,20302,174182,2427,2404179,17875
2020-11-28,Louisiana,22,230602,0,6391,0,3378743,0,230602,0,3148141,0
2020-11-28,Maine,23,11288,23,191,1,841351,23,11288,23,830063,0
2020-11-28,Maryland,24,194603,1398,4602,33,2317570,12025,194448,1590,2123122,10435
2020-11-28,Massachusetts,25,222469,3217,10676,41,3327434,18254,222469,3217,3104965,15037
2020-11-28,Michigan,26,377279,8257,9461,109,6574441,60684,378152,8351,6196289,52333
2020-11-28,Minnesota,27,304082,9022,3580,45,2474553,48332,304023,9022,2170530,39310
2020-11-28,Mississippi,28,149940,1553,3779,10,1097212,1553,149940,1553,947272,0
2020-11-28,Missouri,29,306526,2292,3950,7,1797533,6120,292740,2204,1504793,3916
2020-11-28,Montana,30,60845,1049,670,12,645393,2879,60845,1049,584548,1830
2020-11-28,Nebraska,31,125323,1255,1018,4,734480,2839,124066,1114,610414,1725
2020-11-28,Nevada,32,149613,2468,2123,20,973116,7371,149229,2912,823887,4459
2020-11-28,New Hampshire,33,20002,689,523,6,416158,2868,20002,689,396156,2179
2020-11-28,New Jersey,34,332104,3802,16965,23,5943584,107677,330275,3802,5613309,103875
2020-11-28,New Mexico,35,93982,2130,1527,23,1536202,14455,93982,2130,1442220,12325
2020-11-28,New York,36,639200,6060,34049,45,19115204,152355,634438,6063,18480766,146292
2020-11-28,North Carolina,37,358654,2990,5249,9,5244854,52032,357958,3444,4886896,48588
2020-11-28,North Dakota,38,77941,703,921,13,348805,1402,79359,795,269446,607
2020-11-28,Northern Mariana Islands,69,104,0,2,0,16851,0,104,0,16747,0
2020-11-28,Ohio,39,406703,6895,6378,32,6028709,109168,406703,6895,5622006,102273
2020-11-28,Oklahoma,40,193824,6257,1717,13,2067292,6257,193824,6257,1873468,0
2020-11-28,Oregon,41,72506,1673,899,9,1033150,1714,72506,1674,960644,40
2020-11-28,Pennsylvania,42,356243,6883,10337,42,3156131,26442,351667,8053,2804464,18389
2020-11-28,Puerto Rico,72,85196,903,1083,7,357553,903,51581,903,305972,0
2020-11-28,Rhode Island,44,53954,0,1346,0,523428,2577,55017,1063,468411,1514
2020-11-28,South Carolina,45,214911,1791,4346,0,2370233,31196,214911,1791,2155322,29405
2020-11-28,South Dakota,46,79099,819,942,54,325376,1892,79099,819,246277,1073
2020-11-28,Tennessee,47,355885,6379,4489,14,4470321,43687,363466,6750,4106855,36937
2020-11-28,Texas,48,1234675,6026,21847,85,11021226,72050,1259657,4325,9761569,67725
2020-11-28,Utah,49,192087,2043,863,14,1325093,6738,192087,2043,1133006,4695
2020-11-28,Vermont,50,4033,28,67,0,221496,532,4155,40,217341,492
2020-11-28,Virgin Islands,78,1540,19,23,0,28272,236,1538,17,26734,219
2020-11-28,Virginia,51,233617,3173,4054,10,3320656,26134,233617,3173,3087039,22961
2020-11-28,Washington,53,166736,1506,2828,0,2924044,530,170937,530,2753107,0
2020-11-28,West Virginia,54,45845,799,718,6,1115015,12961,45845,799,1069170,12162
2020-11-28,Wisconsin,55,404999,5442,3474,30,2543109,9883,404999,5473,2138110,4410
2020-11-28,Wyoming,56,31929,156,215,0,170833,156,31929,156,138904,0
2020-11-29,Alabama,01,247229,2236,3577,5,1620999,6214,247229,2236,1373770,3978
2020-11-29,Alaska,02,31896,617,115,0,1006180,7126,30816,612,975364,6514
2020-11-29,Arizona,04,325995,3221,6635,11,2246314,18521,325995,3221,1920319,15300
2020-11-29,Arkansas,05,156247,1221,2470,21,1694985,10445,156247,1221,1538738,9224
2020-11-29,California,06,1219496,13218,19151,19,23807501,234319,1198934,15614,22608567,218705
2020-11-29,Colorado,08,230057,3490,3025,13,1748078,12536,228772,3489,1519306,9047
2020-11-29,Connecticut,09,112581,0,4961,0,3154617,0,112581,0,3042036,0
2020-11-29,Delaware,10,35251,581,770,7,422384,3140,35251,581,387133,2559
2020-11-29,District of Columbia,11,21448,140,680,2,690342,5004,21448,140,668894,4864
2020-11-29,Florida,12,992652,7363,18499,58,7204335,37233,976944,7131,6227391,30102
2020-11-29,Georgia,13,452322,1695,9189,16,4302927,13903,420601,1665,3882326,12238
2020-11-29,Guam,66,7787,36,113,0,83251,36,6818,36,76433,0
2020-11-29,Hawaii,15,17925,54,242,4,313291,56,18138,56,295153,0
2020-11-29,Idaho,16,100758,774,925,6,486067,2408,99660,1160,386407,1248
2020-11-29,Illinois,17,721487,7417,12895,43,10431018,62740,720114,7178,9710904,55562
2020-11-29,Indiana,18,336027,4302,5685,22,2188928,14177,333312,4304,1855616,9873
2020-11-29,Iowa,19,228690,1509,2399,24,1067985,4304,201267,1584,866718,2720
2020-11-29,Kansas,20,155377,112,1529,0,812424,0,153021,0,659403,0
2020-11-29,Kentucky,21,180164,2711,2039,11,2581104,2743,176925,2743,2404179,0
2020-11-29,Louisiana,22,232245,1643,6407,16,3402706,23963,232245,1643,3170461,22320
2020-11-29,Maine,23,11508,220,191,0,841571,220,11508,220,830063,0
2020-11-29,Maryland,24,196727,2124,4625,23,2332839,15269,196447,1999,2136392,13270
2020-11-29,Massachusetts,25,224964,2495,10722,46,3345687,18253,224964,2495,3120723,15758
2020-11-29,Michigan,26,377596,317,9461,0,6574441,0,378152,0,6196289,0
2020-11-29,Minnesota,27,313028,8946,3637,57,2519056,44503,312969,8946,2206087,35557
2020-11-29,Mississippi,28,151785,1845,3806,27,1099057,1845,151785,1845,947272,0
2020-11-29,Missouri,29,309420,2894,3956,6,1805036,7503,295933,3193,1509103,4310
2020-11-29,Montana,30,61801,956,672,2,650223,4830,61801,956,588422,3874
2020-11-29,Nebraska,31,126491,1168,1022,4,737852,3372,125323,1257,612529,2115
2020-11-29,Nevada,32,150825,1212,2140,17,975296,2180,150527,1298,824769,882
2020-11-29,New Hampshire,33,20480,478,526,3,418976,2818,20480,478,398496,2340
2020-11-29,New Jersey,34,335943,3839,16978,13,5947423,3839,334114,3839,5613309,0
2020-11-29,New Mexico,35,95417,1435,1540,13,1547171,10969,95417,1435,1451754,9534
2020-11-29,New York,36,645932,6732,34101,52,19272524,157320,641161,6723,18631363,150597
2020-11-29,North Carolina,37,362124,3470,5279,30,5286488,41634,361778,3820,4924710,37814
2020-11-29,North Dakota,38,78664,723,926,5,350365,1560,80084,725,270281,835
2020-11-29,Northern Mariana Islands,69,104,0,2,0,16851,0,104,0,16747,0
2020-11-29,Ohio,39,414432,7729,6399,21,6083485,54776,414432,7729,5669053,47047
2020-11-29,Oklahoma,40,195545,1721,1736,19,2069013,1721,195545,1721,1873468,0
2020-11-29,Oregon,41,74120,1614,907,8,1042806,9656,74120,1614,968686,8042
2020-11-29,Pennsylvania,42,361387,5144,10406,69,3176073,19942,357196,5529,2818877,14413
2020-11-29,Puerto Rico,72,85317,121,1094,11,357674,121,51702,121,305972,0
2020-11-29,Rhode Island,44,53954,0,1346,0,527158,3730,56072,1055,471086,2675
2020-11-29,South Carolina,45,216129,1218,4353,7,2386587,16354,216129,1218,2170458,15136
2020-11-29,South Dakota,46,79900,801,943,1,327744,2368,79900,801,247844,1567
2020-11-29,Tennessee,47,358809,2924,4500,11,4489451,19130,366518,3052,4122933,16078
2020-11-29,Texas,48,1247065,12390,21900,53,11075304,54078,1266707,7050,9808597,47028
2020-11-29,Utah,49,193809,1722,868,5,1330584,5491,193809,1722,1136775,3769
2020-11-29,Vermont,50,4100,67,67,0,222914,1418,4225,70,218689,1348
2020-11-29,Virgin Islands,78,1544,4,23,0,28327,55,1544,6,26783,49
2020-11-29,Virginia,51,235942,2325,4058,4,3335502,14846,235942,2325,3099560,12521
2020-11-29,Washington,53,168333,1597,2828,0,2926668,2624,173561,2624,2753107,0
2020-11-29,West Virginia,54,46997,1152,729,11,1129226,14211,46997,1152,1082229,13059
2020-11-29,Wisconsin,55,409054,4055,3496,22,2552844,9735,409054,4055,2143790,5680
2020-11-29,Wyoming,56,32489,560,215,0,171393,560,32489,560,138904,0
2020-11-30,Alabama,01,249524,2295,3578,1,1625848,4849,249524,2295,1376324,2554
2020-11-30,Alaska,02,32407,511,115,0,1011396,5216,31323,507,980073,4709
2020-11-30,Arizona,04,327046,1051,6640,5,2263766,17452,326817,822,1936949,16630
2020-11-30,Arkansas,05,157359,1112,2502,32,1702760,7775,157359,1112,1545401,6663
2020-11-30,California,06,1237192,17696,19209,58,24025171,217670,1212968,14034,22812203,203636
2020-11-30,Colorado,08,234502,4445,3060,35,1764249,16171,232905,4133,1531344,12038
2020-11-30,Connecticut,09,117295,4714,5020,59,3261454,106837,117295,4714,3144159,102123
2020-11-30,Delaware,10,35654,403,772,2,424342,1958,35654,403,388688,1555
2020-11-30,District of Columbia,11,21552,104,680,0,695256,4914,21552,104,673704,4810
2020-11-30,Florida,12,999311,6659,18596,97,7239802,35467,983370,6426,6256432,29041
2020-11-30,Georgia,13,454328,2006,9198,9,4314448,11521,422133,1532,3892315,9989
2020-11-30,Guam,66,7821,34,113,0,84419,1168,6852,34,77567,1134
2020-11-30,Hawaii,15,18006,81,242,0,313376,85,18223,85,295153,0
2020-11-30,Idaho,16,102158,1400,937,12,488090,2023,100484,824,387606,1199
2020-11-30,Illinois,17,727825,6338,13015,120,10497998,66980,726304,6190,9771694,60790
2020-11-30,Indiana,18,341694,5667,5723,38,2204581,15653,338977,5665,1865604,9988
2020-11-30,Iowa,19,230634,1944,2426,27,1070816,2831,202410,1143,868406,1688
2020-11-30,Kansas,20,160428,5051,1560,31,822884,10460,157446,4425,665438,6035
2020-11-30,Kentucky,21,183255,3091,2065,26,2613737,32633,179041,2116,2434696,30517
2020-11-30,Louisiana,22,232414,169,6420,13,3403719,1013,232414,169,3171305,844
2020-11-30,Maine,23,11757,249,194,3,875799,34228,11757,249,864042,33979
2020-11-30,Maryland,24,198710,1983,4641,16,2344909,12070,198370,1923,2146539,10147
2020-11-30,Massachusetts,25,226132,1168,10748,26,3353346,7659,226132,1168,3127214,6491
2020-11-30,Michigan,26,388364,10768,9565,104,6677336,102895,388942,10790,6288394,92105
2020-11-30,Minnesota,27,318822,5794,3652,15,2536343,17287,318763,5794,2217580,11493
2020-11-30,Mississippi,28,153270,1485,3807,1,1135665,36608,153270,1485,982395,35123
2020-11-30,Missouri,29,314981,5561,3981,25,1813693,8657,299762,3829,1513931,4828
2020-11-30,Montana,30,62256,455,684,12,656021,5798,62198,397,593823,5401
2020-11-30,Nebraska,31,128433,1942,1039,17,740367,2515,126466,1143,613901,1372
2020-11-30,Nevada,32,152726,1901,2149,9,979849,4553,152169,1642,827680,2911
2020-11-30,New Hampshire,33,20994,514,526,0,421261,2285,20994,514,400267,1771
2020-11-30,New Jersey,34,339133,3190,16993,15,6086496,139073,337304,3190,5749192,135883
2020-11-30,New Mexico,35,97095,1678,1568,28,1558291,11120,97095,1678,1461196,9442
2020-11-30,New York,36,652748,6816,34150,49,19421498,148974,647980,6819,18773518,142155
2020-11-30,North Carolina,37,364968,2844,5296,17,5316284,29796,364512,2734,4951772,27062
2020-11-30,North Dakota,38,79258,594,933,7,351644,1279,80679,595,270965,684
2020-11-30,Northern Mariana Islands,69,106,2,2,0,16853,2,106,2,16747,0
2020-11-30,Ohio,39,421063,6631,6429,30,6128597,45112,421063,6631,5707534,38481
2020-11-30,Oklahoma,40,197745,2200,1743,7,2071213,2200,197745,2200,1873468,0
2020-11-30,Oregon,41,75454,1334,919,12,1044117,1311,75431,1311,968686,0
2020-11-30,Pennsylvania,42,366971,5584,10439,33,3189513,13440,361464,4268,2828049,9172
2020-11-30,Puerto Rico,72,86160,843,1106,12,358517,843,52545,843,305972,0
2020-11-30,Rhode Island,44,56723,2769,1373,27,529884,2726,56723,651,473161,2075
2020-11-30,South Carolina,45,217487,1358,4381,28,2399463,12876,217487,1358,2181976,11518
2020-11-30,South Dakota,46,80464,564,946,3,328852,1108,80464,564,248388,544
2020-11-30,Tennessee,47,366412,7603,4546,46,4545436,55985,374493,7975,4170943,48010
2020-11-30,Texas,48,1262145,15080,21968,68,11121195,45891,1278432,11725,9842763,34166
2020-11-30,Utah,49,195744,1935,871,3,1335394,4810,195706,1897,1139688,2913
2020-11-30,Vermont,50,4172,72,69,2,223885,971,4296,71,219589,900
2020-11-30,Virgin Islands,78,1544,0,23,0,28327,0,1544,0,26783,0
2020-11-30,Virginia,51,237835,1893,4062,4,3352908,17406,237835,1893,3115073,15513
2020-11-30,Washington,53,172175,3842,2895,67,2928847,2179,175740,2179,2753107,0
2020-11-30,West Virginia,54,47842,845,735,6,1137951,8725,47842,845,1090109,7880
2020-11-30,Wisconsin,55,411730,2676,3504,8,2561726,8882,411730,2676,2149996,6206
2020-11-30,Wyoming,56,33305,816,215,0,174771,3378,33305,816,141466,2562
2020-12-01,Alabama,01,252900,3376,3638,60,1636705,10857,252900,3376,1383805,7481
2020-12-01,Alaska,02,32911,504,116,1,1018628,7232,31834,511,986794,6721
2020-12-01,Arizona,04,338254,11208,6692,52,2282215,18449,337139,10322,1945076,8127
2020-12-01,Arkansas,05,159309,1950,2512,10,1711564,8804,159309,1950,1552255,6854
2020-12-01,California,06,1253867,16675,19327,118,24161313,136142,1225189,12221,22936124,123921
2020-12-01,Colorado,08,238779,4277,3136,76,1778454,14205,237310,4405,1541144,9800
2020-12-01,Connecticut,09,118754,1459,5040,20,3286210,24756,118754,1459,3167456,23297
2020-12-01,Delaware,10,36343,689,777,5,427250,2908,36343,689,390907,2219
2020-12-01,District of Columbia,11,21685,133,685,5,697409,2153,21685,133,675724,2020
2020-12-01,Florida,12,1008158,8847,18678,82,7287819,48017,991910,8540,6295909,39477
2020-12-01,Georgia,13,458985,4657,9253,55,4338967,24519,424929,2796,3914038,21723
2020-12-01,Guam,66,7858,37,113,0,85038,619,6889,37,78149,582
2020-12-01,Hawaii,15,18049,43,242,0,313419,43,18266,43,295153,0
2020-12-01,Idaho,16,103642,1484,966,29,490103,2013,101698,1214,388405,799
2020-12-01,Illinois,17,740510,12685,13175,160,10614079,116081,738846,12542,9875233,103539
2020-12-01,Indiana,18,347097,5403,5864,141,2217258,12677,344373,5396,1872885,7281
2020-12-01,Iowa,19,233062,2428,2449,23,1072992,2176,203398,988,869594,1188
2020-12-01,Kansas,20,160718,290,1560,0,822884,0,157446,0,665438,0
2020-12-01,Kentucky,21,187285,4030,2097,32,2639892,26155,183168,4127,2456724,22028
2020-12-01,Louisiana,22,237740,5326,6455,35,3454451,50732,237740,5326,3216711,45406
2020-12-01,Maine,23,11976,219,214,20,881709,5910,11976,219,869733,5691
2020-12-01,Maryland,24,201479,2769,4673,32,2357711,12802,201135,2765,2156576,10037
2020-12-01,Massachusetts,25,229205,3073,10778,30,3371701,18355,229205,3073,3142496,15282
2020-12-01,Michigan,26,394838,6474,9758,193,6716589,39253,395453,6511,6321136,32742
2020-12-01,Minnesota,27,322371,3549,3674,22,2545927,9584,322312,3549,2223615,6035
2020-12-01,Mississippi,28,154411,1141,3836,29,1136806,1141,154411,1141,982395,0
2020-12-01,Missouri,29,317903,2922,4130,149,1819587,5894,302691,2929,1516896,2965
2020-12-01,Montana,30,63324,1068,700,16,660895,4874,63205,1007,597690,3867
2020-12-01,Nebraska,31,130212,1779,1086,47,744724,4357,128407,1941,616317,2416
2020-12-01,Nevada,32,155312,2586,2182,33,986756,6907,154867,2698,831889,4209
2020-12-01,New Hampshire,33,21766,772,528,2,424089,2828,21766,772,402323,2056
2020-12-01,New Jersey,34,343739,4606,17083,90,6091102,4606,341910,4606,5749192,0
2020-12-01,New Mexico,35,99419,2324,1589,21,1579759,21468,99419,2324,1480340,19144
2020-12-01,New York,36,660041,7293,34222,72,19568173,146675,655265,7285,18912908,139390
2020-12-01,North Carolina,37,368615,3647,5322,26,5344037,27753,367395,2883,4976642,24870
2020-12-01,North Dakota,38,79661,403,960,27,352328,684,81145,466,271183,218
2020-12-01,Northern Mariana Islands,69,106,0,2,0,17116,263,106,0,17010,263
2020-12-01,Ohio,39,430093,9030,6548,119,6182931,54334,430093,9030,5752838,45304
2020-12-01,Oklahoma,40,199482,1737,1758,15,2122950,51737,199482,1737,1923468,50000
2020-12-01,Oregon,41,76655,1201,938,19,2002330,958213,76654,1223,1925676,956990
2020-12-01,Pennsylvania,42,372688,5717,10614,175,3203585,14072,367140,5676,2836445,8396
2020-12-01,Puerto Rico,72,86935,775,1122,16,359292,775,53320,775,305972,0
2020-12-01,Rhode Island,44,57906,1183,1380,7,533713,3829,57906,1183,475807,2646
2020-12-01,South Carolina,45,218912,1425,4404,23,2417026,17563,218912,1425,2198114,16138
2020-12-01,South Dakota,46,80912,448,948,2,330533,1681,80912,448,249621,1233
2020-12-01,Tennessee,47,371980,5568,4584,38,4582233,36797,380186,5693,4202047,31104
2020-12-01,Texas,48,1275499,13354,22204,236,11258630,137435,1296972,18540,9961658,118895
2020-12-01,Utah,49,198260,2516,890,19,1342463,7069,198216,2510,1144247,4559
2020-12-01,Vermont,50,4239,67,72,3,225150,1265,4365,69,220785,1196
2020-12-01,Virgin Islands,78,1550,6,23,0,28578,251,1550,6,27028,245
2020-12-01,Virginia,51,240063,2228,4093,31,3368573,15665,240063,2228,3128510,13437
2020-12-01,Washington,53,174969,2794,2927,32,2930161,1314,177054,1314,2753107,0
2020-12-01,West Virginia,54,48818,976,758,23,1149027,11076,48818,976,1100209,10100
2020-12-01,Wisconsin,55,416365,4635,3628,124,2572775,11049,416365,4635,2156410,6414
2020-12-01,Wyoming,56,33805,500,230,15,175271,500,33805,500,141466,0
2020-12-02,Alabama,01,256828,3928,3711,73,1647179,10474,256828,3928,1390351,6546
2020-12-02,Alaska,02,33614,703,116,0,1024643,6015,32531,697,992112,5318
2020-12-02,Arizona,04,342925,4671,6755,63,2298866,16651,340979,3840,1957887,12811
2020-12-02,Arkansas,05,161521,2212,2522,10,1724082,12518,161521,2212,1562561,10306
2020-12-02,California,06,1272041,18174,19440,113,24299126,137813,1245948,20759,23053178,117054
2020-12-02,Colorado,08,243324,4545,3226,90,1789850,11396,241172,3862,1548678,7534
2020-12-02,Connecticut,09,121426,2672,5091,51,3327440,41230,121426,2672,3206014,38558
2020-12-02,Delaware,10,36698,355,779,2,428533,1283,36698,355,391835,928
2020-12-02,District of Columbia,11,21842,157,690,5,701485,4076,21842,157,679643,3919
2020-12-02,Florida,12,1018152,9994,18775,97,7338187,50368,1001800,9890,6336387,40478
2020-12-02,Georgia,13,464417,5432,9301,48,4362964,23997,428980,4051,3933984,19946
2020-12-02,Guam,66,7889,31,113,0,85486,448,6920,31,78566,417
2020-12-02,Hawaii,15,18117,68,242,0,313495,76,18342,76,295153,0
2020-12-02,Idaho,16,105250,1608,1002,36,493134,3031,103305,1607,389829,1424
2020-12-02,Illinois,17,750208,9698,13433,258,10699586,85507,748603,9757,9950983,75750
2020-12-02,Indiana,18,353722,6625,5973,109,2232102,14844,350970,6597,1881132,8247
2020-12-02,Iowa,19,236159,3097,2518,69,1078029,5037,205773,2375,872256,2662
2020-12-02,Kansas,20,164981,4263,1679,119,831182,8298,162061,4615,669121,3683
2020-12-02,Kentucky,21,191067,3782,2124,27,2652314,12422,186765,3597,2465549,8825
2020-12-02,Louisiana,22,241335,3595,6501,46,3518499,64048,241335,3595,3277164,60453
2020-12-02,Maine,23,12208,232,218,4,892341,10632,12208,232,880133,10400
2020-12-02,Maryland,24,203672,2193,4715,42,2371358,13647,203355,2220,2168003,11427
2020-12-02,Massachusetts,25,234232,5027,10824,46,3395423,23722,234232,5027,3161191,18695
2020-12-02,Michigan,26,402255,7417,9839,81,6762022,45433,402886,7433,6359136,38000
2020-12-02,Minnesota,27,327536,5165,3751,77,2563919,17992,327477,5165,2236442,12827
2020-12-02,Mississippi,28,156868,2457,3851,15,1139263,2457,156868,2457,982395,0
2020-12-02,Missouri,29,321411,3508,4185,55,1825375,5788,305370,2679,1520005,3109
2020-12-02,Montana,30,64399,1075,713,13,663581,2686,64340,1135,599241,1551
2020-12-02,Nebraska,31,132530,2318,1132,46,748366,3642,130194,1787,618172,1855
2020-12-02,Nevada,32,157586,2274,2225,43,991427,4671,156996,2129,834431,2542
2020-12-02,New Hampshire,33,22332,566,537,9,427816,3727,22332,566,405484,3161
2020-12-02,New Jersey,34,348042,4303,17145,62,6133587,42485,346206,4296,5787381,38189
2020-12-02,New Mexico,35,100963,1544,1629,40,1592222,12463,100963,1544,1491259,10919
2020-12-02,New York,36,669016,8975,34286,64,19761724,193551,664238,8973,19097486,184578
2020-12-02,North Carolina,37,372525,3910,5406,84,5378004,33967,371594,4199,5006410,29768
2020-12-02,North Dakota,38,80141,480,972,12,353213,885,81696,551,271517,334
2020-12-02,Northern Mariana Islands,69,106,0,2,0,17116,0,106,0,17010,0
2020-12-02,Ohio,39,437928,7835,6671,123,6217744,34813,437928,7835,5779816,26978
2020-12-02,Oklahoma,40,202341,2859,1812,54,2143079,20129,202341,2859,1940738,17270
2020-12-02,Oregon,41,78206,1551,962,24,2021942,19612,78160,1506,1943782,18106
2020-12-02,Pennsylvania,42,381342,8654,10803,189,3228055,24470,375431,8291,2852624,16179
2020-12-02,Puerto Rico,72,87323,388,1144,22,359680,388,53708,388,305972,0
2020-12-02,Rhode Island,44,59005,1099,1391,11,536906,3193,59005,1099,477901,2094
2020-12-02,South Carolina,45,220835,1923,4444,40,2432901,15875,220835,1923,2212066,13952
2020-12-02,South Dakota,46,82203,1291,995,47,332540,2007,82203,1291,250337,716
2020-12-02,Tennessee,47,375995,4015,4635,51,4605389,23156,384285,4099,4221104,19057
2020-12-02,Texas,48,1294064,18565,22422,218,11383051,124421,1316194,19222,10066857,105199
2020-12-02,Utah,49,202220,3960,906,16,1351342,8879,202220,4004,1149122,4875
2020-12-02,Vermont,50,4461,222,74,2,225930,780,4466,101,221464,679
2020-12-02,Virgin Islands,78,1589,39,23,0,28810,232,1563,13,27247,219
2020-12-02,Virginia,51,242480,2417,4113,20,3378990,10417,242480,2417,3136510,8000
2020-12-02,Washington,53,177929,2960,2979,52,2934863,4702,181756,4702,2753107,0
2020-12-02,West Virginia,54,49905,1087,778,20,1159681,10654,49905,1087,1109776,9567
2020-12-02,Wisconsin,55,420930,4565,3715,87,2583546,10771,420930,4565,2162616,6206
2020-12-02,Wyoming,56,34507,702,230,0,175973,702,34507,702,141466,0
2020-12-03,Alabama,01,260359,3531,3776,65,1660369,13190,260359,3531,1400010,9659
2020-12-03,Alaska,02,34377,763,124,8,1040505,15862,33291,760,1007214,15102
2020-12-03,Arizona,04,348134,5209,6834,79,2316257,17391,346421,5442,1969836,11949
2020-12-03,Arkansas,05,164310,2789,2555,33,1740989,16907,164310,2789,1576679,14118
2020-12-03,California,06,1293887,21846,19586,146,24474642,175516,1264539,18591,23210103,156925
2020-12-03,Colorado,08,248779,5455,3335,109,1808065,18215,247209,6037,1560856,12178
2020-12-03,Connecticut,09,126177,4751,5111,20,3394113,66673,126177,4751,3267936,61922
2020-12-03,Delaware,10,37456,758,779,0,431760,3227,37456,758,394304,2469
2020-12-03,District of Columbia,11,22164,322,692,2,709991,8506,22164,322,687827,8184
2020-12-03,Florida,12,1029022,10870,18873,98,7388737,50550,1012456,10656,6376281,39894
2020-12-03,Georgia,13,469955,5538,9377,76,4396665,33701,433353,4373,3963312,29328
2020-12-03,Guam,66,7911,22,113,0,85958,472,6942,22,79016,450
2020-12-03,Hawaii,15,18256,139,244,2,313637,142,18484,142,295153,0
2020-12-03,Idaho,16,106882,1632,1023,21,497009,3875,104734,1429,392275,2446
2020-12-03,Illinois,17,761209,11001,13650,217,10806364,106778,759562,10959,10046802,95819
2020-12-03,Indiana,18,362182,8460,6033,60,2252864,20762,359430,8460,1893434,12302
2020-12-03,Iowa,19,238722,2563,2603,85,1083485,5456,207969,2196,875516,3260
2020-12-03,Kansas,20,165613,632,1679,0,831182,0,162061,0,669121,0
2020-12-03,Kentucky,21,194851,3784,2185,61,2721444,69130,190601,3836,2530843,65294
2020-12-03,Louisiana,22,244078,2743,6524,23,3541901,23402,244078,2743,3297823,20659
2020-12-03,Maine,23,12554,346,220,2,901836,9495,12554,346,889282,9149
2020-12-03,Maryland,24,205716,2044,4764,49,2383341,11983,205399,2044,2177942,9939
2020-12-03,Massachusetts,25,240907,6675,10874,50,3427846,32423,240907,6675,3186939,25748
2020-12-03,Michigan,26,410379,8124,10031,192,6831799,69777,410843,7957,6420956,61820
2020-12-03,Minnesota,27,333685,6149,3843,92,2584374,20455,333626,6149,2250748,14306
2020-12-03,Mississippi,28,159036,2168,3879,28,1141431,2168,159036,2168,982395,0
2020-12-03,Missouri,29,325519,4108,4274,89,1834404,9029,309368,3998,1525036,5031
2020-12-03,Montana,30,65242,843,723,10,669081,5500,65122,782,603959,4718
2020-12-03,Nebraska,31,134710,2180,1174,42,752981,4615,132530,2336,620451,2279
2020-12-03,Nevada,32,160317,2731,2259,34,999188,7761,159532,2536,839656,5225
2020-12-03,New Hampshire,33,22925,593,544,7,431027,3211,22925,593,408102,2618
2020-12-03,New Jersey,34,352835,4793,17209,64,6176836,43249,350999,4793,5825837,38456
2020-12-03,New Mexico,35,102873,1910,1673,44,1604914,12692,102862,1899,1502052,10793
2020-12-03,New York,36,678869,9853,34346,60,19965164,203440,674093,9855,19291071,193585
2020-12-03,North Carolina,37,378370,5845,5454,48,5432699,54695,377231,5637,5055468,49058
2020-12-03,North Dakota,38,81111,970,983,11,355291,2078,82713,1017,272578,1061
2020-12-03,Northern Mariana Islands,69,106,0,2,0,17116,0,106,0,17010,0
2020-12-03,Ohio,39,446859,8931,6753,82,6270788,53044,446849,8921,5823939,44123
2020-12-03,Oklahoma,40,204048,1707,1836,24,2161489,18410,204048,1707,1957441,16703
2020-12-03,Oregon,41,79294,1088,974,12,2043324,21382,79263,1103,1964061,20279
2020-12-03,Pennsylvania,42,392610,11268,11008,205,3259394,31339,386837,11406,2872557,19933
2020-12-03,Puerto Rico,72,87720,397,1155,11,360077,397,54105,397,305972,0
2020-12-03,Rhode Island,44,60722,1717,1400,9,541476,4570,60722,1717,480754,2853
2020-12-03,South Carolina,45,223063,2228,4466,22,2449100,16199,223063,2228,2226037,13971
2020-12-03,South Dakota,46,83348,1145,1033,38,334697,2157,83348,1145,251349,1012
2020-12-03,Tennessee,47,379679,3684,4727,92,4625661,20272,388252,3967,4237409,16305
2020-12-03,Texas,48,1311988,17924,22645,223,11502540,119489,1333746,17552,10168794,101937
2020-12-03,Utah,49,206255,4035,918,12,1361891,10549,206165,3945,1155726,6604
2020-12-03,Vermont,50,4642,181,75,1,227768,1838,4690,224,223078,1614
2020-12-03,Virgin Islands,78,1589,0,23,0,29009,199,1589,26,27420,173
2020-12-03,Virginia,51,244503,2023,4147,34,3389736,10746,244503,2023,3145233,8723
2020-12-03,Washington,53,180125,2196,3040,61,2938264,3401,185157,3401,2753107,0
2020-12-03,West Virginia,54,51025,1120,789,11,1171602,11921,51025,1120,1120577,10801
2020-12-03,Wisconsin,55,426534,5604,3781,66,2596504,12958,426534,5604,2169970,7354
2020-12-03,Wyoming,56,35078,571,257,27,178355,2382,35078,571,143277,1811
2020-12-04,Alabama,01,264199,3840,3831,55,1671498,11129,264199,3840,1407299,7289
2020-12-04,Alaska,02,35138,761,135,11,1050369,9864,34041,750,1016328,9114
2020-12-04,Arizona,04,355054,6920,6885,51,2338378,22121,352101,5680,1986277,16441
2020-12-04,Arkansas,05,167137,2827,2586,31,1756913,15924,167137,2827,1589776,13097
2020-12-04,California,06,1318139,24252,19791,205,24675478,200836,1286557,22018,23388921,178818
2020-12-04,Colorado,08,252960,4181,3375,40,1826441,18376,252222,5013,1574219,13363
2020-12-04,Connecticut,09,127715,1538,5146,35,3422098,27985,127715,1538,3294383,26447
2020-12-04,Delaware,10,38398,942,782,3,435067,3307,38398,942,396669,2365
2020-12-04,District of Columbia,11,22480,316,693,1,718242,8251,22480,316,695762,7935
2020-12-04,Florida,12,1039199,10177,18993,120,7444184,55447,1022354,9898,6421830,45549
2020-12-04,Georgia,13,476181,6226,9443,66,4435020,38355,438300,4947,3996720,33408
2020-12-04,Guam,66,7928,17,114,1,86530,572,6959,17,79571,555
2020-12-04,Hawaii,15,18373,117,254,10,313758,121,18605,121,295153,0
2020-12-04,Idaho,16,108741,1859,1037,14,500908,3899,106455,1721,394453,2178
2020-12-04,Illinois,17,771696,10487,13808,158,10918998,112634,770088,10526,10148910,102108
2020-12-04,Indiana,18,370091,7909,6122,89,2272182,19318,367329,7899,1904853,11419
2020-12-04,Iowa,19,241531,2809,2665,62,1089561,6076,210236,2267,879325,3809
2020-12-04,Kansas,20,171513,5900,1786,107,845186,14004,168295,6234,676891,7770
2020-12-04,Kentucky,21,198506,3655,2216,31,2733708,12264,194193,3592,2539515,8672
2020-12-04,Louisiana,22,247177,3099,6548,24,3566534,24633,247177,3099,3319357,21534
2020-12-04,Maine,23,12844,290,224,4,913676,11840,12844,290,900832,11550
2020-12-04,Maryland,24,209512,3796,4790,26,2403287,19946,209191,3792,2194096,16154
2020-12-04,Massachusetts,25,246398,5491,10910,36,3454355,26509,246398,5491,3207957,21018
2020-12-04,Michigan,26,419704,9325,10113,82,6900160,68361,420268,9425,6479892,58936
2020-12-04,Minnesota,27,339032,5347,3904,61,2608190,23816,338973,5347,2269217,18469
2020-12-04,Mississippi,28,161516,2480,3916,37,1143911,2480,161516,2480,982395,0
2020-12-04,Missouri,29,330445,4926,4375,101,1844062,9658,313421,4053,1530641,5605
2020-12-04,Montana,30,66494,1252,728,5,675262,6181,66436,1314,608826,4867
2020-12-04,Nebraska,31,136349,1639,1199,25,757832,4851,134710,2180,623122,2671
2020-12-04,Nevada,32,163065,2748,2276,17,1004655,5467,162434,2902,842221,2565
2020-12-04,New Hampshire,33,23690,765,552,8,433764,2737,23690,765,410074,1972
2020-12-04,New Jersey,34,358498,5663,17255,46,6182499,5663,356662,5663,5825837,0
2020-12-04,New Mexico,35,104935,2062,1706,33,1620383,15469,104935,2073,1515448,13396
2020-12-04,New York,36,690143,11274,34409,63,20173461,208297,685364,11271,19488097,197026
2020-12-04,North Carolina,37,384165,5795,5505,51,5485287,52588,382534,5303,5102753,47285
2020-12-04,North Dakota,38,81955,844,995,12,356851,1560,83604,891,273247,669
2020-12-04,Northern Mariana Islands,69,106,0,2,0,17116,0,106,0,17010,0
2020-12-04,Ohio,39,456963,10104,6882,129,6349442,78654,456963,10114,5892479,68540
2020-12-04,Oklahoma,40,208875,4827,1860,24,2191644,30155,208875,4827,1982769,25328
2020-12-04,Oregon,41,81441,2147,1004,30,2087054,43730,81437,2174,2005617,41556
2020-12-04,Pennsylvania,42,404699,12089,11189,181,3291921,32527,398600,11763,2893321,20764
2020-12-04,Puerto Rico,72,88212,492,1172,17,360569,492,54597,492,305972,0
2020-12-04,Rhode Island,44,62137,1415,1413,13,545059,3583,62137,1415,482922,2168
2020-12-04,South Carolina,45,226013,2950,4496,30,2474899,25799,226013,2950,2248886,22849
2020-12-04,South Dakota,46,84398,1050,1064,31,336512,1815,84398,1050,252114,765
2020-12-04,Tennessee,47,383995,4316,4822,95,4651344,25683,392608,4356,4258736,21327
2020-12-04,Texas,48,1326103,14115,22890,245,11619285,116745,1350542,16796,10268743,99949
2020-12-04,Utah,49,209258,3003,926,8,1374502,12611,209170,3005,1165332,9606
2020-12-04,Vermont,50,4763,121,77,2,230109,2341,4763,73,225346,2268
2020-12-04,Virgin Islands,78,1613,24,23,0,29115,106,1613,24,27502,82
2020-12-04,Virginia,51,247380,2877,4160,13,3416416,26680,247380,2877,3169036,23803
2020-12-04,Washington,53,182758,2633,3062,22,2941576,3312,188469,3312,2753107,0
2020-12-04,West Virginia,54,52172,1147,799,10,1188605,17003,52172,1147,1136433,15856
2020-12-04,Wisconsin,55,432217,5683,3847,66,2612527,16023,432207,5673,2180320,10350
2020-12-04,Wyoming,56,35737,659,257,0,180313,1958,35737,659,144576,1299
2020-12-05,Alabama,01,267589,3390,3877,46,1682946,11448,267589,3390,1415357,8058
2020-12-05,Alaska,02,36083,945,136,1,1067231,16862,34963,922,1032268,15940
2020-12-05,Arizona,04,361186,6132,6940,55,2362052,23674,358900,6799,2003152,16875
2020-12-05,Arkansas,05,169382,2245,2620,34,1771117,14204,169382,2245,1601735,11959
2020-12-05,California,06,1343145,25006,19876,85,24901975,226497,1311625,25068,23590350,201429
2020-12-05,Colorado,08,258124,5164,3415,40,1831566,5125,257347,5125,1574219,0
2020-12-05,Connecticut,09,127715,0,5146,0,3422098,0,127715,0,3294383,0
2020-12-05,Delaware,10,39096,698,782,0,437610,2543,39096,698,398514,1845
2020-12-05,District of Columbia,11,22872,392,695,2,727387,9145,22872,392,704515,8753
2020-12-05,Florida,12,1049630,10431,19083,90,7496592,52408,1032552,10198,6464040,42210
2020-12-05,Georgia,13,481126,4945,9506,63,4466200,31180,442017,3717,4024183,27463
2020-12-05,Guam,66,7946,18,114,0,86548,18,6977,18,79571,0
2020-12-05,Hawaii,15,18484,111,259,5,313891,133,18738,133,295153,0
2020-12-05,Idaho,16,109764,1023,1037,0,504583,3675,108366,1911,396217,1764
2020-12-05,Illinois,17,781441,9745,14028,220,11021676,102678,779975,9887,10241701,92791
2020-12-05,Indiana,18,377790,7699,6207,85,2292178,19996,375019,7690,1917159,12306
2020-12-05,Iowa,19,243385,1854,2682,17,1094502,4941,211891,1655,882611,3286
2020-12-05,Kansas,20,171626,113,1786,0,845186,0,168295,0,676891,0
2020-12-05,Kentucky,21,202135,3629,2241,25,2766608,32900,198065,3872,2568543,29028
2020-12-05,Louisiana,22,247177,0,6548,0,3566534,0,247177,0,3319357,0
2020-12-05,Maine,23,13127,283,227,3,913959,283,13127,283,900832,0
2020-12-05,Maryland,24,212545,3033,4820,30,2423180,19893,212384,3193,2210796,16700
2020-12-05,Massachusetts,25,252017,5619,10953,43,3482924,28569,252017,5619,3230907,22950
2020-12-05,Michigan,26,425776,6072,10313,200,6965058,64898,426576,6308,6538482,58590
2020-12-05,Minnesota,27,345340,6308,3979,75,2626659,18469,345281,6308,2281378,12161
2020-12-05,Mississippi,28,163458,1942,3949,33,1145853,1942,163458,1942,982395,0
2020-12-05,Missouri,29,334637,4192,4412,37,1855990,11928,318422,5001,1537568,6927
2020-12-05,Montana,30,67092,598,734,6,682583,7321,67069,633,615514,6688
2020-12-05,Nebraska,31,138568,2219,1202,3,761879,4047,136325,1615,625554,2432
2020-12-05,Nevada,32,166187,3122,2309,33,1014896,10241,165628,3194,849268,7047
2020-12-05,New Hampshire,33,24138,448,559,7,437553,3789,24138,448,413415,3341
2020-12-05,New Jersey,34,363822,5324,17306,51,6280783,98284,361986,5324,5918797,92960
2020-12-05,New Mexico,35,106856,1921,1738,32,1634917,14534,106856,1921,1528061,12613
2020-12-05,New York,36,700902,10759,34488,79,20388862,215401,696125,10761,19692737,204640
2020-12-05,North Carolina,37,388760,4595,5547,42,5546614,61327,388552,6018,5158062,55309
2020-12-05,North Dakota,38,82510,555,1013,18,358233,1382,84219,615,274014,767
2020-12-05,Northern Mariana Islands,69,106,0,2,0,17116,0,106,0,17010,0
2020-12-05,Ohio,39,467432,10469,6947,65,6416665,67223,467432,10469,5949233,56754
2020-12-05,Oklahoma,40,213245,4370,1874,14,2222074,30430,213245,4370,2008829,26060
2020-12-05,Oregon,41,83243,1802,1027,23,2088860,1806,83243,1806,2005617,0
2020-12-05,Pennsylvania,42,416073,11374,11331,142,3323124,31203,411484,12884,2911640,18319
2020-12-05,Puerto Rico,72,89147,935,1184,12,361504,935,55532,935,305972,0
2020-12-05,Rhode Island,44,62137,0,1413,0,550004,4945,63944,1807,486060,3138
2020-12-05,South Carolina,45,229235,3222,4517,21,2503921,29022,229235,3222,2274686,25800
2020-12-05,South Dakota,46,85304,906,1091,27,338369,1857,85304,906,253065,951
2020-12-05,Tennessee,47,388815,4820,4851,29,4675056,23712,397522,4914,4277534,18798
2020-12-05,Texas,48,1337296,11193,23111,221,11731196,111911,1364933,14391,10366263,97520
2020-12-05,Utah,49,212844,3586,939,13,1386715,12213,212844,3674,1173871,8539
2020-12-05,Vermont,50,4894,131,79,2,231751,1642,4894,131,226857,1511
2020-12-05,Virgin Islands,78,1613,0,23,0,29293,178,1633,20,27660,158
2020-12-05,Virginia,51,251173,3793,4197,37,3467011,50595,251173,3793,3215838,46802
2020-12-05,Washington,53,184079,1321,3065,3,3137463,195887,191607,3138,2945856,192749
2020-12-05,West Virginia,54,53572,1400,829,30,1215319,26714,53572,1400,1161747,25314
2020-12-05,Wisconsin,55,437918,5701,3938,91,2626867,14340,437918,5711,2188949,8629
2020-12-05,Wyoming,56,35941,204,257,0,180517,204,35941,204,144576,0
2020-12-06,Alabama,01,269877,2288,3889,12,1691003,8057,269877,2288,1421126,5769
2020-12-06,Alaska,02,36847,764,136,0,1077776,10545,35720,757,1042056,9788
2020-12-06,Arizona,04,364276,3090,6950,10,2383089,21037,364276,5376,2018813,15661
2020-12-06,Arkansas,05,170924,1542,2660,40,1785903,14786,170924,1542,1614979,13244
2020-12-06,California,06,1371940,28795,19937,61,25195046,293071,1341700,30075,23853346,262996
2020-12-06,Colorado,08,262460,4336,3437,22,1869410,37844,260581,3234,1608829,34610
2020-12-06,Connecticut,09,127715,0,5146,0,3422098,0,127715,0,3294383,0
2020-12-06,Delaware,10,39912,816,793,11,440766,3156,39912,816,400854,2340
2020-12-06,District of Columbia,11,23136,264,697,2,734633,7246,23136,264,711497,6982
2020-12-06,Florida,12,1058066,8436,19176,93,7545964,49372,1040727,8175,6505237,41197
2020-12-06,Georgia,13,483106,1980,9516,10,4476052,9852,443822,1805,4032230,8047
2020-12-06,Guam,66,7973,27,114,0,86575,27,7004,27,79571,0
2020-12-06,Hawaii,15,18581,97,260,1,313995,104,18842,104,295153,0
2020-12-06,Idaho,16,110553,789,1040,3,507732,3149,109705,1339,398027,1810
2020-12-06,Illinois,17,788922,7481,14127,99,11101214,79538,787573,7598,10313641,71940
2020-12-06,Indiana,18,384391,6601,6242,35,2309879,17701,381617,6598,1928262,11103
2020-12-06,Iowa,19,244689,1304,2717,35,1098589,4087,213390,1499,885199,2588
2020-12-06,Kansas,20,171635,9,1786,0,845186,0,168295,0,676891,0
2020-12-06,Kentucky,21,204772,2637,2250,9,2769175,2567,200632,2567,2568543,0
2020-12-06,Louisiana,22,251123,3946,6584,36,3608083,41549,251123,3946,3356960,37603
2020-12-06,Maine,23,13348,221,227,0,914180,221,13348,221,900832,0
2020-12-06,Maryland,24,215348,2803,4846,26,2440622,17442,215027,2643,2225595,14799
2020-12-06,Massachusetts,25,256844,4827,11004,51,3507572,24648,256844,4827,3250728,19821
2020-12-06,Michigan,26,426124,348,10313,0,6965058,0,426576,0,6538482,0
2020-12-06,Minnesota,27,350921,5581,4043,64,2651997,25338,350862,5581,2301135,19757
2020-12-06,Mississippi,28,164931,1473,3961,12,1147326,1473,164931,1473,982395,0
2020-12-06,Missouri,29,337927,3290,4420,8,1866524,10534,322298,3876,1544226,6658
2020-12-06,Montana,30,67875,783,736,2,688214,5631,67875,806,620339,4825
2020-12-06,Nebraska,31,139834,1266,1213,11,770307,8428,138568,2243,631739,6185
2020-12-06,Nevada,32,168758,2571,2318,9,1021786,6890,168139,2511,853647,4379
2020-12-06,New Hampshire,33,24771,633,564,5,440747,3194,24771,633,415976,2561
2020-12-06,New Jersey,34,369852,6030,17321,15,6286813,6030,368016,6030,5918797,0
2020-12-06,New Mexico,35,108088,1232,1749,11,1647976,13059,108088,1232,1539888,11827
2020-12-06,New York,36,710612,9710,34552,64,20594694,205832,705827,9702,19888867,196130
2020-12-06,North Carolina,37,395020,6260,5578,31,5611276,64662,394990,6438,5216286,58224
2020-12-06,North Dakota,38,82987,477,1019,6,359199,966,84707,488,274492,478
2020-12-06,Northern Mariana Islands,69,106,0,2,0,17116,0,106,0,17010,0
2020-12-06,Ohio,39,475024,7592,6960,13,6475710,59045,475024,7592,6000686,51453
2020-12-06,Oklahoma,40,216486,3241,1896,22,2225315,3241,216486,3241,2008829,0
2020-12-06,Oregon,41,84496,1253,1033,6,2090113,1253,84496,1253,2005617,0
2020-12-06,Pennsylvania,42,423828,7755,11389,58,3349150,26026,420114,8630,2929036,17396
2020-12-06,Puerto Rico,72,90286,1139,1191,7,362643,1139,56671,1139,305972,0
2020-12-06,Rhode Island,44,62137,0,1413,0,553947,3943,64974,1030,488973,2913
2020-12-06,South Carolina,45,232099,2864,4566,49,2528191,24270,232099,2864,2296092,21406
2020-12-06,South Dakota,46,85991,687,1110,19,339995,1626,85991,687,254004,939
2020-12-06,Tennessee,47,391393,2578,4888,37,4690522,15466,400594,3072,4289928,12394
2020-12-06,Texas,48,1346699,9403,23187,76,11790789,59593,1375313,10380,10415476,49213
2020-12-06,Utah,49,215407,2563,939,0,1395728,9013,215407,2563,1180321,6450
2020-12-06,Vermont,50,5015,121,79,0,233880,2129,5015,121,228865,2008
2020-12-06,Virgin Islands,78,1613,0,23,0,29293,0,1633,0,27660,0
2020-12-06,Virginia,51,255053,3880,4200,3,3523875,56864,255053,3880,3268822,52984
2020-12-06,Washington,53,185505,1426,3065,0,3152739,15276,194687,3080,2958052,12196
2020-12-06,West Virginia,54,54997,1425,838,9,1223363,8044,54997,1425,1168366,6619
2020-12-06,Wisconsin,55,441067,3149,3956,18,2637789,10922,441067,3149,2196722,7773
2020-12-06,Wyoming,56,36317,376,257,0,180893,376,36317,376,144576,0
2020-12-07,Alabama,01,272229,2352,3892,3,1698013,7010,272229,2352,1425784,4658
2020-12-07,Alaska,02,37350,503,139,3,1082140,4364,36196,476,1045944,3888
2020-12-07,Arizona,04,366364,2088,6950,0,2401547,18458,365843,1567,2035704,16891
2020-12-07,Arkansas,05,172042,1118,2713,53,1795940,10037,172042,1118,1623898,8919
2020-12-07,California,06,1399167,27227,20052,115,25493351,298305,1366435,24735,24126916,273570
2020-12-07,Colorado,08,266670,4210,3466,29,1884917,15507,264618,4037,1620299,11470
2020-12-07,Connecticut,09,135844,8129,5224,78,3545421,123323,135844,8129,3409577,115194
2020-12-07,Delaware,10,40711,799,793,0,444528,3762,40711,799,403817,2963
2020-12-07,District of Columbia,11,23319,183,701,4,739084,4451,23319,183,715765,4268
2020-12-07,Florida,12,1065777,7711,19281,105,7584453,38489,1048264,7537,6536189,30952
2020-12-07,Georgia,13,488225,5119,9559,43,4521060,45008,448683,4861,4072377,40147
2020-12-07,Guam,66,7988,15,114,0,88437,1862,7019,15,81418,1847
2020-12-07,Hawaii,15,18659,78,260,0,314076,81,18923,81,295153,0
2020-12-07,Idaho,16,112433,1880,1062,22,510221,2489,110510,805,399711,1684
2020-12-07,Illinois,17,797789,8867,14234,107,11178783,77569,796264,8691,10382519,68878
2020-12-07,Indiana,18,390048,5657,6284,42,2323969,14090,387278,5661,1936691,8429
2020-12-07,Iowa,19,245985,1296,2723,6,1100653,2064,214067,677,886586,1387
2020-12-07,Kansas,20,177389,5754,1856,70,861324,16138,174025,5730,687299,10408
2020-12-07,Kentucky,21,207043,2271,2276,26,2806992,37817,202592,1960,2604400,35857
2020-12-07,Louisiana,22,252136,1013,6607,23,3618824,10741,252136,1013,3366688,9728
2020-12-07,Maine,23,13775,427,227,0,936624,22444,13775,427,922849,22017
2020-12-07,Maryland,24,217647,2299,4865,19,2458029,17407,217329,2302,2240700,15105
2020-12-07,Massachusetts,25,259325,2481,11035,31,3521096,13524,259325,2481,3261771,11043
2020-12-07,Michigan,26,435681,9557,10415,102,7058720,93662,436400,9824,6622320,83838
2020-12-07,Minnesota,27,356211,5290,4064,21,2677739,25742,356152,5290,2321587,20452
2020-12-07,Mississippi,28,166194,1263,3961,0,1192494,45168,166194,1263,1026300,43905
2020-12-07,Missouri,29,342244,4317,4452,32,1874010,7486,324956,2658,1549054,4828
2020-12-07,Montana,30,68651,776,743,7,692763,4549,68591,716,624172,3833
2020-12-07,Nebraska,31,141284,1450,1244,31,773671,3364,139834,1266,633837,2098
2020-12-07,Nevada,32,171159,2401,2326,8,1028231,6445,170587,2448,857644,3997
2020-12-07,New Hampshire,33,25816,1045,566,2,443890,3143,25816,1045,418074,2098
2020-12-07,New Jersey,34,373415,3563,17336,15,6290376,3563,371579,3563,5918797,0
2020-12-07,New Mexico,35,109947,1859,1756,7,1660275,12299,109947,1859,1550328,10440
2020-12-07,New York,36,718991,8379,34637,85,20746981,152287,713129,7302,20033852,144985
2020-12-07,North Carolina,37,399796,4776,5598,20,5655815,44539,399362,4372,5256453,40167
2020-12-07,North Dakota,38,83348,361,1028,9,360031,832,85094,387,274937,445
2020-12-07,Northern Mariana Islands,69,109,3,2,0,17119,3,109,3,17010,0
2020-12-07,Ohio,39,484297,9273,7023,63,6527328,51618,484297,9273,6043031,42345
2020-12-07,Oklahoma,40,218389,1903,1911,15,2227218,1903,218389,1903,2008829,0
2020-12-07,Oregon,41,85803,1307,1049,16,2153661,63548,85788,1292,2067873,62256
2020-12-07,Pennsylvania,42,432410,8582,11431,42,3369727,20577,426444,6330,2943283,14247
2020-12-07,Puerto Rico,72,91237,951,1202,11,363594,951,57622,951,305972,0
2020-12-07,Rhode Island,44,65818,3681,1448,35,556960,3013,65818,844,491142,2169
2020-12-07,South Carolina,45,234652,2553,4579,13,2554866,26675,234652,2553,2320214,24122
2020-12-07,South Dakota,46,86500,509,1110,0,341195,1200,86500,509,254695,691
2020-12-07,Tennessee,47,399323,7930,4953,65,4733652,43130,408730,8136,4324922,34994
2020-12-07,Texas,48,1361376,14677,23258,71,11831199,40410,1384804,9491,10446395,30919
2020-12-07,Utah,49,217638,2231,949,10,1403103,7375,217638,2231,1185465,5144
2020-12-07,Vermont,50,5080,65,81,2,235301,1421,5080,65,230221,1356
2020-12-07,Virgin Islands,78,1649,36,23,0,29663,370,1649,16,28014,354
2020-12-07,Virginia,51,258870,3817,4208,8,3554496,30621,258870,3817,3295626,26804
2020-12-07,Washington,53,191468,5963,3080,15,3162013,9274,196460,1773,2965553,7501
2020-12-07,West Virginia,54,56128,1131,841,3,1235583,12220,56128,1131,1179455,11089
2020-12-07,Wisconsin,55,443415,2348,3979,23,2645862,8073,443389,2322,2202473,5751
2020-12-07,Wyoming,56,36985,668,280,23,183251,2358,36985,668,146266,1690
2020-12-08,Alabama,01,276665,4436,3942,50,1711748,13735,276665,4436,1435083,9299
2020-12-08,Alaska,02,37923,573,139,0,1088978,6838,36758,562,1052220,6276
2020-12-08,Arizona,04,379662,13298,6985,35,2421060,19513,378157,12314,2042903,7199
2020-12-08,Arkansas,05,174325,2283,2752,39,1807211,11271,174325,2283,1632886,8988
2020-12-08,California,06,1425432,26265,20238,186,25789775,296424,1389707,23272,24400068,273152
2020-12-08,Colorado,08,270381,3711,3508,42,1899317,14400,268589,3971,1630728,10429
2020-12-08,Connecticut,09,138258,2414,5242,18,3573535,28114,138258,2414,3435277,25700
2020-12-08,Delaware,10,41464,753,803,10,447438,2910,41464,753,405974,2157
2020-12-08,District of Columbia,11,23589,270,701,0,745631,6547,23589,270,722042,6277
2020-12-08,Florida,12,1073762,7985,19377,96,7624426,39973,1056065,7801,6568361,32172
2020-12-08,Georgia,13,493558,5333,9582,23,4555443,34383,452369,3686,4103074,30697
2020-12-08,Guam,66,7995,7,114,0,88614,177,7026,7,81588,170
2020-12-08,Hawaii,15,18712,53,260,0,314129,53,18976,53,295153,0
2020-12-08,Idaho,16,114411,1978,1081,19,512851,2630,111893,1383,400958,1247
2020-12-08,Illinois,17,805794,8005,14392,158,11274608,95825,804174,7910,10470434,87915
2020-12-08,Indiana,18,395449,5401,6410,126,2338308,14339,392663,5385,1945645,8954
2020-12-08,Iowa,19,246237,252,2915,192,1102737,2084,214897,830,887840,1254
2020-12-08,Kansas,20,177780,391,1856,0,861324,0,174025,0,687299,0
2020-12-08,Kentucky,21,210232,3189,2328,52,2822478,15486,205668,3076,2616810,12410
2020-12-08,Louisiana,22,254562,2426,6652,45,3647386,28562,254562,2426,3392824,26136
2020-12-08,Maine,23,14049,274,239,12,942567,5943,14049,274,928518,5669
2020-12-08,Maryland,24,220279,2632,4916,51,2474475,16446,219961,2632,2254514,13814
2020-12-08,Massachusetts,25,263447,4122,11076,41,3540164,19068,263447,4122,3276717,14946
2020-12-08,Michigan,26,442504,6823,10620,205,7119253,60533,443076,6676,6676177,53857
2020-12-08,Minnesota,27,359262,3051,4086,22,2688011,10272,359203,3051,2328808,7221
2020-12-08,Mississippi,28,167926,1732,4017,56,1194226,1732,167926,1732,1026300,0
2020-12-08,Missouri,29,346161,3917,4594,142,1881501,7491,328206,3250,1553295,4241
2020-12-08,Montana,30,69465,814,763,20,696878,4115,69346,755,627532,3360
2020-12-08,Nebraska,31,142718,1434,1288,44,776493,2822,141127,1293,635366,1529
2020-12-08,Nevada,32,174050,2891,2368,42,1033130,4899,173281,2694,859849,2205
2020-12-08,New Hampshire,33,26623,807,566,0,446689,2799,26623,807,420066,1992
2020-12-08,New Jersey,34,378891,5476,17426,90,6349346,58970,377055,5476,5972291,53494
2020-12-08,New Mexico,35,111191,1244,1789,33,1669512,9237,111202,1255,1558310,7982
2020-12-08,New York,36,728010,9019,34723,86,20909445,162464,722464,9335,20186981,153129
2020-12-08,North Carolina,37,404520,4724,5642,44,5704900,49085,404032,4670,5300868,44415
2020-12-08,North Dakota,38,85688,2340,1064,36,360613,582,85676,582,274937,0
2020-12-08,Northern Mariana Islands,69,111,2,2,0,17121,2,111,2,17010,0
2020-12-08,Ohio,39,510018,25721,7103,80,6593404,66076,510018,25721,6083386,40355
2020-12-08,Oklahoma,40,220686,2297,1922,11,2259659,32441,220686,2297,2038973,30144
2020-12-08,Oregon,41,87082,1279,1082,33,2175160,21499,87082,1294,2088078,20205
2020-12-08,Pennsylvania,42,442528,10118,11592,161,3396338,26611,436614,10170,2959724,16441
2020-12-08,Puerto Rico,72,91931,694,1205,3,364288,694,58316,694,305972,0
2020-12-08,Rhode Island,44,67067,1249,1470,22,560886,3926,67067,1249,493819,2677
2020-12-08,South Carolina,45,236954,2302,4585,6,2581328,26462,236954,2302,2344374,24160
2020-12-08,South Dakota,46,87038,538,1111,1,342423,1228,87038,538,255385,690
2020-12-08,Tennessee,47,405149,5826,5051,98,4765211,31559,414749,6019,4350462,25540
2020-12-08,Texas,48,1375272,13896,23439,181,11954052,122853,1404646,19842,10549406,103011
2020-12-08,Utah,49,219971,2333,972,23,1409363,6260,219971,2333,1189392,3927
2020-12-08,Vermont,50,5180,100,85,4,235474,173,5180,100,230294,73
2020-12-08,Virgin Islands,78,1680,31,23,0,29841,178,1680,31,28161,147
2020-12-08,Virginia,51,262730,3860,4260,52,3579046,24550,262730,3860,3316316,20690
2020-12-08,Washington,53,194788,3320,3102,22,3177952,15939,197642,1182,2980310,14757
2020-12-08,West Virginia,54,57060,932,870,29,1245934,10351,57060,932,1188874,9419
2020-12-08,Wisconsin,55,448009,4594,4059,80,2655959,10097,448009,4620,2207950,5477
2020-12-08,Wyoming,56,37475,490,280,0,184614,1363,37475,490,147139,873
2020-12-09,Alabama,01,280187,3522,3985,43,1721812,10064,280187,3522,1441625,6542
2020-12-09,Alaska,02,38510,587,143,4,1099555,10577,37342,584,1062213,9993
2020-12-09,Arizona,04,384241,4579,7081,96,2432832,11772,382601,4444,2050231,7328
2020-12-09,Arkansas,05,176652,2327,2786,34,1824317,17106,176652,2327,1647665,14779
2020-12-09,California,06,1457214,31782,20466,228,26042071,252296,1420558,30851,24621513,221445
2020-12-09,Colorado,08,274354,3973,3671,163,1910906,11589,272346,3757,1638560,7832
2020-12-09,Connecticut,09,140548,2290,5285,43,3603855,30320,140548,2290,3463307,28030
2020-12-09,Delaware,10,42393,929,803,0,450786,3348,42393,929,408393,2419
2020-12-09,District of Columbia,11,23854,265,704,3,752507,6876,23854,265,728653,6611
2020-12-09,Florida,12,1083354,9592,19461,84,7671897,47471,1065476,9411,6606421,38060
2020-12-09,Georgia,13,499299,5741,9630,48,4578124,22681,456113,3744,4122011,18937
2020-12-09,Guam,66,8008,13,114,0,89195,581,7039,13,82156,568
2020-12-09,Hawaii,15,18785,73,264,4,314209,80,19056,80,295153,0
2020-12-09,Idaho,16,116677,2266,1124,43,510627,-2224,113905,2012,396722,-4236
2020-12-09,Illinois,17,813990,8196,14621,229,11367345,92737,812430,8256,10554915,84481
2020-12-09,Indiana,18,401219,5770,6506,96,2352854,14546,398417,5754,1954437,8792
2020-12-09,Iowa,19,248782,2545,3017,102,1107487,4750,216694,1797,890793,2953
2020-12-09,Kansas,20,183404,5624,1941,85,876052,14728,179803,5778,696249,8950
2020-12-09,Kentucky,21,212997,2765,2359,31,2829382,6904,209136,3468,2620246,3436
2020-12-09,Louisiana,22,258914,4352,6684,32,3679908,32522,258914,4352,3420994,28170
2020-12-09,Maine,23,14454,405,246,7,951213,8646,14454,405,936759,8241
2020-12-09,Maryland,24,222971,2692,4962,46,2490238,15763,222653,2692,2267585,13071
2020-12-09,Massachusetts,25,269412,5965,11166,90,3566445,26281,269412,5965,3297033,20316
2020-12-09,Michigan,26,447817,5313,10699,79,7166909,47656,448418,5342,6718491,42314
2020-12-09,Minnesota,27,363778,4516,4168,82,2704144,16133,363719,4516,2340425,11617
2020-12-09,Mississippi,28,170672,2746,4041,24,1196972,2746,170672,2746,1026300,0
2020-12-09,Missouri,29,349046,2885,4640,46,1887534,6033,330846,2640,1556688,3393
2020-12-09,Montana,30,70191,726,771,8,699468,2590,70133,787,629335,1803
2020-12-09,Nebraska,31,144087,1369,1305,17,780473,3980,142603,1476,637870,2504
2020-12-09,Nevada,32,176674,2624,2395,27,1039942,6812,176334,3053,863608,3759
2020-12-09,New Hampshire,33,27592,969,570,4,449993,3304,27592,969,422401,2335
2020-12-09,New Jersey,34,383354,4463,17542,116,6488525,139179,381486,4431,6107039,134748
2020-12-09,New Mexico,35,112950,1759,1823,34,1671260,1748,112950,1748,1558310,0
2020-12-09,New York,36,738947,10937,34799,76,21104040,194595,733064,10600,20370976,183995
2020-12-09,North Carolina,37,412140,7620,5704,62,5758894,53994,410527,6495,5348367,47499
2020-12-09,North Dakota,38,86149,461,1081,17,361358,745,86149,473,275209,272
2020-12-09,Northern Mariana Islands,69,113,2,2,0,17319,198,113,2,17206,196
2020-12-09,Ohio,39,520112,10094,7187,84,6643708,50304,520112,10094,6123596,40210
2020-12-09,Oklahoma,40,222993,2307,1945,23,2278911,19252,222993,2307,2055918,16945
2020-12-09,Oregon,41,88308,1226,1112,30,2193822,18662,88287,1205,2105535,17457
2020-12-09,Pennsylvania,42,451154,8626,11839,247,3417911,21573,445317,8703,2972594,12870
2020-12-09,Puerto Rico,72,92577,646,1219,14,364934,646,58962,646,305972,0
2020-12-09,Rhode Island,44,68299,1232,1484,14,566029,5143,68299,1232,497730,3911
2020-12-09,South Carolina,45,239444,2490,4612,27,2596781,15453,239444,2490,2357337,12963
2020-12-09,South Dakota,46,88023,985,1147,36,344472,2049,88023,985,256449,1064
2020-12-09,Tennessee,47,413043,7894,5113,62,4810238,45027,422962,8213,4387276,36814
2020-12-09,Texas,48,1390544,15272,23727,288,12037885,83833,1418252,13606,10619633,70227
2020-12-09,Utah,49,222545,2574,995,23,1417893,8530,222545,2574,1195348,5956
2020-12-09,Vermont,50,5285,105,86,1,236628,1154,5285,105,231343,1049
2020-12-09,Virgin Islands,78,1698,18,23,0,30204,363,1698,18,28506,345
2020-12-09,Virginia,51,267128,4398,4281,21,3607487,28441,267128,4398,3340359,24043
2020-12-09,Washington,53,197973,3185,3146,44,3211015,33063,201292,3650,3009723,29413
2020-12-09,West Virginia,54,58462,1402,901,31,1259831,13897,58462,1402,1201369,12495
2020-12-09,Wisconsin,55,452180,4171,4149,90,2668237,12278,452180,4171,2216057,8107
2020-12-09,Wyoming,56,37885,410,299,19,185419,805,37885,410,147534,395
2020-12-10,Alabama,01,284922,4735,4034,49,1734292,12480,284922,4735,1449370,7745
2020-12-10,Alaska,02,39146,636,148,5,1113360,13805,37962,620,1075398,13185
2020-12-10,Arizona,04,390047,5806,7173,92,2451811,18979,387529,4928,2064282,14051
2020-12-10,Arkansas,05,178854,2202,2820,34,1837779,13462,178854,2202,1658925,11260
2020-12-10,California,06,1491053,33839,20636,170,26324332,282261,1450235,29677,24874097,252584
2020-12-10,Colorado,08,278916,4562,3795,124,1926295,15389,276995,4649,1649300,10740
2020-12-10,Connecticut,09,142979,2431,5327,42,3640545,36690,142979,2431,3497566,34259
2020-12-10,Delaware,10,43036,643,806,3,453437,2651,43036,643,410401,2008
2020-12-10,District of Columbia,11,24098,244,708,4,757833,5326,24098,244,733735,5082
2020-12-10,Florida,12,1094689,11335,19590,129,7731735,59838,1076547,11071,6655188,48767
2020-12-10,Georgia,13,506802,7503,9683,53,4621841,43717,462175,6062,4159666,37655
2020-12-10,Guam,66,8021,13,116,2,89694,499,7052,13,82642,486
2020-12-10,Hawaii,15,18901,116,266,2,314332,123,19179,123,295153,0
2020-12-10,Idaho,16,118352,1675,1145,21,514491,3864,116203,2298,398288,1566
2020-12-10,Illinois,17,825136,11146,14852,231,11481848,114503,823531,11101,10658317,103402
2020-12-10,Indiana,18,407755,6536,6603,97,2369181,16327,404935,6518,1964246,9809
2020-12-10,Iowa,19,251027,2245,3116,99,1111940,4453,218377,1683,893563,2770
2020-12-10,Kansas,20,183750,346,1941,0,876052,0,179803,0,696249,0
2020-12-10,Kentucky,21,217112,4115,2387,28,2878401,49019,213450,4314,2664951,44705
2020-12-10,Louisiana,22,261329,2415,6724,40,3704865,24957,261329,2415,3443536,22542
2020-12-10,Maine,23,14861,407,246,0,961560,10347,14861,407,946699,9940
2020-12-10,Maryland,24,226173,3202,5012,50,2510206,19968,225855,3202,2284351,16766
2020-12-10,Massachusetts,25,274781,5369,11209,43,3590168,23723,274781,5369,3315387,18354
2020-12-10,Michigan,26,454180,6363,10895,196,7226999,60090,454720,6302,6772279,53788
2020-12-10,Minnesota,27,367277,3499,4257,89,2717840,13696,367218,3499,2350622,10197
2020-12-10,Mississippi,28,172955,2283,4083,42,1199255,2283,172955,2283,1026300,0
2020-12-10,Missouri,29,353082,4036,4690,50,1898753,11219,334704,3858,1564049,7361
2020-12-10,Montana,30,70954,763,786,15,702525,3057,70892,759,631633,2298
2020-12-10,Nebraska,31,145819,1732,1348,43,783697,3224,143924,1321,639773,1903
2020-12-10,Nevada,32,179409,2735,2448,53,1045846,5904,178527,2193,867319,3711
2020-12-10,New Hampshire,33,28273,681,584,14,453887,3894,28273,681,425614,3213
2020-12-10,New Jersey,34,388474,5120,17608,66,6537755,49230,386606,5120,6151149,44110
2020-12-10,New Mexico,35,114731,1781,1846,23,1692676,21416,114731,1781,1577945,19635
2020-12-10,New York,36,749204,10257,34884,85,21301446,197406,743242,10178,20558204,187228
2020-12-10,North Carolina,37,417951,5811,5752,48,5778458,19564,416083,5556,5362375,14008
2020-12-10,North Dakota,38,86713,564,1109,28,362737,1379,86707,558,276030,821
2020-12-10,Northern Mariana Islands,69,113,0,2,0,17319,0,113,0,17206,0
2020-12-10,Ohio,39,531850,11738,7298,111,6706714,63006,531850,11738,6174864,51268
2020-12-10,Oklahoma,40,225453,2460,1980,35,2297621,18710,225453,2460,2072168,16250
2020-12-10,Oregon,41,89838,1530,1124,12,2216527,22705,89838,1551,2126689,21154
2020-12-10,Pennsylvania,42,463175,12021,12066,227,3450796,32885,457289,11972,2993507,20913
2020-12-10,Puerto Rico,72,93073,496,1238,19,365430,496,59458,496,305972,0
2020-12-10,Rhode Island,44,69247,948,1498,14,568204,2175,69247,948,498957,1227
2020-12-10,South Carolina,45,241686,2242,4627,15,2614236,17455,241686,2242,2372550,15213
2020-12-10,South Dakota,46,88727,704,1177,30,346200,1728,88727,704,257473,1024
2020-12-10,Tennessee,47,418902,5859,5183,70,4841914,31676,428973,6011,4412941,25665
2020-12-10,Texas,48,1403687,13143,23967,240,12076734,38849,1433551,15299,10643183,23550
2020-12-10,Utah,49,225946,3401,1016,21,1427973,10080,225946,3401,1202027,6679
2020-12-10,Vermont,50,5413,128,89,3,238653,2025,5413,128,233240,1897
2020-12-10,Virgin Islands,78,1733,35,23,0,30480,276,1733,35,28747,241
2020-12-10,Virginia,51,271043,3915,4335,54,3636064,28577,271043,3915,3365021,24662
2020-12-10,Washington,53,201179,3206,3075,-71,3239834,28819,204269,2977,3035565,25842
2020-12-10,West Virginia,54,59695,1233,921,20,1275008,15177,59695,1233,1215313,13944
2020-12-10,Wisconsin,55,456889,4709,4216,67,2681467,13230,456889,4709,2224578,8521
2020-12-10,Wyoming,56,38223,338,299,0,186885,1466,38223,338,148662,1128
2020-12-11,Alabama,01,288775,3853,4086,52,1747335,13043,288775,3853,1458560,9190
2020-12-11,Alaska,02,39773,627,151,3,1123545,10185,38584,622,1084961,9563
2020-12-11,Arizona,04,398150,8103,7250,77,2475382,23571,394512,6983,2080870,16588
2020-12-11,Arkansas,05,181624,2770,2875,55,1853792,16013,181624,2770,1672168,13243
2020-12-11,California,06,1528177,37124,20854,218,26572343,248011,1485703,35468,25086640,212543
2020-12-11,Colorado,08,283571,4655,3858,63,1940699,14404,281673,4678,1659026,9726
2020-12-11,Connecticut,09,146761,3782,5363,36,3695091,54546,146761,3782,3548330,50764
2020-12-11,Delaware,10,43818,782,807,1,456379,2942,43818,782,412561,2160
2020-12-11,District of Columbia,11,24357,259,709,1,762746,4913,24357,259,738389,4654
2020-12-11,Florida,12,1106388,11699,19713,123,7786912,55177,1087956,11409,6698956,43768
2020-12-11,Georgia,13,512715,5913,9738,55,4657199,35358,466904,4729,4190295,30629
2020-12-11,Guam,66,8048,27,116,0,90109,415,7079,27,83030,388
2020-12-11,Hawaii,15,19029,128,267,1,314468,136,19315,136,295153,0
2020-12-11,Idaho,16,119934,1582,1169,24,518245,3754,118028,1825,400217,1929
2020-12-11,Illinois,17,834668,9532,15076,224,11586296,104448,832951,9420,10753345,95028
2020-12-11,Indiana,18,414961,7206,6673,70,2387500,18319,412135,7200,1975365,11119
2020-12-11,Iowa,19,253612,2585,3193,77,1115807,3867,219914,1537,895893,2330
2020-12-11,Kansas,20,188610,4860,2072,131,890717,14665,185294,5491,705423,9174
2020-12-11,Kentucky,21,220898,3786,2416,29,2895500,17099,217120,3670,2678380,13429
2020-12-11,Louisiana,22,264191,2862,6767,43,3739272,34407,264191,2862,3475081,31545
2020-12-11,Maine,23,15206,345,250,4,971996,10436,15206,345,956790,10091
2020-12-11,Maryland,24,228792,2619,5064,52,2527160,16954,228471,2616,2298689,14338
2020-12-11,Massachusetts,25,280436,5655,11257,48,3616768,26600,280436,5655,3336332,20945
2020-12-11,Michigan,26,459811,5631,10961,66,7285348,58349,460346,5626,6825002,52723
2020-12-11,Minnesota,27,371027,3750,4351,94,2736162,18322,370968,3750,2365194,14572
2020-12-11,Mississippi,28,175282,2327,4124,41,1201582,2327,175282,2327,1026300,0
2020-12-11,Missouri,29,355147,2065,4704,14,1908211,9458,338604,3900,1569607,5558
2020-12-11,Montana,30,71931,977,805,19,711734,9209,71870,978,639864,8231
2020-12-11,Nebraska,31,147037,1218,1363,15,789093,5396,145774,1850,643319,3546
2020-12-11,Nevada,32,181922,2513,2488,40,1048852,3006,181310,2783,867542,223
2020-12-11,New Hampshire,33,29460,1187,590,6,458435,4548,29460,1187,428975,3361
2020-12-11,New Jersey,34,392124,3650,17662,54,6587012,49257,390256,3650,6196756,45607
2020-12-11,New Mexico,35,116565,1834,1889,43,1707040,14364,116565,1834,1590475,12530
2020-12-11,New York,36,759765,10561,34983,99,21514118,212672,753837,10595,20760281,202077
2020-12-11,North Carolina,37,424991,7040,5791,39,5879122,100664,423623,7540,5455499,93124
2020-12-11,North Dakota,38,87220,507,1136,27,363971,1234,87214,507,276757,727
2020-12-11,Northern Mariana Islands,69,113,0,2,0,17319,0,113,0,17206,0
2020-12-11,Ohio,39,542209,10359,7426,128,6772307,65593,542209,10359,6230098,55234
2020-12-11,Oklahoma,40,229353,3900,2007,27,2320719,23098,229353,3900,2091366,19198
2020-12-11,Oregon,41,91434,1596,1147,23,2242771,26244,91420,1582,2151351,24662
2020-12-11,Pennsylvania,42,475844,12669,12298,232,3479544,28748,470034,12745,3009510,16003
2020-12-11,Puerto Rico,72,94617,1544,1249,11,366974,1544,61002,1544,305972,0
2020-12-11,Rhode Island,44,70818,1571,1509,11,573689,5485,70818,1571,502871,3914
2020-12-11,South Carolina,45,245226,3540,4673,46,2651756,37520,245226,3540,2406530,33980
2020-12-11,South Dakota,46,89672,945,1210,33,348369,2169,89672,945,258697,1224
2020-12-11,Tennessee,47,425954,7052,5271,88,4896753,54839,436262,7289,4460491,47550
2020-12-11,Texas,48,1461943,58256,24208,241,12086122,9388,1448002,14451,10638120,-5063
2020-12-11,Utah,49,228146,2200,1027,11,1436053,8080,228129,2183,1207924,5897
2020-12-11,Vermont,50,5541,128,93,4,240617,1964,5541,128,235076,1836
2020-12-11,Virgin Islands,78,1791,58,23,0,30480,0,1733,0,28747,0
2020-12-11,Virginia,51,274438,3395,4370,35,3670649,34585,274438,3395,3396211,31190
2020-12-11,Washington,53,204484,3305,3097,22,3271251,31417,206826,2557,3064425,28860
2020-12-11,West Virginia,54,60637,942,938,17,1293240,18232,60637,942,1232603,17290
2020-12-11,Wisconsin,55,461367,4478,4272,56,2693132,11665,461367,4478,2231765,7187
2020-12-11,Wyoming,56,38785,562,321,22,188321,1436,38785,562,149536,874
2020-12-12,Alabama,01,292841,4066,4102,16,1751401,4066,292841,4066,1458560,0
2020-12-12,Alaska,02,40293,520,169,18,1133418,9873,39101,517,1094317,9356
2020-12-12,Arizona,04,405656,7506,7340,90,2501754,26372,402589,8077,2099165,18295
2020-12-12,Arkansas,05,184252,2628,2911,36,1869408,15616,184252,2628,1685156,12988
2020-12-12,California,06,1554863,26686,20958,104,26886130,313787,1521432,35729,25364698,278058
2020-12-12,Colorado,08,287364,3793,3916,58,1955626,14927,285634,3961,1669992,10966
2020-12-12,Connecticut,09,146761,0,5363,0,3695091,0,146761,0,3548330,0
2020-12-12,Delaware,10,44876,1058,815,8,460700,4321,44876,1058,415824,3263
2020-12-12,District of Columbia,11,24643,286,713,4,770914,8168,24643,286,746271,7882
2020-12-12,Florida,12,1116965,10577,19784,71,7839137,52225,1098341,10385,6740796,41840
2020-12-12,Georgia,13,518973,6258,9779,41,4696707,39508,471734,4830,4224973,34678
2020-12-12,Guam,66,8059,11,118,2,90120,11,7090,11,83030,0
2020-12-12,Hawaii,15,19225,196,269,2,314665,197,19512,197,295153,0
2020-12-12,Idaho,16,120703,769,1173,4,521598,3353,119610,1582,401988,1771
2020-12-12,Illinois,17,843328,8660,15232,156,11713184,126888,841688,8737,10871496,118151
2020-12-12,Indiana,18,422368,7407,6758,85,2406388,18888,419536,7401,1986852,11487
2020-12-12,Iowa,19,255009,1397,3208,15,1119355,3548,221159,1245,898196,2303
2020-12-12,Kansas,20,188610,0,2072,0,890717,0,185294,0,705423,0
2020-12-12,Kentucky,21,224155,3257,2446,30,2914184,18684,220660,3540,2693524,15144
2020-12-12,Louisiana,22,264191,0,6767,0,3739272,0,264191,0,3475081,0
2020-12-12,Maine,23,15620,414,257,7,972410,414,15620,414,956790,0
2020-12-12,Maryland,24,232172,3380,5100,36,2547454,20294,232009,3538,2315445,16756
2020-12-12,Massachusetts,25,285725,5289,11307,50,3640748,23980,285725,5289,3355023,18691
2020-12-12,Michigan,26,464368,4557,11186,225,7341990,56642,465159,4813,6876831,51829
2020-12-12,Minnesota,27,375457,4430,4418,67,2753902,17740,375398,4430,2378504,13310
2020-12-12,Mississippi,28,177947,2665,4180,56,1204247,2665,177947,2665,1026300,0
2020-12-12,Missouri,29,360623,5476,4754,50,1917786,9575,342347,3743,1575439,5832
2020-12-12,Montana,30,72659,728,816,11,718502,6768,72644,774,645858,5994
2020-12-12,Nebraska,31,147792,755,1385,22,793417,4324,146877,1103,646540,3221
2020-12-12,Nevada,32,184527,2605,2530,42,1056620,7768,183951,2641,872669,5127
2020-12-12,New Hampshire,33,30244,784,600,10,461629,3194,30244,784,431385,2410
2020-12-12,New Jersey,34,398364,6240,17732,70,6593252,6240,396496,6240,6196756,0
2020-12-12,New Mexico,35,118358,1793,1913,24,1719109,12069,118358,1793,1600751,10276
2020-12-12,New York,36,770804,11039,35074,91,21757045,242927,764966,11129,20992079,231798
2020-12-12,North Carolina,37,430325,5334,5831,40,5936625,57503,429776,6153,5506849,51350
2020-12-12,North Dakota,38,87596,376,1158,22,365062,1091,87590,376,277472,715
2020-12-12,Northern Mariana Islands,69,113,0,2,0,17319,0,113,0,17206,0
2020-12-12,Ohio,39,553461,11252,7477,51,6840149,67842,553461,11252,6286688,56590
2020-12-12,Oklahoma,40,233336,3983,2042,35,2343815,23096,233336,3983,2110479,19113
2020-12-12,Oregon,41,92839,1405,1155,8,2244190,1419,92839,1419,2151351,0
2020-12-12,Pennsylvania,42,485901,10057,12489,191,3506371,26827,481118,11084,3025253,15743
2020-12-12,Puerto Rico,72,95338,721,1266,17,367695,721,61723,721,305972,0
2020-12-12,Rhode Island,44,70818,0,1509,0,577857,4168,72649,1831,505208,2337
2020-12-12,South Carolina,45,248798,3572,4685,12,2655328,3572,248798,3572,2406530,0
2020-12-12,South Dakota,46,90407,735,1243,33,350215,1846,90407,735,259808,1111
2020-12-12,Tennessee,47,432246,6292,5344,73,4909997,13244,442953,6691,4467044,6553
2020-12-12,Texas,48,1473318,11375,24400,192,12089107,2985,1464362,16360,10624745,-13375
2020-12-12,Utah,49,231821,3675,1039,12,1446950,10897,231821,3692,1215129,7205
2020-12-12,Vermont,50,5626,85,95,2,241841,1224,5626,85,236215,1139
2020-12-12,Virgin Islands,78,1791,0,23,0,31253,773,1791,58,29462,715
2020-12-12,Virginia,51,278615,4177,4409,39,3707999,37350,278615,4177,3429384,33173
2020-12-12,Washington,53,207399,2915,3043,-54,3299629,28378,209247,2421,3090382,25957
2020-12-12,West Virginia,54,62151,1514,966,28,1309396,16156,62151,1514,1247245,14642
2020-12-12,Wisconsin,55,465991,4624,4329,57,2707339,14207,465991,4624,2241348,9583
2020-12-12,Wyoming,56,38907,122,321,0,188443,122,38907,122,149536,0
2020-12-13,Alabama,01,295631,2790,4102,0,1754191,2790,295631,2790,1458560,0
2020-12-13,Alaska,02,40934,641,169,0,1143098,9680,39738,637,1103360,9043
2020-12-13,Arizona,04,408646,2990,7357,17,2528147,26393,408442,5853,2119705,20540
2020-12-13,Arkansas,05,185702,1450,2945,34,1882283,12875,185702,1450,1696581,11425
2020-12-13,California,06,1590670,35807,21043,85,27195587,309457,1551766,30334,25643821,279123
2020-12-13,Colorado,08,289679,2315,3982,66,1967409,11783,288193,2559,1679216,9224
2020-12-13,Connecticut,09,146761,0,5363,0,3695091,0,146761,0,3548330,0
2020-12-13,Delaware,10,45460,584,816,1,463363,2663,45460,584,417903,2079
2020-12-13,District of Columbia,11,24874,231,715,2,778265,7351,24874,231,753391,7120
2020-12-13,Florida,12,1125923,8958,19865,81,7877488,38351,1107103,8762,6770385,29589
2020-12-13,Georgia,13,523580,4607,9781,2,4729534,32827,476044,4310,4253490,28517
2020-12-13,Guam,66,8075,16,119,1,90136,16,7106,16,83030,0
2020-12-13,Hawaii,15,19302,77,272,3,314752,87,19599,87,295153,0
2020-12-13,Idaho,16,121243,540,1179,6,523879,2281,120632,1022,403247,1259
2020-12-13,Illinois,17,850412,7084,15340,108,11776832,63648,848904,7216,10927928,56432
2020-12-13,Indiana,18,428275,5907,6805,47,2423719,17331,425434,5898,1998285,11433
2020-12-13,Iowa,19,256249,1240,3209,1,1122583,3228,222148,989,900435,2239
2020-12-13,Kansas,20,188660,50,2072,0,890717,0,185294,0,705423,0
2020-12-13,Kentucky,21,226604,2449,2453,7,2916628,2444,223104,2444,2693524,0
2020-12-13,Louisiana,22,268613,4422,6818,51,3794201,54929,268613,4422,3525588,50507
2020-12-13,Maine,23,15923,303,257,0,972713,303,15923,303,956790,0
2020-12-13,Maryland,24,234975,2803,5117,17,2565648,18194,234647,2638,2331001,15556
2020-12-13,Massachusetts,25,290578,4853,11349,42,3663352,22604,290578,4853,3372774,17751
2020-12-13,Michigan,26,464606,238,11186,0,7341990,0,465159,0,6876831,0
2020-12-13,Minnesota,27,378882,3425,4503,85,2769643,15741,378823,3425,2390820,12316
2020-12-13,Mississippi,28,179447,1500,4199,19,1205747,1500,179447,1500,1026300,0
2020-12-13,Missouri,29,363246,2623,4761,7,1925812,8026,345041,2694,1580771,5332
2020-12-13,Montana,30,73303,644,818,2,722308,3806,73303,659,649005,3147
2020-12-13,Nebraska,31,149044,1252,1389,4,795716,2299,147688,811,648028,1488
2020-12-13,Nevada,32,187502,2975,2545,15,1063513,6893,186833,2882,876680,4011
2020-12-13,New Hampshire,33,30956,712,603,3,464479,2850,30956,712,433523,2138
2020-12-13,New Jersey,34,402518,4154,17751,19,6597406,4154,400650,4154,6196756,0
2020-12-13,New Mexico,35,119800,1442,1957,44,1732004,12895,119800,1442,1612204,11453
2020-12-13,New York,36,780831,10027,35198,124,21962295,205250,775160,10194,21187135,195056
2020-12-13,North Carolina,37,436655,6330,5855,24,6000910,64285,436595,6819,5564315,57466
2020-12-13,North Dakota,38,87877,281,1158,0,365709,647,87871,281,277838,366
2020-12-13,Northern Mariana Islands,69,113,0,2,0,17319,0,113,0,17206,0
2020-12-13,Ohio,39,562727,9266,7492,15,6895762,55613,562727,9266,6333035,46347
2020-12-13,Oklahoma,40,237668,4332,2064,22,2348147,4332,237668,4332,2110479,0
2020-12-13,Oregon,41,93853,1014,1158,3,2245204,1014,93853,1014,2151351,0
2020-12-13,Pennsylvania,42,495906,10005,12613,124,3537125,30754,491802,10684,3045323,20070
2020-12-13,Puerto Rico,72,96046,708,1272,6,368403,708,62431,708,305972,0
2020-12-13,Rhode Island,44,70818,0,1509,0,581842,3985,73519,870,508323,3115
2020-12-13,South Carolina,45,252206,3408,4739,54,2719621,64293,252206,3408,2467415,60885
2020-12-13,South Dakota,46,91038,631,1259,16,351856,1641,91038,631,260818,1010
2020-12-13,Tennessee,47,442707,10461,5406,62,4994602,84605,454305,11352,4540297,73253
2020-12-13,Texas,48,1480047,6729,24501,101,12173510,84403,1472711,8349,10700799,76054
2020-12-13,Utah,49,233904,2083,1055,16,1455319,8369,233904,2083,1221415,6286
2020-12-13,Vermont,50,5753,127,95,0,243515,1674,5753,127,237762,1547
2020-12-13,Virgin Islands,78,1791,0,23,0,31253,0,1791,0,29462,0
2020-12-13,Virginia,51,281909,3294,4411,2,3740737,32738,281909,3294,3458828,29444
2020-12-13,Washington,53,209385,1986,3045,2,3331810,32181,211475,2228,3120335,29953
2020-12-13,West Virginia,54,63217,1066,968,2,1322664,13268,63217,1066,1259447,12202
2020-12-13,Wisconsin,55,468956,2965,4344,15,2719722,12383,468956,2965,2250766,9418
2020-12-13,Wyoming,56,39360,453,321,0,188896,453,39360,453,149536,0
2020-12-14,Alabama,01,297895,2264,4102,0,1776802,22611,297895,2264,1478907,20347
2020-12-14,Alaska,02,41363,429,169,0,1147560,4462,40160,422,1107400,4040
2020-12-14,Arizona,04,420459,11813,7358,1,2547176,19029,420248,11806,2126928,7223
2020-12-14,Arkansas,05,187057,1355,2990,45,1893350,11067,187507,1805,1705843,9262
2020-12-14,California,06,1620870,30200,21196,153,27552039,356452,1585044,33278,25966995,323174
2020-12-14,Colorado,08,291645,1966,4015,33,1980707,13298,291104,2911,1689603,10387
2020-12-14,Connecticut,09,153992,7231,5444,81,3814335,119244,153992,7231,3660343,112013
2020-12-14,Delaware,10,46457,997,816,0,467413,4050,46457,997,420956,3053
2020-12-14,District of Columbia,11,25038,164,716,1,782979,4714,25038,164,757941,4550
2020-12-14,Florida,12,1134375,8452,20002,137,7918013,40525,1115446,8343,6802567,32182
2020-12-14,Georgia,13,527157,3577,9803,22,4755530,25996,479340,3296,4276190,22700
2020-12-14,Guam,66,8106,31,120,1,91132,996,7137,31,83995,965
2020-12-14,Hawaii,15,19489,187,272,0,314941,189,19788,189,295153,0
2020-12-14,Idaho,16,122679,1436,1199,20,525660,1781,121179,547,404481,1234
2020-12-14,Illinois,17,857860,7448,15458,118,11869088,92256,856118,7214,11012970,85042
2020-12-14,Indiana,18,433242,4967,6840,35,2435885,12166,430401,4967,2005484,7199
2020-12-14,Iowa,19,256902,653,3269,60,1124774,2191,222785,637,901989,1554
2020-12-14,Kansas,20,193109,4449,2109,37,903732,13015,190018,4724,713714,8291
2020-12-14,Kentucky,21,228668,2064,2472,19,2956293,39665,224890,1786,2731403,37879
2020-12-14,Louisiana,22,269643,1030,6845,27,3804370,10169,269643,1030,3534727,9139
2020-12-14,Maine,23,16349,426,259,2,993373,20660,16349,426,977024,20234
2020-12-14,Maryland,24,237215,2240,5142,25,2580984,15336,236961,2314,2344023,13022
2020-12-14,Massachusetts,25,294231,3653,11388,39,3680609,17257,294231,3653,3386378,13604
2020-12-14,Michigan,26,472166,7560,11282,96,7430448,88458,472780,7621,6957668,80837
2020-12-14,Minnesota,27,381900,3018,4521,18,2785429,15786,381841,3018,2403588,12768
2020-12-14,Mississippi,28,181095,1648,4204,5,1260755,55008,181095,1648,1079660,53360
2020-12-14,Missouri,29,367510,4264,4787,26,1933243,7431,347603,2562,1585640,4869
2020-12-14,Montana,30,73356,53,818,0,722308,0,73303,0,649005,0
2020-12-14,Nebraska,31,149620,576,1432,43,798923,3207,148861,1173,650062,2034
2020-12-14,Nevada,32,189805,2303,2557,12,1070420,6907,189412,2579,881008,4328
2020-12-14,New Hampshire,33,31875,919,604,1,468280,3801,31875,919,436405,2882
2020-12-14,New Jersey,34,407316,4798,17775,24,6786635,189229,405448,4798,6381187,184431
2020-12-14,New Mexico,35,121299,1499,1978,21,1741401,9397,121299,1499,1620102,7898
2020-12-14,New York,36,789815,8984,35288,90,22122139,159844,784204,9044,21337935,150800
2020-12-14,North Carolina,37,441721,5066,5899,44,6046926,46016,441365,4770,5605561,41246
2020-12-14,North Dakota,38,88073,196,1163,5,366246,537,88067,196,278179,341
2020-12-14,Northern Mariana Islands,69,113,0,2,0,17319,0,113,0,17206,0
2020-12-14,Ohio,39,570602,7875,7551,59,6955181,59419,570602,7875,6384579,51544
2020-12-14,Oklahoma,40,239767,2099,2072,8,2350246,2099,239767,2099,2110479,0
2020-12-14,Oregon,41,95042,1189,1168,10,2304931,59727,95010,1157,2209921,58570
2020-12-14,Pennsylvania,42,505422,9516,12668,55,3560453,23328,499764,7962,3060689,15366
2020-12-14,Puerto Rico,72,96600,554,1282,10,368957,554,62985,554,305972,0
2020-12-14,Rhode Island,44,74071,3253,1555,46,584367,2525,74071,552,510296,1973
2020-12-14,South Carolina,45,254776,2570,4751,12,2745200,25579,254776,2570,2490424,23009
2020-12-14,South Dakota,46,91354,316,1259,0,352547,691,91354,316,261193,375
2020-12-14,Tennessee,47,452476,9769,5484,78,5055140,60538,464264,9959,4590876,50579
2020-12-14,Texas,48,1493857,13810,24582,81,12308459,134949,1481612,8901,10826847,126048
2020-12-14,Utah,49,235872,1968,1065,10,1461066,5747,235872,1968,1225194,3779
2020-12-14,Vermont,50,5857,104,96,1,245350,1835,5857,104,239493,1731
2020-12-14,Virgin Islands,78,1807,16,23,0,31379,126,1807,16,29572,110
2020-12-14,Virginia,51,285149,3240,4414,3,3767596,26859,285149,3240,3482447,23619
2020-12-14,Washington,53,212342,2957,3084,39,3358725,26915,212885,1410,3145840,25505
2020-12-14,West Virginia,54,64394,1177,978,10,1331983,9319,64394,1177,1267589,8142
2020-12-14,Wisconsin,55,471285,2329,4359,15,2727279,7557,471285,2329,2255994,5228
2020-12-14,Wyoming,56,39775,415,321,0,191036,2140,39775,415,151261,1725
2020-12-15,Alabama,01,301533,3638,4124,22,1786715,9913,301533,3638,1485182,6275
2020-12-15,Alaska,02,41645,282,172,3,1157867,10307,40438,278,1117429,10029
2020-12-15,Arizona,04,427121,6662,7428,70,2561564,14388,424382,4134,2137182,10254
2020-12-15,Arkansas,05,189198,2141,3016,26,1902077,8727,189198,1691,1712879,7036
2020-12-15,California,06,1655086,34216,21483,287,27845066,293027,1617370,32326,26227696,260701
2020-12-15,Colorado,08,295558,3913,4131,116,1987721,7014,293382,2278,1694339,4736
2020-12-15,Connecticut,09,155462,1470,5466,22,3839064,24729,155462,1470,3683602,23259
2020-12-15,Delaware,10,47142,685,826,10,470171,2758,47142,685,423029,2073
2020-12-15,District of Columbia,11,25339,301,720,4,791984,9005,25339,301,766645,8704
2020-12-15,Florida,12,1143786,9411,20081,79,7961744,43731,1124742,9296,6837002,34435
2020-12-15,Georgia,13,534488,7331,9856,53,4794475,38945,484152,4812,4310323,34133
2020-12-15,Guam,66,8118,12,120,0,91609,477,7149,12,84460,465
2020-12-15,Hawaii,15,19541,52,272,0,314997,56,19844,56,295153,0
2020-12-15,Idaho,16,124286,1607,1219,20,527256,1596,122217,1038,405039,558
2020-12-15,Illinois,17,865261,7401,15591,133,11962010,92922,863477,7359,11098533,85563
2020-12-15,Indiana,18,437513,4271,6968,128,2446551,10666,434642,4241,2011909,6425
2020-12-15,Iowa,19,258253,1351,3337,68,1127084,2310,223511,726,903573,1584
2020-12-15,Kansas,20,193555,446,2109,0,903732,0,190018,0,713714,0
2020-12-15,Kentucky,21,231287,2619,2499,27,2967046,10753,227818,2928,2739228,7825
2020-12-15,Louisiana,22,272276,2633,6895,50,3838249,33879,272276,2633,3565973,31246
2020-12-15,Maine,23,16760,411,265,6,999291,5918,16760,411,982531,5507
2020-12-15,Maryland,24,239694,2479,5206,64,2593877,12893,239362,2401,2354515,10492
2020-12-15,Massachusetts,25,298160,3929,11443,55,3700153,19544,298160,3929,3401993,15615
2020-12-15,Michigan,26,477613,5447,11488,206,7480152,49704,478171,5391,7001981,44313
2020-12-15,Minnesota,27,384223,2323,4542,21,2797923,12494,384164,2323,2413759,10171
2020-12-15,Mississippi,28,183300,2205,4252,48,1262960,2205,183300,2205,1079660,0
2020-12-15,Missouri,29,370869,3359,4959,172,1940007,6764,350365,2762,1589642,4002
2020-12-15,Montana,30,74160,804,826,8,732739,10431,74040,737,658699,9694
2020-12-15,Nebraska,31,151228,1608,1454,22,800242,1319,149344,483,650898,836
2020-12-15,Nevada,32,192109,2304,2609,52,1078605,8185,191732,2320,886873,5865
2020-12-15,New Hampshire,33,32545,670,604,0,471037,2757,32545,670,438492,2087
2020-12-15,New Jersey,34,411282,3966,17872,97,6870323,83688,409414,3966,6460909,79722
2020-12-15,New Mexico,35,122557,1258,2006,28,1755426,14025,122557,1258,1632869,12767
2020-12-15,New York,36,799551,9736,35425,137,22316327,194188,794557,10353,21521770,183835
2020-12-15,North Carolina,37,447303,5582,5926,27,6097725,50799,446601,5236,5651124,45563
2020-12-15,North Dakota,38,88401,328,1176,13,367013,767,88395,328,278618,439
2020-12-15,Northern Mariana Islands,69,113,0,2,0,17542,223,113,0,17429,223
2020-12-15,Ohio,39,579357,8755,7654,103,7002480,47299,579357,8755,6423123,38544
2020-12-15,Oklahoma,40,241991,2224,2086,14,2389948,39702,241991,2224,2147957,37478
2020-12-15,Oregon,41,96093,1051,1213,45,2343728,38797,96092,1082,2247636,37715
2020-12-15,Pennsylvania,42,515009,9587,12930,262,3581625,21172,509320,9556,3072305,11616
2020-12-15,Puerto Rico,72,97034,434,1294,12,369391,434,63419,434,305972,0
2020-12-15,Rhode Island,44,75237,1166,1570,15,588389,4022,75237,1166,513152,2856
2020-12-15,South Carolina,45,257320,2544,4756,5,2769559,24359,257320,2544,2512239,21815
2020-12-15,South Dakota,46,91699,345,1261,2,353282,735,91699,345,261583,390
2020-12-15,Tennessee,47,460454,7978,5557,73,5100997,45857,472875,8611,4628122,37246
2020-12-15,Texas,48,1513359,19502,24796,214,12431261,122802,1500538,18926,10930723,103876
2020-12-15,Utah,49,237787,1915,1078,13,1466514,5448,237787,1915,1228727,3533
2020-12-15,Vermont,50,5923,66,100,4,245602,252,5923,66,239679,186
2020-12-15,Virgin Islands,78,1828,21,23,0,31644,265,1828,21,29816,244
2020-12-15,Virginia,51,288309,3160,4470,56,3794025,26429,288309,3160,3505716,23269
2020-12-15,Washington,53,214085,1743,3123,39,3390084,31359,213537,652,3176547,30707
2020-12-15,West Virginia,54,65708,1314,1012,34,1341407,9424,65701,1307,1275706,8117
2020-12-15,Wisconsin,55,475340,4055,4412,53,2735132,7853,475340,4055,2259792,3798
2020-12-15,Wyoming,56,40064,289,328,7,191582,546,40064,289,151518,257
2020-12-16,Alabama,01,305640,4107,4198,74,1796919,10204,305640,4107,1491279,6097
2020-12-16,Alaska,02,42256,611,174,2,1166145,8278,41041,603,1125104,7675
2020-12-16,Arizona,04,431330,4209,7558,130,2577409,15845,429219,4837,2148190,11008
2020-12-16,Arkansas,05,191504,2306,3074,58,1914362,12285,191504,2306,1722858,9979
2020-12-16,California,06,1716027,60941,21881,398,28149590,304524,1671081,53711,26478509,250813
2020-12-16,Colorado,08,298492,2934,4192,61,1997929,10208,296716,3334,1701213,6874
2020-12-16,Connecticut,09,157781,2319,5506,40,3870391,31327,157781,2319,3712610,29008
2020-12-16,Delaware,10,47929,787,833,7,473493,3322,47929,787,425564,2535
2020-12-16,District of Columbia,11,25602,263,720,0,798388,6404,25602,263,772786,6141
2020-12-16,Florida,12,1155327,11541,20203,122,8012061,50317,1136024,11282,6876037,39035
2020-12-16,Georgia,13,541086,6598,9913,57,4817908,23433,488338,4186,4329570,19247
2020-12-16,Guam,66,8137,19,120,0,91915,306,7168,19,84747,287
2020-12-16,Hawaii,15,19645,104,276,4,315107,110,19954,110,295153,0
2020-12-16,Idaho,16,125834,1548,1247,28,531823,4567,124019,1802,407804,2765
2020-12-16,Illinois,17,872294,7033,15780,189,12055288,93278,870600,7123,11184688,86155
2020-12-16,Indiana,18,443734,6221,7101,133,2461562,15011,440850,6208,2020712,8803
2020-12-16,Iowa,19,260784,2531,3354,17,1131182,4098,225050,1539,906132,2559
2020-12-16,Kansas,20,197903,4348,2253,144,918265,14533,194569,4551,723696,9982
2020-12-16,Kentucky,21,234207,2920,2529,30,2983093,16047,230693,2875,2752400,13172
2020-12-16,Louisiana,22,275545,3269,6933,38,3863633,25384,275545,3269,3588088,22115
2020-12-16,Maine,23,17311,551,267,2,1008178,8887,17311,551,990867,8336
2020-12-16,Maryland,24,242057,2363,5270,64,2607611,13734,241767,2405,2365844,11329
2020-12-16,Massachusetts,25,304112,5952,11513,70,3728879,28726,304112,5952,3424767,22774
2020-12-16,Michigan,26,482217,4604,11582,94,7534591,54439,482815,4644,7051776,49795
2020-12-16,Minnesota,27,386471,2248,4634,92,2804803,6880,386412,2248,2418391,4632
2020-12-16,Mississippi,28,185643,2343,4294,42,1265303,2343,185643,2343,1079660,0
2020-12-16,Missouri,29,374010,3141,5043,84,1946697,6690,353038,2673,1593659,4017
2020-12-16,Montana,30,74764,604,836,10,736059,3320,74644,604,661415,2716
2020-12-16,Nebraska,31,152562,1334,1462,8,804015,3773,150861,1517,653154,2256
2020-12-16,Nevada,32,194461,2352,2659,50,1084570,5965,194098,2366,890472,3599
2020-12-16,New Hampshire,33,33433,888,625,21,473346,2309,33433,888,439913,1421
2020-12-16,New Jersey,34,416983,5701,18003,131,6945615,75292,415075,5661,6530540,69631
2020-12-16,New Mexico,35,124357,1800,2049,43,1767408,11982,124357,1800,1643051,10182
2020-12-16,New York,36,808929,9378,35522,97,22477274,160947,804555,9998,21672719,150949
2020-12-16,North Carolina,37,453628,6325,6030,104,6138845,41120,451874,5273,5686971,35847
2020-12-16,North Dakota,38,88692,291,1201,25,367830,817,88686,291,279144,526
2020-12-16,Northern Mariana Islands,69,113,0,2,0,17542,0,113,0,17429,0
2020-12-16,Ohio,39,584766,5409,7777,123,7040469,37989,584766,5409,6455703,32580
2020-12-16,Oklahoma,40,245229,3238,2128,42,2403866,13918,245229,3238,2158637,10680
2020-12-16,Oregon,41,97625,1532,1267,54,2368409,24681,97622,1530,2270787,23151
2020-12-16,Pennsylvania,42,525199,10190,13200,270,3605428,23803,519369,10049,3086059,13754
2020-12-16,Puerto Rico,72,97301,267,1312,18,369658,267,63686,267,305972,0
2020-12-16,Rhode Island,44,76209,972,1590,20,591698,3309,76209,972,515489,2337
2020-12-16,South Carolina,45,260119,2799,4800,44,2791674,22115,260119,2799,2531555,19316
2020-12-16,South Dakota,46,92604,905,1300,39,355614,2332,92603,904,263011,1428
2020-12-16,Tennessee,47,471348,10894,5610,53,5161287,60290,484285,11410,4677002,48880
2020-12-16,Texas,48,1535323,21964,25078,282,12511684,80423,1519340,18802,10992344,61621
2020-12-16,Utah,49,240715,2928,1102,24,1475127,8613,240715,2928,1234412,5685
2020-12-16,Vermont,50,6009,86,105,5,246178,576,6009,86,240169,490
2020-12-16,Virgin Islands,78,1828,0,23,0,31644,0,1828,0,29816,0
2020-12-16,Virginia,51,292240,3931,4508,38,3820372,26347,292240,3931,3528132,22416
2020-12-16,Washington,53,215310,1225,3139,16,3420811,30727,214204,667,3206607,30060
2020-12-16,West Virginia,54,66849,1141,1039,27,1350414,9007,66849,1148,1283565,7859
2020-12-16,Wisconsin,55,478162,2822,4499,87,2744803,9671,478162,2822,2266641,6849
2020-12-16,Wyoming,56,40310,246,328,0,192533,951,40310,246,152223,705
2020-12-17,Alabama,01,310335,4695,4254,56,1809684,12765,310335,4695,1499349,8070
2020-12-17,Alaska,02,42639,383,176,2,1175723,9578,41418,377,1134305,9201
2020-12-17,Arizona,04,438514,7184,7711,153,2600940,23531,435036,5817,2165904,17714
2020-12-17,Arkansas,05,194543,3039,3112,38,1928805,14443,194543,3039,1734262,11404
2020-12-17,California,06,1761085,45058,22150,269,28456358,306768,1723362,52281,26732996,254487
2020-12-17,Colorado,08,302086,3594,4265,73,2010785,12856,300414,3698,1710371,9158
2020-12-17,Connecticut,09,160102,2321,5552,46,3906494,36103,160102,2321,3746392,33782
2020-12-17,Delaware,10,48768,839,845,12,476675,3182,48768,839,427907,2343
2020-12-17,District of Columbia,11,25830,228,725,5,804207,5819,25830,228,778377,5591
2020-12-17,Florida,12,1168475,13148,20304,101,8071957,59896,1149126,13102,6922831,46794
2020-12-17,Georgia,13,548646,7560,9974,61,4856170,38262,494173,5835,4361997,32427
2020-12-17,Guam,66,8152,15,120,0,92352,437,7183,15,85169,422
2020-12-17,Hawaii,15,19781,136,278,2,315248,141,20095,141,295153,0
2020-12-17,Idaho,16,127224,1390,1266,19,535499,3676,125452,1433,410047,2243
2020-12-17,Illinois,17,881229,8935,15987,207,12147303,92015,879428,8828,11267875,83187
2020-12-17,Indiana,18,450074,6340,7180,79,2477734,16172,447190,6340,2030544,9832
2020-12-17,Iowa,19,262210,1426,3451,97,1135722,4540,226465,1415,909257,3125
2020-12-17,Kansas,20,198189,286,2253,0,918265,0,194569,0,723696,0
2020-12-17,Kentucky,21,237160,2953,2575,46,3012588,29495,234021,3328,2778567,26167
2020-12-17,Louisiana,22,279321,3776,6964,31,3896824,33191,279321,3776,3617503,29415
2020-12-17,Maine,23,17901,590,276,9,1016341,8163,17901,590,998440,7573
2020-12-17,Maryland,24,244247,2190,5319,49,2618526,10915,243984,2217,2374542,8698
2020-12-17,Massachusetts,25,309247,5135,11558,45,3753135,24256,309247,5135,3443888,19121
2020-12-17,Michigan,26,486831,4614,11793,211,7587661,53070,487356,4541,7100305,48529
2020-12-17,Minnesota,27,389230,2759,4717,83,2819859,15056,389171,2759,2430688,12297
2020-12-17,Mississippi,28,187904,2261,4320,26,1267564,2261,187904,2261,1079660,0
2020-12-17,Missouri,29,378014,4004,5101,58,1957194,10497,356607,3569,1600587,6928
2020-12-17,Montana,30,75545,781,849,13,742540,6481,75483,839,667057,5642
2020-12-17,Nebraska,31,153761,1199,1472,10,807647,3632,152103,1242,655544,2390
2020-12-17,Nevada,32,197059,2598,2680,21,1090377,5807,196379,2281,893998,3526
2020-12-17,New Hampshire,33,34264,831,629,4,476064,2718,34264,831,441800,1887
2020-12-17,New Jersey,34,421238,4255,18080,77,6949870,4255,419330,4255,6530540,0
2020-12-17,New Mexico,35,126045,1688,2103,54,1796603,29195,126045,1688,1670558,27507
2020-12-17,New York,36,819427,10498,35647,125,22680046,202772,815469,10914,21864577,191858
2020-12-17,North Carolina,37,458739,5111,6120,90,6183484,44639,457660,5786,5725824,38853
2020-12-17,North Dakota,38,89069,377,1210,9,368951,1121,89063,377,279888,744
2020-12-17,Northern Mariana Islands,69,113,0,2,0,17542,0,113,0,17429,0
2020-12-17,Ohio,39,596178,11412,7894,117,7107765,67296,596178,11412,6511587,55884
2020-12-17,Oklahoma,40,248204,2975,2144,16,2406841,2975,248204,2975,2158637,0
2020-12-17,Oregon,41,98937,1312,1284,17,2392813,24404,98936,1314,2293877,23090
2020-12-17,Pennsylvania,42,535231,10032,13442,242,3631099,25671,529335,9966,3101764,15705
2020-12-17,Puerto Rico,72,98366,1065,1323,11,370723,1065,64751,1065,305972,0
2020-12-17,Rhode Island,44,77290,1081,1602,12,595944,4246,77290,1081,518654,3165
2020-12-17,South Carolina,45,262774,2655,4843,43,2808022,16348,262774,2655,2545248,13693
2020-12-17,South Dakota,46,93197,593,1301,1,356916,1302,93197,594,263719,708
2020-12-17,Tennessee,47,480225,8877,5783,173,5196858,35571,493230,8945,4703628,26626
2020-12-17,Texas,48,1552549,17226,25336,258,12611978,100294,1539189,19849,11072789,80445
2020-12-17,Utah,49,243918,3203,1126,24,1484987,9860,243918,3203,1241069,6657
2020-12-17,Vermont,50,6149,140,105,0,247457,1279,6149,140,241308,1139
2020-12-17,Virgin Islands,78,1878,50,23,0,32463,819,1878,50,30585,769
2020-12-17,Virginia,51,296093,3853,4553,45,3852161,31789,296093,3853,3556068,27936
2020-12-17,Washington,53,220628,5318,3170,31,3440563,19752,214265,61,3226298,19691
2020-12-17,West Virginia,54,68485,1636,1071,32,1364955,14541,68485,1636,1296470,12905
2020-12-17,Wisconsin,55,482443,4281,4566,67,2756379,11576,482443,4281,2273936,7295
2020-12-17,Wyoming,56,40593,283,351,23,193719,1186,40593,283,153126,903
2020-12-18,Alabama,01,315683,5348,4296,42,1822887,13203,315683,5348,1507204,7855
2020-12-18,Alaska,02,43132,493,176,0,1184922,9199,41905,487,1143017,8712
2020-12-18,Arizona,04,444038,5524,7819,108,2623864,22924,442671,7635,2181193,15289
2020-12-18,Arkansas,05,197421,2878,3139,27,1943435,14630,197421,2878,1746014,11752
2020-12-18,California,06,1809585,48500,22436,286,28741027,284669,1764374,41012,26976653,243657
2020-12-18,Colorado,08,305622,3536,4323,58,2025063,14278,304107,3693,1720956,10585
2020-12-18,Connecticut,09,162782,2680,5581,29,3945648,39154,162782,2680,3782866,36474
2020-12-18,Delaware,10,49109,341,854,9,478106,1431,49109,341,428997,1090
2020-12-18,District of Columbia,11,26104,274,728,3,812902,8695,26104,274,786798,8421
2020-12-18,Florida,12,1181475,13000,20400,96,8128430,56473,1161953,12827,6966477,43646
2020-12-18,Georgia,13,556615,7969,10009,35,4904046,47876,500265,6092,4403781,41784
2020-12-18,Guam,66,8162,10,120,0,92741,389,7193,10,85548,379
2020-12-18,Hawaii,15,19937,156,279,1,315410,162,20257,162,295153,0
2020-12-18,Idaho,16,128498,1274,1280,14,540105,4606,126878,1426,413227,3180
2020-12-18,Illinois,17,888478,7249,16206,219,12259595,112292,886805,7377,11372790,104915
2020-12-18,Indiana,18,456028,5954,7265,85,2492370,14636,453139,5949,2039231,8687
2020-12-18,Iowa,19,264729,2519,3451,0,1139593,3871,227989,1524,911604,2347
2020-12-18,Kansas,20,203646,5457,2341,88,930806,12541,200426,5857,730380,6684
2020-12-18,Kentucky,21,240345,3185,2618,43,3033321,20733,237190,3169,2796131,17564
2020-12-18,Louisiana,22,282434,3113,6994,30,3925514,28690,282434,3113,3643080,25577
2020-12-18,Maine,23,18337,436,281,5,1025640,9299,18337,436,1007303,8863
2020-12-18,Maryland,24,246816,2569,5358,39,2633730,15204,246553,2569,2387177,12635
2020-12-18,Massachusetts,25,314926,5679,11610,52,3785110,31975,314926,5679,3470184,26296
2020-12-18,Michigan,26,491339,4508,11861,68,7638468,50807,491875,4519,7146593,46288
2020-12-18,Minnesota,27,391948,2718,4782,65,2838115,18256,391889,2718,2446226,15538
2020-12-18,Mississippi,28,190411,2507,4354,34,1270071,2507,190411,2507,1079660,0
2020-12-18,Missouri,29,382181,4167,5170,69,1967696,10502,360330,3723,1607366,6779
2020-12-18,Montana,30,76056,511,855,6,747802,5262,75992,509,671810,4753
2020-12-18,Nebraska,31,155068,1307,1490,18,811473,3826,153400,1297,658073,2529
2020-12-18,Nevada,32,200032,2973,2728,48,1096842,6465,199257,2878,897585,3587
2020-12-18,New Hampshire,33,34960,696,638,9,479655,3591,34960,696,444695,2895
2020-12-18,New Jersey,34,425134,3896,18124,44,7095705,145835,423226,3896,6672479,141939
2020-12-18,New Mexico,35,127500,1455,2128,25,1809293,12690,127500,1455,1681793,11235
2020-12-18,New York,36,832033,12606,35775,128,22929431,249385,828166,12697,22101265,236688
2020-12-18,North Carolina,37,468195,9456,6172,52,6266727,83243,466104,8444,5800623,74799
2020-12-18,North Dakota,38,89563,494,1231,21,370422,1471,89557,494,280865,977
2020-12-18,Northern Mariana Islands,69,115,2,2,0,17544,2,115,2,17429,0
2020-12-18,Ohio,39,605862,9684,7967,73,7177064,69299,605862,9684,6571202,59615
2020-12-18,Oklahoma,40,251760,3556,2161,17,2443847,37006,251760,3556,2192087,33450
2020-12-18,Oregon,41,100309,1372,1306,22,2415804,22991,100308,1372,2315496,21619
2020-12-18,Pennsylvania,42,544417,9186,13664,222,3657529,26430,538655,9320,3118874,17110
2020-12-18,Puerto Rico,72,99747,1381,1333,10,372104,1381,66132,1381,305972,0
2020-12-18,Rhode Island,44,77812,522,1625,23,597623,1679,77812,522,519811,1157
2020-12-18,South Carolina,45,267076,4302,4872,29,2844895,36873,267076,4302,2577819,32571
2020-12-18,South Dakota,46,93772,575,1330,29,358566,1650,93772,575,264794,1075
2020-12-18,Tennessee,47,490304,10079,5897,114,5263516,66658,503651,10421,4759865,56237
2020-12-18,Texas,48,1571925,19376,25608,272,12703849,91871,1555981,16792,11147868,75079
2020-12-18,Utah,49,246562,2644,1140,14,1493137,8150,246562,2644,1246575,5506
2020-12-18,Vermont,50,6243,94,107,2,249140,1683,6243,94,242897,1589
2020-12-18,Virgin Islands,78,1900,22,23,0,32808,345,1900,22,30908,323
2020-12-18,Virginia,51,299388,3295,4598,45,3874072,21911,299388,3295,3574684,18616
2020-12-18,Washington,53,224594,3966,3168,-2,3443503,2940,217205,2940,3226298,0
2020-12-18,West Virginia,54,69751,1266,1091,20,1377072,12117,69751,1266,1307321,10851
2020-12-18,Wisconsin,55,486364,3921,4635,69,2767494,11115,486364,3921,2281130,7194
2020-12-18,Wyoming,56,41359,766,351,0,194864,1145,41359,766,153505,379
2020-12-19,Alabama,01,319904,4221,4389,93,1834831,11944,319904,4221,1514927,7723
2020-12-19,Alaska,02,43468,336,177,1,1193118,8196,42235,330,1150883,7866
2020-12-19,Arizona,04,450807,6769,7956,137,2644809,20945,448231,5560,2196578,15385
2020-12-19,Arkansas,05,200114,2693,3191,52,1958098,14663,200114,2693,1757984,11970
2020-12-19,California,06,1846943,37358,22651,215,29112249,371222,1807982,43608,27304267,327614
2020-12-19,Colorado,08,308350,2728,4400,77,2035008,9945,306598,2491,1728410,7454
2020-12-19,Connecticut,09,162782,0,5581,0,3945648,0,162782,0,3782866,0
2020-12-19,Delaware,10,50136,1027,858,4,482025,3919,50136,1027,431889,2892
2020-12-19,District of Columbia,11,26342,238,730,2,820999,8097,26342,238,794657,7859
2020-12-19,Florida,12,1193157,11682,20472,72,8180515,52085,1173409,11456,7007106,40629
2020-12-19,Georgia,13,562479,5864,10054,45,4941049,37003,504501,4236,4436548,32767
2020-12-19,Guam,66,8167,5,120,0,92746,5,7198,5,85548,0
2020-12-19,Hawaii,15,20089,152,279,0,315566,156,20413,156,295153,0
2020-12-19,Idaho,16,129334,836,1280,0,543168,3063,128218,1340,414950,1723
2020-12-19,Illinois,17,896003,7525,16326,120,12356446,96851,894367,7562,11462079,89289
2020-12-19,Indiana,18,460766,4738,7338,73,2505094,12724,457871,4732,2047223,7992
2020-12-19,Iowa,19,266959,2230,3533,82,1143798,4205,229187,1198,914611,3007
2020-12-19,Kansas,20,203650,4,2341,0,930806,0,200426,0,730380,0
2020-12-19,Kentucky,21,243047,2702,2637,19,3049073,15752,240564,3374,2808509,12378
2020-12-19,Louisiana,22,282434,0,6994,0,3925514,0,282434,0,3643080,0
2020-12-19,Maine,23,18739,402,292,11,1026042,402,18739,402,1007303,0
2020-12-19,Maryland,24,248924,2108,5412,54,2645474,11744,248754,2201,2396720,9543
2020-12-19,Massachusetts,25,319270,4344,11657,47,3802761,17651,319270,4344,3483491,13307
2020-12-19,Michigan,26,495282,3943,12066,205,7699634,61166,496056,4181,7203578,56985
2020-12-19,Minnesota,27,394694,2746,4839,57,2848775,10660,394635,2746,2454140,7914
2020-12-19,Mississippi,28,192111,1700,4390,36,1271771,1700,192111,1700,1079660,0
2020-12-19,Missouri,29,384522,2341,5236,66,1974507,6811,363114,2784,1611393,4027
2020-12-19,Montana,30,76708,652,864,9,752243,4441,76619,627,675624,3814
2020-12-19,Nebraska,31,155765,697,1495,5,814808,3335,154745,1345,660063,1990
2020-12-19,Nevada,32,202164,2132,2754,26,1102203,5361,201858,2601,900345,2760
2020-12-19,New Hampshire,33,35609,649,650,12,482947,3292,35609,649,447338,2643
2020-12-19,New Jersey,34,429325,4191,18173,49,7099896,4191,427417,4191,6672479,0
2020-12-19,New Mexico,35,128930,1430,2155,27,1823169,13876,128930,1430,1694239,12446
2020-12-19,New York,36,841946,9913,35897,122,23120907,191476,838085,9919,22282822,181557
2020-12-19,North Carolina,37,473691,5496,6222,50,6342889,76162,472268,6164,5870621,69998
2020-12-19,North Dakota,38,89794,231,1237,6,371421,999,89788,231,281633,768
2020-12-19,Northern Mariana Islands,69,115,0,2,0,17544,0,115,0,17429,0
2020-12-19,Ohio,39,614429,8567,8031,64,7239882,62818,614429,8567,6625453,54251
2020-12-19,Oklahoma,40,255868,4108,2189,28,2454616,10769,255868,4108,2198748,6661
2020-12-19,Oregon,41,101814,1505,1340,34,2417310,1506,101814,1506,2315496,0
2020-12-19,Pennsylvania,42,553424,9007,13869,205,3680120,22591,548489,9834,3131631,12757
2020-12-19,Puerto Rico,72,100826,1079,1342,9,373183,1079,67211,1079,305972,0
2020-12-19,Rhode Island,44,77812,0,1625,0,599766,2143,78783,971,520983,1172
2020-12-19,South Carolina,45,270537,3461,4895,23,2871621,26726,270537,3461,2601084,23265
2020-12-19,South Dakota,46,94336,564,1350,20,360182,1616,94336,564,265846,1052
2020-12-19,Tennessee,47,494497,4193,5960,63,5263516,0,503651,0,4759865,0
2020-12-19,Texas,48,1585338,13413,25841,233,12745117,41268,1573888,17907,11171229,23361
2020-12-19,Utah,49,248970,2408,1148,8,1500528,7391,248970,2408,1251558,4983
2020-12-19,Vermont,50,6343,100,108,1,250527,1387,6343,100,244184,1287
2020-12-19,Virgin Islands,78,1910,10,23,0,33172,364,1910,10,31262,354
2020-12-19,Virginia,51,302972,3584,4643,45,3932006,57934,302972,3584,3629034,54350
2020-12-19,Washington,53,226551,1957,3169,1,3486613,43110,220268,3063,3266345,40047
2020-12-19,West Virginia,54,71215,1464,1122,31,1390401,13329,71215,1464,1319186,11865
2020-12-19,Wisconsin,55,490679,4315,4724,89,2779010,11516,490679,4315,2288331,7201
2020-12-19,Wyoming,56,41488,129,351,0,194993,129,41488,129,153505,0
2020-12-20,Alabama,01,322452,2548,4389,0,1843744,8913,322452,2548,1521292,6365
2020-12-20,Alaska,02,43649,181,176,-1,1196506,3388,42413,178,1154093,3210
2020-12-20,Arizona,04,453601,2794,7971,15,2668236,23427,453597,5366,2214639,18061
2020-12-20,Arkansas,05,201650,1536,3237,46,1971287,13189,201650,1536,1769637,11653
2020-12-20,California,06,1889675,42732,22736,85,29465170,352921,1854456,46474,27610714,306447
2020-12-20,Colorado,08,310522,2172,4420,20,2047198,12190,308890,2292,1738308,9898
2020-12-20,Connecticut,09,162782,0,5581,0,3945648,0,162782,0,3782866,0
2020-12-20,Delaware,10,50616,480,862,4,484059,2034,50616,480,433443,1554
2020-12-20,District of Columbia,11,26601,259,737,7,829299,8300,26601,259,802698,8041
2020-12-20,Florida,12,1201558,8401,20567,95,8223154,42639,1181549,8140,7041605,34499
2020-12-20,Georgia,13,567654,5175,10056,2,4974164,33115,509588,5087,4464576,28028
2020-12-20,Guam,66,8171,4,120,0,92750,4,7202,4,85548,0
2020-12-20,Hawaii,15,20291,202,280,1,315768,202,20615,202,295153,0
2020-12-20,Idaho,16,130039,705,1284,4,546196,3028,129069,851,417127,2177
2020-12-20,Illinois,17,901924,5921,16407,81,12434525,78079,900370,6003,11534155,72076
2020-12-20,Indiana,18,467258,6492,7404,66,2523679,18585,464354,6483,2059325,12102
2020-12-20,Iowa,19,267329,370,3589,56,1147392,3594,230084,897,917308,2697
2020-12-20,Kansas,20,203674,24,2341,0,930806,0,200426,0,730380,0
2020-12-20,Kentucky,21,244784,1737,2665,28,3067977,18904,242321,1757,2825656,17147
2020-12-20,Louisiana,22,286145,3711,7042,48,3969384,43870,286145,3711,3683239,40159
2020-12-20,Maine,23,18946,207,292,0,1026249,207,18946,207,1007303,0
2020-12-20,Maryland,24,251069,2145,5448,36,2658591,13117,250808,2054,2407783,11063
2020-12-20,Massachusetts,25,323531,4261,11717,60,3823777,21016,323531,4261,3500246,16755
2020-12-20,Michigan,26,495458,176,12066,0,7699634,0,496056,0,7203578,0
2020-12-20,Minnesota,27,397378,2684,4909,70,2871269,22494,397319,2684,2473950,19810
2020-12-20,Mississippi,28,194333,2222,4409,19,1273993,2222,194333,2222,1079660,0
2020-12-20,Missouri,29,386259,1737,5262,26,1979966,5459,365186,2072,1614780,3387
2020-12-20,Montana,30,77170,462,865,1,755291,3048,77170,551,678121,2497
2020-12-20,Nebraska,31,156513,748,1505,10,816926,2118,155415,670,661511,1448
2020-12-20,Nevada,32,204227,2063,2786,32,1106466,4263,203945,2087,902521,2176
2020-12-20,New Hampshire,33,36542,933,656,6,484956,2009,36542,933,448414,1076
2020-12-20,New Jersey,34,434500,5175,18194,21,7105071,5175,432592,5175,6672479,0
2020-12-20,New Mexico,35,129993,1063,2171,16,1833325,10156,129993,1063,1703332,9093
2020-12-20,New York,36,851400,9454,36017,120,23318158,197251,848042,9957,22470116,187294
2020-12-20,North Carolina,37,479875,6184,6259,37,6409315,66426,479168,6900,5930147,59526
2020-12-20,North Dakota,38,90045,251,1237,0,372056,635,90039,251,282017,384
2020-12-20,Northern Mariana Islands,69,115,0,2,0,17544,0,115,0,17429,0
2020-12-20,Ohio,39,622806,8377,8047,16,7288797,48915,622806,8377,6665991,40538
2020-12-20,Oklahoma,40,260838,4970,2212,23,2459586,4970,260838,4970,2198748,0
2020-12-20,Oregon,41,102930,1116,1341,1,2418426,1116,102930,1116,2315496,0
2020-12-20,Pennsylvania,42,560002,6578,13964,95,3701258,21138,555702,7213,3145556,13925
2020-12-20,Puerto Rico,72,102048,1222,1368,26,374405,1222,68433,1222,305972,0
2020-12-20,Rhode Island,44,77812,0,1625,0,603904,4138,79812,1029,524092,3109
2020-12-20,South Carolina,45,273406,2869,4935,40,2897011,25390,273406,2869,2623605,22521
2020-12-20,South Dakota,46,94727,391,1361,11,361285,1103,94727,391,266558,712
2020-12-20,Tennessee,47,505880,11383,6007,47,5335981,72465,519687,16036,4816294,56429
2020-12-20,Texas,48,1593201,7863,25948,107,12857760,112643,1581668,7780,11276092,104863
2020-12-20,Utah,49,250964,1994,1155,7,1508398,7870,250964,1994,1257434,5876
2020-12-20,Vermont,50,6443,100,111,3,251915,1388,6443,100,245472,1288
2020-12-20,Virgin Islands,78,1921,11,23,0,33666,494,1921,11,31745,483
2020-12-20,Virginia,51,306848,3876,4650,7,3982227,50221,306848,3876,3675379,46345
2020-12-20,Washington,53,227049,498,3170,1,3511711,25098,222600,2332,3289111,22766
2020-12-20,West Virginia,54,72342,1127,1128,6,1398549,8148,72342,1127,1326207,7021
2020-12-20,Wisconsin,55,492724,2045,4745,21,2786922,7912,492724,2045,2294198,5867
2020-12-20,Wyoming,56,41662,174,351,0,195167,174,41662,174,153505,0
2020-12-21,Alabama,01,324832,2380,4389,0,1850342,6598,324832,2380,1525510,4218
2020-12-21,Alaska,02,43801,152,176,0,1200977,4471,42563,150,1158414,4321
2020-12-21,Arizona,04,461345,7744,7972,1,2685721,17485,461345,7748,2224376,9737
2020-12-21,Arkansas,05,203107,1457,3295,58,1980964,9677,203107,1457,1777857,8220
2020-12-21,California,06,1933083,43408,22980,244,29860404,395234,1892348,37892,27968056,357342
2020-12-21,Colorado,08,312713,2191,4432,12,2059740,12542,311036,2146,1748704,10396
2020-12-21,Connecticut,09,167377,4595,5676,95,4034669,89021,167377,4595,3867292,84426
2020-12-21,Delaware,10,51056,440,871,9,486104,2045,51056,440,435048,1605
2020-12-21,District of Columbia,11,26740,139,742,5,834138,4839,26740,139,807398,4700
2020-12-21,Florida,12,1212573,11015,20679,112,8275570,52416,1192456,10907,7083114,41509
2020-12-21,Georgia,13,571301,3647,10072,16,4999306,25142,512699,3111,4486607,22031
2020-12-21,Guam,66,8180,9,121,1,93567,817,7211,9,86356,808
2020-12-21,Hawaii,15,20423,132,280,0,315902,134,20749,134,295153,0
2020-12-21,Idaho,16,131468,1429,1305,21,547904,1708,129960,891,417944,817
2020-12-21,Illinois,17,906917,4993,16530,123,12520979,86454,905069,4699,11615910,81755
2020-12-21,Indiana,18,471124,3866,7438,34,2533672,9993,468219,3865,2065453,6128
2020-12-21,Iowa,19,268736,1407,3589,0,1149061,1669,230622,538,918439,1131
2020-12-21,Kansas,20,207933,4259,2448,107,946123,15317,204600,4174,741523,11143
2020-12-21,Kentucky,21,247243,2459,2701,36,3075233,7256,244297,1976,2830936,5280
2020-12-21,Louisiana,22,287261,1116,7107,65,3981309,11925,287261,1116,3694048,10809
2020-12-21,Maine,23,19285,339,293,1,1043633,17384,19285,339,1024348,17045
2020-12-21,Maryland,24,253345,2276,5471,23,2673490,14899,253073,2265,2420417,12634
2020-12-21,Massachusetts,25,327374,3843,11759,42,3842909,19132,327374,3843,3515535,15289
2020-12-21,Michigan,26,500461,5003,12146,80,7782176,82542,501115,5059,7281061,77483
2020-12-21,Minnesota,27,399370,1992,4931,22,2882526,11257,399311,1992,2483215,9265
2020-12-21,Mississippi,28,195500,1167,4411,2,1323158,49165,195500,1167,1127658,47998
2020-12-21,Missouri,29,390512,4253,5291,29,1988451,8485,368316,3130,1620135,5355
2020-12-21,Montana,30,77456,286,881,16,758979,3688,77324,154,681655,3534
2020-12-21,Nebraska,31,157418,905,1530,25,819700,2774,156382,967,663318,1807
2020-12-21,Nevada,32,206195,1968,2801,15,1113930,7464,205884,1939,908046,5525
2020-12-21,New Hampshire,33,37388,846,656,0,487023,2067,37388,846,449635,1221
2020-12-21,New Jersey,34,437671,3171,18223,29,7295523,190452,435763,3171,6859760,187281
2020-12-21,New Mexico,35,130808,815,2180,9,1841584,8259,130808,815,1710776,7444
2020-12-21,New York,36,860856,9456,36147,130,23474668,156510,857049,9007,22617619,147503
2020-12-21,North Carolina,37,484513,4638,6285,26,6456474,47159,483647,4479,5972827,42680
2020-12-21,North Dakota,38,90127,82,1239,2,372107,51,90121,82,281986,-31
2020-12-21,Northern Mariana Islands,69,116,1,2,0,17545,1,116,1,17429,0
2020-12-21,Ohio,39,629354,6548,8122,75,7330074,41277,629354,6548,6700720,34729
2020-12-21,Oklahoma,40,263434,2596,2218,6,2462182,2596,263434,2596,2198748,0
2020-12-21,Oregon,41,103880,950,1351,10,2472444,54018,103755,825,2368689,53193
2020-12-21,Pennsylvania,42,569413,9411,14021,57,3723664,22406,563589,7887,3160075,14519
2020-12-21,Puerto Rico,72,102464,416,1382,14,374821,416,68849,416,305972,0
2020-12-21,Rhode Island,44,80231,2419,1670,45,605972,2068,80231,419,525741,1649
2020-12-21,South Carolina,45,275733,2327,4962,27,2916627,19616,275733,2327,2640894,17289
2020-12-21,South Dakota,46,95074,347,1381,20,362320,1035,95074,347,267246,688
2020-12-21,Tennessee,47,515145,9265,6072,65,5396151,60170,529578,9891,4866573,50279
2020-12-21,Texas,48,1610141,16940,26164,216,13003964,146204,1591948,10280,11412016,135924
2020-12-21,Utah,49,252783,1819,1162,7,1514421,6023,252783,1819,1261638,4204
2020-12-21,Vermont,50,6534,91,111,0,253814,1899,6534,91,247280,1808
2020-12-21,Virgin Islands,78,1921,0,23,0,33666,0,1921,0,31745,0
2020-12-21,Virginia,51,310890,4042,4654,4,4020121,37894,310890,4042,3709231,33852
2020-12-21,Washington,53,230642,3593,3186,16,3511711,0,222600,0,3289111,0
2020-12-21,West Virginia,54,73337,995,1129,1,1409130,10581,73337,995,1335793,9586
2020-12-21,Wisconsin,55,494353,1629,4754,9,2793618,6696,494353,1629,2299265,5067
2020-12-21,Wyoming,56,42118,456,351,0,197061,1894,42118,456,154943,1438
