date,state,fips,cases,newCases,deaths,newDeaths,tests,newTests,positive,newPositive,negative,newNegative
2020-08-31,US,00,6045455,36485,183472,488,77731718,678380,5975013,31270,71756705,647110
2020-09-01,US,00,6089504,44049,184563,1091,78428811,697093,6017434,42421,72411377,654672
2020-09-02,US,00,6121948,32444,185639,1076,79076027,647216,6047651,30217,73028376,616999
2020-09-03,US,00,6168342,46394,186717,1078,79800686,724659,6092272,44621,73708414,680038
2020-09-04,US,00,6220446,52104,187697,980,80701775,901089,6143785,51513,74557990,849576
2020-09-05,US,00,6262700,42254,188409,712,81508218,806443,6188529,44744,75319689,761699
2020-09-06,US,00,6292699,29999,188820,411,82241177,732959,6221450,32921,76019727,700038
2020-09-07,US,00,6317865,25166,189083,263,82828176,586999,6249594,28144,76578582,558855
2020-09-08,US,00,6346806,28941,189541,458,83333741,505565,6271730,22136,77062011,483429
2020-09-09,US,00,6380138,33332,190716,1175,83917175,583434,6302903,31173,77614272,552261
2020-09-10,US,00,6418198,38060,191631,915,84531821,614646,6340205,37302,78191616,577344
2020-09-11,US,00,6465766,47568,192858,1227,85300612,768791,6384889,44684,78915723,724107
2020-09-12,US,00,6504870,39104,193559,701,86151572,850960,6426755,41866,79724817,809094
2020-09-13,US,00,6538213,33343,193958,399,86797740,646168,6461066,34311,80336674,611857
2020-09-14,US,00,6575100,36887,194408,450,87198048,400308,6494686,33620,80703362,366688
2020-09-15,US,00,6614317,39217,195689,1281,87884952,686904,6529591,34905,81355361,651999
2020-09-16,US,00,6653585,39268,196686,997,88553600,668648,6569703,40112,81983897,628536
2020-09-17,US,00,6698895,45310,197535,849,89334355,780755,6612992,43289,82721363,737466
2020-09-18,US,00,6747782,48887,198484,949,90234662,900307,6660244,47252,83574418,853055
2020-09-19,US,00,6789593,41811,199154,670,91225242,990580,6705149,44905,84520093,945675
2020-09-20,US,00,6825949,36356,199367,213,92049268,824026,6740652,35503,85308616,788523
2020-09-21,US,00,6880899,54950,199797,430,92725204,675936,6779791,39139,85945413,636797
2020-09-22,US,00,6918290,37391,200738,941,93448383,723179,6829266,49475,86619117,673704
2020-09-23,US,00,6959841,41551,201828,1090,94291582,843199,6867886,38620,87423696,804579
2020-09-24,US,00,7005043,45202,202713,885,95137848,846266,6911232,43346,88226616,802920
2020-09-25,US,00,7059624,54581,203566,853,96069599,931751,6966421,55189,89103178,876562
2020-09-26,US,00,7102321,42697,204335,769,97003635,934036,7013826,47405,89989809,886631
2020-09-27,US,00,7139619,37298,204602,267,97708038,704403,7048812,34986,90659226,669417
2020-09-28,US,00,7176979,37360,204952,350,98656342,948304,7084695,35883,91571647,912421
2020-09-29,US,00,7220676,43697,205878,926,99403993,747651,7121136,36441,92282857,711210
2020-09-30,US,00,7262734,42058,206852,974,100125321,721328,7165483,44347,92959838,676981
2020-10-01,US,00,7309152,46418,207699,847,100934407,809086,7211088,45605,93723319,763481
2020-10-02,US,00,7362732,53580,208564,865,101958768,1024361,7260346,49258,94698422,975103
2020-10-03,US,00,7410511,47779,209273,709,102854625,895857,7311280,50934,95543345,844923
2020-10-04,US,00,7445574,35063,209606,333,103715645,861020,7349267,37987,96366378,823033
2020-10-05,US,00,7507986,62412,210035,429,104597589,881944,7387024,37757,97210565,844187
2020-10-06,US,00,7550848,42862,210756,721,105353113,755524,7425941,38917,97927172,716607
2020-10-07,US,00,7603865,53017,211752,996,106135244,782131,7476532,50591,98658712,731540
2020-10-08,US,00,7660248,56383,212680,928,107074951,939707,7531740,55208,99543211,884499
2020-10-09,US,00,7719210,58962,213595,915,108079856,1004905,7588542,56802,100491314,948103
2020-10-10,US,00,7770858,51648,214187,592,109098808,1018952,7645956,57414,101452852,961538
2020-10-11,US,00,7815641,44783,214606,419,109947121,848313,7692224,46268,102254897,802045
2020-10-12,US,00,7863657,48016,214957,351,110872731,925610,7734868,42644,103137863,882966
2020-10-13,US,00,7918051,54394,215783,826,111780291,907560,7783462,48594,103996829,858966
2020-10-14,US,00,7977904,59853,216792,1009,112457570,677279,7839579,56117,104617991,621162
2020-10-15,US,00,8043257,65353,217585,793,113372867,915297,7902973,63394,105469894,851903
2020-10-16,US,00,8113720,70463,218476,891,114411482,1038615,7971222,68249,106440260,970366
2020-10-17,US,00,8166481,52761,219154,678,115433961,1022479,8028550,57328,107405411,965151
2020-10-18,US,00,8214363,47882,219541,387,116247859,813898,8076834,48284,108171025,765614
2020-10-19,US,00,8279803,65440,220058,517,117329065,1081206,8133943,57109,109195122,1024097
2020-10-20,US,00,8340397,60594,220987,929,118146192,817127,8194492,60549,109951700,756578
2020-10-21,US,00,8404634,64237,222195,1208,118897720,751528,8255450,60958,110642270,690570
2020-10-22,US,00,8479762,75128,223023,828,119888369,990649,8328292,72842,111560077,917807
2020-10-23,US,00,8564893,85131,223949,926,121013293,1124924,8410625,82333,112602668,1042591
2020-10-24,US,00,8643591,78698,224821,872,122057972,1044679,8493912,83287,113564060,961392
2020-10-25,US,00,8703303,59712,225160,339,123023398,965426,8558805,64893,114464593,900533
2020-10-26,US,00,8777800,74497,225698,538,124069766,1046368,8621330,62525,115448436,983843
2020-10-27,US,00,8852197,74397,226681,983,124949199,879433,8693413,72083,116255786,807350
2020-10-28,US,00,8934121,81924,227697,1016,125830875,881676,8772165,78752,117058710,802924
2020-10-29,US,00,9024915,90794,228701,1004,126928995,1098120,8860888,88723,118068107,1009397
2020-10-30,US,00,9124729,99814,229672,971,128001689,1072694,8958126,97238,119043563,975456
2020-10-31,US,00,9208964,84235,230510,838,129136278,1134589,9048711,90585,120087567,1044004
2020-11-01,US,00,9283188,74224,230937,427,130024311,888033,9122560,73849,120901751,814184
2020-11-02,US,00,9376927,93739,231477,540,131177119,1152808,9204607,82047,121972512,1070761
2020-11-03,US,00,9469557,92630,232607,1130,132103837,926718,9291273,86666,122812564,840052
2020-11-04,US,00,9577440,107883,234223,1616,133076943,973106,9394578,103305,123682365,869801
2020-11-05,US,00,9698981,121541,235331,1108,134377044,1300101,9511021,116443,124866023,1183658
2020-11-06,US,00,9831853,132872,236577,1246,135637336,1260292,9636779,125758,126000557,1134534
2020-11-07,US,00,9957785,125932,237584,1007,136750748,1113412,9766001,129222,126984747,984190
2020-11-08,US,00,10061201,103416,238048,464,137782968,1032220,9876291,110290,127906677,921930
2020-11-09,US,00,10191642,130441,238793,745,139124940,1341972,9995725,119434,129129215,1222538
2020-11-10,US,00,10331382,139740,240258,1465,140198116,1073176,10126912,131187,130071204,941989
2020-11-11,US,00,10474242,142860,241689,1431,141362541,1164425,10271729,144817,131090812,1019608
2020-11-12,US,00,10637733,163491,242861,1172,142485299,1122758,10423741,152012,132061558,970746
2020-11-13,US,00,10819326,181593,244250,1389,143894773,1409474,10595857,172116,133298916,1237358
2020-11-14,US,00,10978447,159121,245460,1210,145233056,1338283,10759395,163538,134473661,1174745
2020-11-15,US,00,11113634,135187,246083,623,146540076,1307020,10903827,144432,135636249,1162588
2020-11-16,US,00,11280088,166454,246879,796,147792537,1252461,11052700,148873,136739837,1103588
2020-11-17,US,00,11441833,161745,248486,1607,149041735,1249198,11209432,156732,137832303,1092466
2020-11-18,US,00,11614116,172283,250411,1925,150280242,1238507,11373404,163972,138906838,1074535
2020-11-19,US,00,11801586,187470,252373,1962,151749759,1469517,11556239,182835,140193520,1286682
2020-11-20,US,00,12000258,198672,254325,1952,153332448,1582689,11749039,192800,141583409,1389889
2020-11-21,US,00,12172261,172003,255754,1429,154942040,1609592,11928754,179715,143013286,1429877
2020-11-22,US,00,12313295,141034,256597,843,156347172,1405132,12079595,150841,144267577,1254291
2020-11-23,US,00,12492394,179099,257635,1038,157845789,1498617,12230553,150958,145615236,1347659
2020-11-24,US,00,12670684,178290,259844,2209,159366481,1520692,12397567,167014,146968914,1353678
2020-11-25,US,00,12851220,180536,262157,2313,160710297,1343816,12581196,183629,148129101,1160187
2020-11-26,US,00,12954324,103104,263336,1179,161687050,976753,12707531,126335,148979519,850418
2020-11-27,US,00,13159786,205462,264748,1412,163385206,1698156,12901256,193725,150483950,1504431
2020-11-28,US,00,13311031,151245,265940,1192,164816663,1431457,13055778,154522,151760885,1276935
2020-11-29,US,00,13447369,136338,266758,818,165835053,1018390,13191020,135242,152644033,883148
2020-11-30,US,00,13615129,167760,268023,1265,167202448,1367395,13338607,147587,153863841,1219808
2020-12-01,US,00,13799415,184286,270633,2610,169320915,2118467,13515360,176753,155805555,1941714
2020-12-02,US,00,13999749,200334,273518,2885,170498743,1177828,13711156,195796,156787587,982032
2020-12-03,US,00,14217106,217357,276375,2857,171947412,1448669,13921360,210204,158026052,1238465
2020-12-04,US,00,14446183,229077,279012,2637,173432900,1485488,14146191,224831,159286709,1260657
2020-12-05,US,00,14651696,205513,281202,2190,175170968,1738068,14357264,211073,160813704,1526995
2020-12-06,US,00,14825153,173457,282313,1111,176520329,1349361,14534035,176771,161986294,1172590
2020-08-31,Alabama,01,126058,823,2182,20,985287,4225,126058,823,859229,3402
2020-08-31,Alaska,02,6075,39,34,0,348630,1791,5286,36,343344,1755
2020-08-31,Arizona,04,201866,171,5031,-2,1204429,4988,201835,174,1002594,4814
2020-08-31,Arkansas,05,61224,368,797,13,727035,14348,61224,368,665811,13980
2020-08-31,California,06,712541,5952,13020,81,11373305,141476,704085,4176,10669220,137300
2020-08-31,Colorado,08,57797,282,1952,7,714768,4872,57424,201,657344,4671
2020-08-31,Connecticut,09,52879,384,4465,0,1173096,45590,52879,384,1120217,45206
2020-08-31,Delaware,10,17429,86,605,1,236849,2188,17429,86,219420,2102
2020-08-31,District of Columbia,11,13992,33,607,1,290682,2593,13992,33,276690,2560
2020-08-31,Florida,12,623463,1885,11186,68,4608697,15922,616629,1876,3992068,14046
2020-08-31,Georgia,13,254238,1425,5506,28,2343634,16144,270471,1498,2073163,14646
2020-08-31,Guam,66,2364,108,11,0,37884,424,1395,48,36489,376
2020-08-31,Hawaii,15,8447,132,69,7,196719,2784,8339,200,188380,2584
2020-08-31,Idaho,16,32256,222,364,4,256013,1688,31867,190,224146,1498
2020-08-31,Illinois,17,237682,1903,8258,10,4065863,47379,236725,1668,3829138,45711
2020-08-31,Indiana,18,96277,883,3296,5,1076947,11591,94196,883,982751,10708
2020-08-31,Iowa,19,65252,653,1120,7,620872,3777,63328,608,557544,3169
2020-08-31,Kansas,20,43407,1396,451,1,413249,10102,42612,1564,370637,8538
2020-08-31,Kentucky,21,50884,714,965,10,821320,5206,48396,364,772924,4842
2020-08-31,Louisiana,22,148894,326,4950,19,1873490,4039,148894,326,1724596,3713
2020-08-31,Maine,23,4526,14,132,0,262935,3274,4526,14,258409,3260
2020-08-31,Maryland,24,108742,456,3755,3,1330853,11615,108249,458,1222604,11157
2020-08-31,Massachusetts,25,128533,304,9060,11,1742517,18743,128533,304,1613984,18439
2020-08-31,Michigan,26,113163,565,6756,6,2764431,19637,113025,499,2651406,19138
2020-08-31,Minnesota,27,75913,675,1866,1,1128023,5952,75864,675,1052159,5277
2020-08-31,Mississippi,28,82950,274,2473,32,573865,4701,82950,274,490915,4427
2020-08-31,Missouri,29,86328,1195,1623,8,982955,8718,84697,1042,898258,7676
2020-08-31,Montana,30,7440,100,104,0,250238,3577,7421,81,242817,3496
2020-08-31,Nebraska,31,34287,241,402,2,361351,3406,34046,293,327305,3113
2020-08-31,Nevada,32,69318,337,1305,0,597921,2236,69228,320,528693,1916
2020-08-31,New Hampshire,33,7275,21,432,0,210916,1621,7275,21,203641,1600
2020-08-31,New Jersey,34,193740,349,15945,8,2857918,21584,191960,349,2665958,21235
2020-08-31,New Mexico,35,25352,69,779,9,760874,3941,25352,69,735522,3872
2020-08-31,New York,36,439480,649,32541,7,8263033,66241,434756,656,7828277,65585
2020-08-31,North Carolina,37,167989,1479,2733,12,2256172,12899,167313,1186,2088859,11713
2020-08-31,North Dakota,38,11820,114,147,1,201755,1796,11810,114,189945,1682
2020-08-31,Northern Mariana Islands,69,56,0,2,0,13540,0,56,0,13484,0
2020-08-31,Ohio,39,123157,895,4138,10,2244104,47244,123157,895,2120947,46349
2020-08-31,Oklahoma,40,58733,713,800,1,865278,713,58733,713,806545,0
2020-08-31,Oregon,41,26723,169,467,4,557228,3883,26713,159,530515,3724
2020-08-31,Pennsylvania,42,138840,703,7743,1,1658220,8817,134025,521,1524195,8296
2020-08-31,Puerto Rico,72,33199,351,434,0,321448,247,15476,247,305972,0
2020-08-31,Rhode Island,44,21949,266,1048,2,273897,1881,21949,46,251948,1835
2020-08-31,South Carolina,45,118992,668,2720,11,949548,6675,118992,668,830556,6007
2020-08-31,South Dakota,46,13509,187,167,0,146529,878,13509,187,133020,691
2020-08-31,Tennessee,47,152033,1784,1727,5,2200999,11989,154933,1818,2046066,10171
2020-08-31,Texas,48,640317,3770,12857,50,4961553,36841,612969,2615,4348584,34226
2020-08-31,Utah,49,52166,312,409,1,659297,2701,52107,253,607190,2448
2020-08-31,Vermont,50,1624,8,58,0,134156,2466,1617,5,132539,2461
2020-08-31,Virgin Islands,78,1139,5,15,1,16234,128,1134,5,15100,123
2020-08-31,Virginia,51,120594,847,2580,11,1586551,13124,120594,847,1465957,12277
2020-08-31,Washington,53,77718,596,2002,10,1461354,0,74320,0,1387034,0
2020-08-31,West Virginia,54,10250,140,214,1,436047,4925,10250,140,425797,4785
2020-08-31,Wisconsin,55,80733,422,1132,0,1253422,3820,80568,268,1172854,3552
2020-08-31,Wyoming,56,3842,22,37,0,76273,980,3842,22,72431,958
2020-09-01,Alabama,01,127616,1558,2200,18,958920,-26367,127616,1558,831304,-27925
2020-09-01,Alaska,02,6109,34,36,2,374255,25625,5321,35,368934,25590
2020-09-01,Arizona,04,202375,509,5048,17,1208990,4561,202342,507,1006648,4054
2020-09-01,Arkansas,05,61497,273,814,17,731025,3990,61497,273,669528,3717
2020-09-01,California,06,716628,4087,13149,129,11470696,97391,707797,3712,10762899,93679
2020-09-01,Colorado,08,58118,321,1953,1,718398,3630,57775,351,660623,3279
2020-09-01,Connecticut,09,53006,127,4466,1,1192338,19242,53006,127,1139332,19115
2020-09-01,Delaware,10,17535,106,605,0,238423,1574,17535,106,220888,1468
2020-09-01,District of Columbia,11,14049,57,607,0,292844,2162,14049,57,278795,2105
2020-09-01,Florida,12,631032,7569,11373,187,4668942,60245,624116,7487,4044826,52758
2020-09-01,Georgia,13,256544,2306,5604,98,2368498,24864,272697,2226,2095801,22638
2020-09-01,Guam,66,2416,52,14,3,38322,438,1447,52,36875,386
2020-09-01,Hawaii,15,8628,181,73,4,198182,1463,8472,133,189710,1330
2020-09-01,Idaho,16,32703,447,370,6,257689,1676,32088,221,225601,1455
2020-09-01,Illinois,17,239115,1433,8299,41,4088824,22961,238217,1492,3850607,21469
2020-09-01,Indiana,18,96988,711,3312,16,1083765,6818,94891,695,988874,6123
2020-09-01,Iowa,19,65846,594,1125,5,623547,2675,63919,591,559628,2084
2020-09-01,Kansas,20,43491,84,454,3,413249,0,42612,0,370637,0
2020-09-01,Kentucky,21,51762,878,983,18,830421,9101,49185,789,781236,8312
2020-09-01,Louisiana,22,149583,689,4984,34,1890526,17036,149583,689,1740943,16347
2020-09-01,Maine,23,4548,22,132,0,268735,5800,4548,22,264187,5778
2020-09-01,Maryland,24,109353,611,3761,6,1338917,8064,108863,614,1230054,7450
2020-09-01,Massachusetts,25,128888,355,9064,4,1764172,21655,128888,355,1635284,21300
2020-09-01,Michigan,26,113969,806,6770,14,2789407,24976,113820,795,2675587,24181
2020-09-01,Minnesota,27,76404,491,1872,6,1132922,4899,76355,491,1056567,4408
2020-09-01,Mississippi,28,83584,634,2493,20,577517,3652,83584,634,493933,3018
2020-09-01,Missouri,29,87414,1086,1651,28,991244,8289,85755,1058,905489,7231
2020-09-01,Montana,30,7526,86,105,1,252296,2058,7509,88,244787,1970
2020-09-01,Nebraska,31,34574,287,405,3,363075,1724,34287,241,328788,1483
2020-09-01,Nevada,32,69708,390,1313,8,600349,2428,69633,405,530716,2023
2020-09-01,New Hampshire,33,7297,22,432,0,211281,365,7297,22,203984,343
2020-09-01,New Jersey,34,194070,330,15950,5,2859048,1130,192290,330,2666758,800
2020-09-01,New Mexico,35,25460,108,787,8,765399,4525,25460,108,739939,4417
2020-09-01,New York,36,440237,757,32551,10,8340030,76997,435510,754,7904520,76243
2020-09-01,North Carolina,37,169966,1977,2769,36,2295698,39526,169424,2111,2126274,37415
2020-09-01,North Dakota,38,12004,184,149,2,202422,667,12004,194,190418,473
2020-09-01,Northern Mariana Islands,69,57,1,2,0,13541,1,57,1,13484,0
2020-09-01,Ohio,39,124610,1453,4165,27,2269669,25565,124610,1453,2145059,24112
2020-09-01,Oklahoma,40,59399,666,809,9,886912,21634,59399,666,827513,20968
2020-09-01,Oregon,41,26958,235,467,0,561800,4572,26946,233,534854,4339
2020-09-01,Pennsylvania,42,139591,751,7764,21,1674764,16544,134795,770,1539969,15774
2020-09-01,Puerto Rico,72,33421,222,435,1,321556,108,15584,108,305972,0
2020-09-01,Rhode Island,44,22002,53,1050,2,276482,2585,22002,53,254480,2532
2020-09-01,South Carolina,45,119846,854,2757,37,954402,4854,119846,854,834556,4000
2020-09-01,South Dakota,46,13749,240,167,0,147595,1066,13749,240,133846,826
2020-09-01,Tennessee,47,153274,1241,1753,26,2217751,16752,156329,1396,2061422,15356
2020-09-01,Texas,48,645534,5217,13004,147,5033554,72001,617333,4364,4416221,67637
2020-09-01,Utah,49,52505,339,410,1,663050,3753,52403,296,610647,3457
2020-09-01,Vermont,50,1635,11,58,0,137205,3049,1623,6,135582,3043
2020-09-01,Virgin Islands,78,1143,4,15,0,16387,153,1139,5,15248,148
2020-09-01,Virginia,51,121615,1021,2612,32,1598689,12138,121615,1021,1477074,11117
2020-09-01,Washington,53,78061,343,2018,16,1473245,11891,74635,315,1398610,11576
2020-09-01,West Virginia,54,10507,257,222,8,438441,2394,10507,257,427934,2137
2020-09-01,Wisconsin,55,81688,955,1141,9,1265321,11899,81604,1036,1183717,10863
2020-09-01,Wyoming,56,3866,24,41,4,76567,294,3866,24,72701,270
2020-09-02,Alabama,01,128239,623,2217,17,964233,5313,128239,623,835994,4690
2020-09-02,Alaska,02,6181,72,36,0,376884,2629,5387,66,371497,2563
2020-09-02,Arizona,04,202898,523,5070,22,1213927,4937,202861,519,1011066,4418
2020-09-02,Arkansas,05,62112,615,841,27,737449,6424,62112,615,675337,5809
2020-09-02,California,06,722035,5407,13330,181,11580370,109674,712052,4255,10868318,105419
2020-09-02,Colorado,08,58392,274,1960,7,723058,4660,58019,244,665039,4416
2020-09-02,Connecticut,09,53108,102,4467,1,1203979,11641,53108,102,1150871,11539
2020-09-02,Delaware,10,17549,14,606,1,240530,2107,17549,14,222981,2093
2020-09-02,District of Columbia,11,14077,28,608,1,294797,1953,14077,28,280720,1925
2020-09-02,Florida,12,633434,2402,11500,127,4686786,17844,626426,2310,4060360,15534
2020-09-02,Georgia,13,258482,1938,5665,61,2381637,13139,274613,1916,2107024,11223
2020-09-02,Guam,66,2463,47,14,0,38771,449,1494,47,37277,402
2020-09-02,Hawaii,15,8966,338,74,1,202186,4004,8653,181,193533,3823
2020-09-02,Idaho,16,33059,356,374,4,259096,1407,32368,280,226728,1127
2020-09-02,Illinois,17,241282,2167,8322,23,4121575,32751,240345,2128,3881230,30623
2020-09-02,Indiana,18,97853,865,3325,13,1092596,8831,95750,859,996846,7972
2020-09-02,Iowa,19,66463,617,1134,9,629654,6107,64645,726,565009,5381
2020-09-02,Kansas,20,44529,1038,458,4,419247,5998,43940,1328,375307,4670
2020-09-02,Kentucky,21,52704,942,1008,25,837211,6790,49991,806,787220,5984
2020-09-02,Louisiana,22,150734,1151,5004,20,1904779,14253,150734,1151,1754045,13102
2020-09-02,Maine,23,4567,19,133,1,273032,4297,4567,19,268465,4278
2020-09-02,Maryland,24,109808,455,3766,5,1345646,6729,109319,456,1236327,6273
2020-09-02,Massachusetts,25,121131,-7757,9060,-4,1771706,7534,121131,-7757,1650575,15291
2020-09-02,Michigan,26,114603,634,6783,13,2816816,27409,114468,648,2702348,26761
2020-09-02,Minnesota,27,77137,733,1882,10,1150854,17932,77085,730,1073769,17202
2020-09-02,Mississippi,28,84365,781,2526,33,581586,4069,84365,781,497221,3288
2020-09-02,Missouri,29,88974,1560,1669,18,998097,6853,87213,1458,910884,5395
2020-09-02,Montana,30,7715,189,109,4,253873,1577,7691,182,246182,1395
2020-09-02,Nebraska,31,34995,421,408,3,365641,2566,34574,287,331067,2279
2020-09-02,Nevada,32,69927,219,1338,25,602308,1959,69872,239,532436,1720
2020-09-02,New Hampshire,33,7309,12,432,0,211281,0,7297,0,203984,0
2020-09-02,New Jersey,34,194378,308,15964,14,2902267,43219,192595,305,2709672,42914
2020-09-02,New Mexico,35,25612,152,790,3,770959,5560,25612,152,745347,5408
2020-09-02,New York,36,440947,710,32559,8,8428477,88447,436218,708,7992259,87739
2020-09-02,North Carolina,37,171140,1174,2806,37,2315310,19612,170553,1129,2144757,18483
2020-09-02,North Dakota,38,12271,267,152,3,204100,1678,12270,266,191830,1412
2020-09-02,Northern Mariana Islands,69,57,0,2,0,13541,0,57,0,13484,0
2020-09-02,Ohio,39,125767,1157,4176,11,2292748,23079,125767,1157,2166981,21922
2020-09-02,Oklahoma,40,60118,719,821,12,893242,6330,60118,719,833124,5611
2020-09-02,Oregon,41,27085,127,473,6,566382,4582,27075,129,539307,4453
2020-09-02,Pennsylvania,42,140577,986,7792,28,1687696,12932,135611,816,1552085,12116
2020-09-02,Puerto Rico,72,34003,582,443,8,321914,358,15942,358,305972,0
2020-09-02,Rhode Island,44,22078,76,1051,1,278641,2159,22078,76,256563,2083
2020-09-02,South Carolina,45,120503,657,2794,37,959032,4630,120503,657,838529,3973
2020-09-02,South Dakota,46,14003,254,169,2,148925,1330,14003,254,134922,1076
2020-09-02,Tennessee,47,154833,1559,1768,15,2238231,20480,157831,1502,2080400,18978
2020-09-02,Texas,48,649844,4310,13185,181,5068862,35308,621667,4334,4447195,30974
2020-09-02,Utah,49,52950,445,414,4,667493,4443,52822,419,614671,4024
2020-09-02,Vermont,50,1637,2,58,0,137747,542,1625,2,136122,540
2020-09-02,Virgin Islands,78,1144,1,15,0,16486,99,1143,4,15343,95
2020-09-02,Virginia,51,122542,927,2641,29,1610691,12002,122542,927,1488149,11075
2020-09-02,Washington,53,78554,493,2025,7,1480039,6794,74939,304,1405100,6490
2020-09-02,West Virginia,54,10642,135,230,8,441585,3144,10642,135,430943,3009
2020-09-02,Wisconsin,55,82261,573,1151,10,1273730,8409,82182,578,1191548,7831
2020-09-02,Wyoming,56,3911,45,41,0,76810,243,3911,45,72899,198
2020-09-03,Alabama,01,129285,1046,2233,16,965974,1741,129285,1046,836689,695
2020-09-03,Alaska,02,6287,106,37,1,377936,1052,5475,88,372461,964
2020-09-03,Arizona,04,203964,1066,5133,63,1222859,8932,203953,1092,1018906,7840
2020-09-03,Arkansas,05,63504,1392,861,20,738841,1392,63504,1392,675337,0
2020-09-03,California,06,727398,5363,13497,167,11663924,83554,717177,5125,10946747,78429
2020-09-03,Colorado,08,58680,288,1963,3,729015,5957,58287,268,670728,5689
2020-09-03,Connecticut,09,53209,101,4468,1,1218216,14237,53209,101,1165007,14136
2020-09-03,Delaware,10,17653,104,606,0,244548,4018,17653,104,226895,3914
2020-09-03,District of Columbia,11,14135,58,609,1,298759,3962,14135,58,284624,3904
2020-09-03,Florida,12,637005,3571,11649,149,4710596,23810,629913,3487,4080683,20323
2020-09-03,Georgia,13,261056,2574,5735,70,2410665,29028,277288,2675,2133377,26353
2020-09-03,Guam,66,2529,66,14,0,39490,719,1560,66,37930,653
2020-09-03,Hawaii,15,9177,211,78,4,207431,5245,8991,338,198440,4907
2020-09-03,Idaho,16,33361,302,375,1,261400,2304,32664,296,228736,2008
2020-09-03,Illinois,17,242715,1433,8347,25,4162370,40795,241705,1360,3920665,39435
2020-09-03,Indiana,18,98971,1118,3332,7,1103038,10442,96854,1104,1006184,9338
2020-09-03,Iowa,19,67693,1230,1137,3,634758,5104,65523,878,569235,4226
2020-09-03,Kansas,20,44755,226,475,17,419247,0,43940,0,375307,0
2020-09-03,Kentucky,21,54067,1363,1021,13,844424,7213,50885,894,793539,6319
2020-09-03,Louisiana,22,151547,813,5021,17,1917099,12320,151547,813,1765552,11507
2020-09-03,Maine,23,4617,50,133,0,281053,8021,4617,50,276436,7971
2020-09-03,Maryland,24,110504,696,3778,12,1357605,11959,110012,693,1247593,11266
2020-09-03,Massachusetts,25,121546,415,9077,17,1803312,31606,121546,415,1681766,31191
2020-09-03,Michigan,26,115393,790,6794,11,2849451,32635,115242,774,2734209,31861
2020-09-03,Minnesota,27,78175,1038,1889,7,1158388,7534,78123,1038,1080265,6496
2020-09-03,Mississippi,28,85116,751,2536,10,586581,4995,85116,751,501465,4244
2020-09-03,Missouri,29,90392,1418,1680,11,1008078,9981,88610,1397,919468,8584
2020-09-03,Montana,30,7903,188,111,2,255660,1787,7871,180,247789,1607
2020-09-03,Nebraska,31,35469,474,410,2,368965,3324,34995,421,333970,2903
2020-09-03,Nevada,32,70319,392,1366,28,605268,2960,70223,351,535045,2609
2020-09-03,New Hampshire,33,7347,38,432,0,215875,4594,7347,50,208528,4544
2020-09-03,New Jersey,34,194756,378,15971,7,2930015,27748,192973,378,2737042,27370
2020-09-03,New Mexico,35,25812,200,791,1,776796,5837,25812,200,750984,5637
2020-09-03,New York,36,441835,888,32567,8,8517458,88981,437107,889,8080351,88092
2020-09-03,North Carolina,37,172791,1651,2829,23,2347837,32527,172209,1656,2175628,30871
2020-09-03,North Dakota,38,12633,362,154,2,205899,1799,12629,359,193270,1440
2020-09-03,Northern Mariana Islands,69,57,0,2,0,13541,0,57,0,13484,0
2020-09-03,Ohio,39,127112,1345,4226,50,2319528,26780,127112,1345,2192416,25435
2020-09-03,Oklahoma,40,61027,909,835,14,903046,9804,61027,909,842019,8895
2020-09-03,Oregon,41,27356,271,475,2,571125,4743,27336,261,543789,4482
2020-09-03,Pennsylvania,42,141578,1001,7805,13,1702214,14518,136771,1160,1565443,13358
2020-09-03,Puerto Rico,72,34198,195,448,5,322041,127,16069,127,305972,0
2020-09-03,Rhode Island,44,22143,65,1055,4,281633,2992,22143,65,259490,2927
2020-09-03,South Carolina,45,121696,1193,2807,13,969425,10393,121696,1193,847729,9200
2020-09-03,South Dakota,46,14337,334,169,0,150537,1612,14337,334,136200,1278
2020-09-03,Tennessee,47,157028,2195,1791,23,2265003,26772,159546,1715,2105457,25057
2020-09-03,Texas,48,653321,3477,13387,202,5107503,38641,625347,3680,4482156,34961
2020-09-03,Utah,49,53412,462,416,2,672051,4558,53326,504,618725,4054
2020-09-03,Vermont,50,1637,0,58,0,139501,1754,1630,5,137871,1749
2020-09-03,Virgin Islands,78,1150,6,16,1,16793,307,1144,1,15649,306
2020-09-03,Virginia,51,123668,1126,2652,11,1624531,13840,123668,1126,1500863,12714
2020-09-03,Washington,53,79120,566,2033,8,1496353,16314,75377,438,1420976,15876
2020-09-03,West Virginia,54,10845,203,237,7,445094,3509,10845,203,434249,3306
2020-09-03,Wisconsin,55,83119,858,1155,4,1282921,9191,82922,740,1199999,8451
2020-09-03,Wyoming,56,3939,28,41,0,77501,691,3939,28,73562,663
2020-09-04,Alabama,01,130393,1108,2266,33,970413,4439,130393,1108,840020,3331
2020-09-04,Alaska,02,6416,129,37,0,381937,4001,5594,119,376343,3882
2020-09-04,Arizona,04,204686,722,5174,41,1236928,14069,204681,728,1032247,13341
2020-09-04,Arkansas,05,64678,1174,873,12,748914,10073,64678,1174,684236,8899
2020-09-04,California,06,732691,5293,13644,147,11796970,133046,722283,5106,11074687,127940
2020-09-04,Colorado,08,59021,341,1973,10,735968,6953,58655,368,677313,6585
2020-09-04,Connecticut,09,53365,156,4468,0,1237658,19442,53365,156,1184293,19286
2020-09-04,Delaware,10,17752,99,606,0,246642,2094,17752,99,228890,1995
2020-09-04,District of Columbia,11,14186,51,611,2,303351,4592,14186,51,289165,4541
2020-09-04,Florida,12,640203,3198,11749,100,4732856,22260,633060,3147,4099796,19113
2020-09-04,Georgia,13,263047,1991,5797,62,2432125,21460,279354,2066,2152771,19394
2020-09-04,Guam,66,2588,59,15,1,40112,622,1619,59,38493,563
2020-09-04,Hawaii,15,9448,271,80,2,213722,6291,9202,211,204520,6080
2020-09-04,Idaho,16,33628,267,386,11,263727,2327,32927,263,230800,2064
2020-09-04,Illinois,17,248253,5538,8386,39,4311869,149499,247299,5594,4064570,143905
2020-09-04,Indiana,18,100011,1040,3350,18,1117427,14389,97884,1030,1019543,13359
2020-09-04,Iowa,19,68757,1064,1158,21,642335,7577,66614,1091,575721,6486
2020-09-04,Kansas,20,46049,1294,481,6,427205,7958,45220,1280,381985,6678
2020-09-04,Kentucky,21,55500,1433,1028,7,852440,8016,51677,792,800763,7224
2020-09-04,Louisiana,22,152369,822,5035,14,1932644,15545,152369,822,1780275,14723
2020-09-04,Maine,23,4632,15,134,1,286603,5550,4632,15,281971,5535
2020-09-04,Maryland,24,111332,828,3789,11,1371465,13860,110831,819,1260634,13041
2020-09-04,Massachusetts,25,121758,212,9100,23,1820864,17552,121758,212,1699106,17340
2020-09-04,Michigan,26,116470,1077,6802,8,2877981,28530,116295,1053,2761686,27477
2020-09-04,Minnesota,27,79018,843,1899,10,1168307,9919,78966,843,1089341,9076
2020-09-04,Mississippi,28,85939,823,2558,22,587404,823,85939,823,501465,0
2020-09-04,Missouri,29,91994,1602,1698,18,1021730,13652,90215,1605,931515,12047
2020-09-04,Montana,30,8046,143,114,3,259988,4328,8019,148,251969,4180
2020-09-04,Nebraska,31,35661,192,411,1,373592,4627,35469,474,338123,4153
2020-09-04,Nevada,32,70783,464,1376,10,608815,3547,70712,489,538103,3058
2020-09-04,New Hampshire,33,7368,21,432,0,217263,1388,7368,21,209895,1367
2020-09-04,New Jersey,34,195205,449,15978,7,2964722,34707,193422,449,2771300,34258
2020-09-04,New Mexico,35,25902,90,794,3,782044,5248,25902,90,756142,5158
2020-09-04,New York,36,442698,863,32573,6,8610853,93395,437971,864,8172882,92531
2020-09-04,North Carolina,37,174848,2057,2868,39,2389096,41259,174254,2045,2214842,39214
2020-09-04,North Dakota,38,12977,344,154,0,207754,1855,12971,342,194783,1513
2020-09-04,Northern Mariana Islands,69,57,0,2,0,13541,0,57,0,13484,0
2020-09-04,Ohio,39,128444,1332,4248,22,2349585,30057,128444,1332,2221141,28725
2020-09-04,Oklahoma,40,62040,1013,846,11,914395,11349,62040,1013,852355,10336
2020-09-04,Oregon,41,27605,249,481,6,576929,5804,27601,265,549328,5539
2020-09-04,Pennsylvania,42,142537,959,7821,16,1714541,12327,137662,891,1576879,11436
2020-09-04,Puerto Rico,72,34241,43,455,7,322073,32,16101,32,305972,0
2020-09-04,Rhode Island,44,22243,100,1055,0,284006,2373,22243,100,261763,2273
2020-09-04,South Carolina,45,123325,1629,2846,39,981984,12559,123325,1629,858659,10930
2020-09-04,South Dakota,46,14596,259,170,1,152293,1756,14596,259,137697,1497
2020-09-04,Tennessee,47,158120,1092,1813,22,2283234,18231,160597,1051,2122637,17180
2020-09-04,Texas,48,658789,5468,13516,129,5119753,12250,630829,5482,4488924,6768
2020-09-04,Utah,49,53940,528,420,4,676673,4622,53839,513,622834,4109
2020-09-04,Vermont,50,1642,5,58,0,140794,1293,1640,10,139154,1283
2020-09-04,Virgin Islands,78,1150,0,16,0,16940,147,1150,6,15790,141
2020-09-04,Virginia,51,124779,1111,2662,10,1639828,15297,124779,1111,1515049,14186
2020-09-04,Washington,53,79721,601,2042,9,1518089,21736,75856,479,1442233,21257
2020-09-04,West Virginia,54,11037,192,243,6,448911,3817,11037,192,437874,3625
2020-09-04,Wisconsin,55,84519,1400,1164,9,1294667,11746,84464,1542,1210203,10204
2020-09-04,Wyoming,56,3989,50,42,1,78301,800,3989,50,74312,750
2020-09-05,Alabama,01,131803,1410,2275,9,977973,7560,131803,1410,846170,6150
2020-09-05,Alaska,02,6514,98,39,2,385002,3065,5681,87,379321,2978
2020-09-05,Arizona,04,205518,832,5207,33,1252775,15847,205516,835,1047259,15012
2020-09-05,Arkansas,05,65226,548,882,9,765947,17033,65226,548,700721,16485
2020-09-05,California,06,737073,4382,13708,64,11916323,119353,727239,4956,11189084,114397
2020-09-05,Colorado,08,59362,341,1978,5,742572,6604,58989,334,683583,6270
2020-09-05,Connecticut,09,53365,0,4468,0,1237658,0,53365,0,1184293,0
2020-09-05,Delaware,10,17892,140,608,2,248632,1990,17892,140,230740,1850
2020-09-05,District of Columbia,11,14238,52,611,0,307864,4513,14238,52,293626,4461
2020-09-05,Florida,12,643859,3656,11810,61,4756593,23737,636653,3593,4119940,20144
2020-09-05,Georgia,13,265215,2168,5842,45,2460729,28604,281548,2194,2179181,26410
2020-09-05,Guam,66,2640,52,16,1,40741,629,1671,52,39070,577
2020-09-05,Hawaii,15,9667,219,83,3,221391,7669,9473,271,211918,7398
2020-09-05,Idaho,16,33884,256,386,0,265645,1918,33196,269,232449,1649
2020-09-05,Illinois,17,250882,2629,8405,19,4373804,61935,250105,2806,4123699,59129
2020-09-05,Indiana,18,101094,1083,3362,12,1129078,11651,98961,1077,1030117,10574
2020-09-05,Iowa,19,69690,933,1165,7,648511,6176,67642,1028,580869,5148
2020-09-05,Kansas,20,46051,2,482,1,427205,0,45220,0,381985,0
2020-09-05,Kentucky,21,56016,516,1033,5,871819,19379,52464,787,819355,18592
2020-09-05,Louisiana,22,152369,0,5035,0,1932644,0,152369,0,1780275,0
2020-09-05,Maine,23,4667,35,134,0,291975,5372,4667,35,287308,5337
2020-09-05,Maryland,24,112104,772,3796,7,1384455,12990,111607,776,1272848,12214
2020-09-05,Massachusetts,25,122196,438,9116,16,1841675,20811,122196,438,1719479,20373
2020-09-05,Michigan,26,117267,797,6809,7,2919002,41021,117191,896,2801811,40125
2020-09-05,Minnesota,27,79932,914,1903,4,1177800,9493,79880,914,1097920,8579
2020-09-05,Mississippi,28,86478,539,2569,11,597399,9995,86478,539,510921,9456
2020-09-05,Missouri,29,93713,1719,1728,30,1038301,16571,92202,1987,946099,14584
2020-09-05,Montana,30,8178,132,116,2,261050,1062,8164,145,252886,917
2020-09-05,Nebraska,31,35805,144,415,4,375524,1932,35661,192,339863,1740
2020-09-05,Nevada,32,71184,401,1390,14,613004,4189,71102,390,541902,3799
2020-09-05,New Hampshire,33,7424,56,432,0,218745,1482,7424,56,211321,1426
2020-09-05,New Jersey,34,195530,325,15985,7,2965047,325,193747,325,2771300,0
2020-09-05,New Mexico,35,26048,146,800,6,787811,5767,26048,146,761763,5621
2020-09-05,New York,36,443497,799,32579,6,8710614,99761,438772,801,8271842,98960
2020-09-05,North Carolina,37,176124,1276,2913,45,2410871,21775,175815,1561,2235056,20214
2020-09-05,North Dakota,38,13338,361,159,5,209492,1738,13327,356,196165,1382
2020-09-05,Northern Mariana Islands,69,58,1,2,0,13542,1,58,1,13484,0
2020-09-05,Ohio,39,129785,1341,4256,8,2377910,28325,129785,1341,2248125,26984
2020-09-05,Oklahoma,40,63187,1147,850,4,923273,8878,63187,1147,860086,7731
2020-09-05,Oregon,41,27857,252,482,1,580107,3178,27856,255,552251,2923
2020-09-05,Pennsylvania,42,143301,764,7837,16,1727706,13165,138625,963,1589081,12202
2020-09-05,Puerto Rico,72,34492,251,464,9,322215,142,16243,142,305972,0
2020-09-05,Rhode Island,44,22243,0,1055,0,287687,3681,22484,241,265203,3440
2020-09-05,South Carolina,45,124289,964,2877,31,993927,11943,124289,964,869638,10979
2020-09-05,South Dakota,46,14889,293,173,3,153907,1614,14889,293,139018,1321
2020-09-05,Tennessee,47,159893,1773,1838,25,2310324,27090,162362,1765,2147962,25325
2020-09-05,Texas,48,663246,4457,13660,144,5183948,64195,635315,4486,4548633,59709
2020-09-05,Utah,49,54364,424,421,1,681438,4765,54272,433,627166,4332
2020-09-05,Vermont,50,1647,5,58,0,141652,858,1645,5,140007,853
2020-09-05,Virgin Islands,78,1167,17,16,0,17211,271,1167,17,16044,254
2020-09-05,Virginia,51,125727,948,2677,15,1657556,17728,125727,948,1531829,16780
2020-09-05,Washington,53,79900,179,2042,0,1534090,16001,76335,479,1457755,15522
2020-09-05,West Virginia,54,11289,252,243,0,453481,4570,11289,252,442192,4318
2020-09-05,Wisconsin,55,85517,998,1177,13,1302741,8074,85463,999,1217278,7075
2020-09-05,Wyoming,56,4006,17,42,0,78318,17,4006,17,74312,0
2020-09-06,Alabama,01,132314,511,2276,1,984308,6335,132314,511,851994,5824
2020-09-06,Alaska,02,6603,89,39,0,387057,2055,5776,95,381281,1960
2020-09-06,Arizona,04,205772,254,5221,14,1259018,6243,205766,250,1053252,5993
2020-09-06,Arkansas,05,65924,698,894,12,765947,0,65226,0,700721,0
2020-09-06,California,06,740233,3160,13730,22,12047191,130868,732144,4905,11315047,125963
2020-09-06,Colorado,08,59626,264,1980,2,748461,5889,59274,285,689187,5604
2020-09-06,Connecticut,09,53365,0,4468,0,1237658,0,53365,0,1184293,0
2020-09-06,Delaware,10,18043,151,609,1,250783,2151,18043,151,232740,2000
2020-09-06,District of Columbia,11,14279,41,611,0,311510,3646,14279,41,297231,3605
2020-09-06,Florida,12,646423,2564,11848,38,4777505,20912,639166,2513,4138339,18399
2020-09-06,Georgia,13,266707,1492,5900,58,2479568,18839,283199,1651,2196369,17188
2020-09-06,Guam,66,2588,-52,17,1,40741,0,1671,0,39070,0
2020-09-06,Hawaii,15,9829,162,84,1,229796,8405,9693,220,220103,8185
2020-09-06,Idaho,16,34053,169,387,1,267172,1527,33477,281,233695,1246
2020-09-06,Illinois,17,252306,1424,8409,4,4420300,46496,251508,1403,4168792,45093
2020-09-06,Indiana,18,101937,843,3364,2,1138868,9790,99804,843,1039064,8947
2020-09-06,Iowa,19,70210,520,1167,2,652937,4426,68291,649,584646,3777
2020-09-06,Kansas,20,46151,100,483,1,427205,0,45220,0,381985,0
2020-09-06,Kentucky,21,56172,156,1035,2,872129,310,52774,310,819355,0
2020-09-06,Louisiana,22,153764,1395,5093,58,1959244,26600,153764,1395,1805480,25205
2020-09-06,Maine,23,4682,15,134,0,296854,4879,4682,15,292172,4864
2020-09-06,Maryland,24,112557,453,3799,3,1393324,8869,112119,512,1281205,8357
2020-09-06,Massachusetts,25,122562,366,9125,9,1859402,17727,122562,366,1736840,17361
2020-09-06,Michigan,26,117310,43,6809,0,2919002,0,117191,0,2801811,0
2020-09-06,Minnesota,27,80639,707,1909,6,1188293,10493,80587,707,1107706,9786
2020-09-06,Mississippi,28,86888,410,2584,15,597809,410,86888,410,510921,0
2020-09-06,Missouri,29,94923,1210,1739,11,1045843,7542,93434,1232,952409,6310
2020-09-06,Montana,30,8272,94,117,1,262026,976,8264,100,253762,876
2020-09-06,Nebraska,31,35891,86,415,0,376828,1304,35805,144,341023,1160
2020-09-06,Nevada,32,71711,527,1394,4,619482,6478,71610,508,547872,5970
2020-09-06,New Hampshire,33,7447,23,433,1,220662,1917,7447,23,213215,1894
2020-09-06,New Jersey,34,195841,311,15989,4,3002307,37260,194058,311,2808249,36949
2020-09-06,New Mexico,35,26107,59,803,3,791836,4025,26107,59,765729,3966
2020-09-06,New York,36,444226,729,32585,6,8796244,85630,439501,729,8356743,84901
2020-09-06,North Carolina,37,177141,1017,2920,7,2442950,32079,176901,1086,2266049,30993
2020-09-06,North Dakota,38,13635,297,160,1,210994,1502,13626,299,197368,1203
2020-09-06,Northern Mariana Islands,69,58,0,2,0,13542,0,58,0,13484,0
2020-09-06,Ohio,39,130558,773,4259,3,2404235,26325,130558,773,2273677,25552
2020-09-06,Oklahoma,40,63607,420,853,3,923693,420,63607,420,860086,0
2020-09-06,Oregon,41,28045,188,483,1,585425,5318,28044,188,557381,5130
2020-09-06,Pennsylvania,42,143902,601,7837,0,1738615,10909,139316,691,1599299,10218
2020-09-06,Puerto Rico,72,34533,41,477,13,322241,26,16269,26,305972,0
2020-09-06,Rhode Island,44,22243,0,1055,0,289208,1521,22519,35,266689,1486
2020-09-06,South Carolina,45,124952,663,2887,10,1001225,7298,124952,663,876273,6635
2020-09-06,South Dakota,46,15109,220,173,0,155101,1194,15109,220,139992,974
2020-09-06,Tennessee,47,161589,1696,1841,3,2331199,20875,164126,1764,2167073,19111
2020-09-06,Texas,48,665338,2092,13739,79,5282579,98631,638310,2995,4644269,95636
2020-09-06,Utah,49,54660,296,423,2,685923,4485,54660,388,631263,4097
2020-09-06,Vermont,50,1648,1,58,0,142568,916,1646,1,140922,915
2020-09-06,Virgin Islands,78,1181,14,17,1,17325,114,1181,14,16144,100
2020-09-06,Virginia,51,126926,1199,2678,1,1670084,12528,126926,1199,1543158,11329
2020-09-06,Washington,53,80369,469,2043,1,1550477,16387,76836,501,1473641,15886
2020-09-06,West Virginia,54,11412,123,246,3,458378,4897,11412,123,446966,4774
2020-09-06,Wisconsin,55,86406,889,1177,0,1308247,5506,86353,890,1221894,4616
2020-09-06,Wyoming,56,4032,26,42,0,78344,26,4032,26,74312,0
2020-09-07,Alabama,01,132973,659,2276,0,987995,3687,132973,659,855022,3028
2020-09-07,Alaska,02,6637,34,39,0,388621,1564,5810,34,382811,1530
2020-09-07,Arizona,04,205971,199,5219,-2,1263397,4379,205964,198,1057433,4181
2020-09-07,Arkansas,05,66280,356,908,14,772813,6866,66280,1054,706533,5812
2020-09-07,California,06,742689,2456,13763,33,12158292,111101,735235,3091,11423057,108010
2020-09-07,Colorado,08,59823,197,1980,0,754319,5858,59487,213,694832,5645
2020-09-07,Connecticut,09,53365,0,4468,0,1237658,0,53365,0,1184293,0
2020-09-07,Delaware,10,18249,206,609,0,252602,1819,18249,206,234353,1613
2020-09-07,District of Columbia,11,14315,36,611,0,313715,2205,14315,36,299400,2169
2020-09-07,Florida,12,648261,1838,11870,22,4794393,16888,640978,1812,4153415,15076
2020-09-07,Georgia,13,267238,531,5907,7,2488841,9273,283807,608,2205034,8665
2020-09-07,Guam,66,2588,0,19,2,40741,0,1671,0,39070,0
2020-09-07,Hawaii,15,9933,104,85,1,234903,5107,9855,162,225048,4945
2020-09-07,Idaho,16,34153,100,387,0,268189,1017,33667,190,234522,827
2020-09-07,Illinois,17,253649,1343,8417,8,4449275,28975,252889,1381,4196386,27594
2020-09-07,Indiana,18,102527,590,3368,4,1146572,7704,100394,590,1046178,7114
2020-09-07,Iowa,19,70537,327,1170,3,655846,2909,68684,393,587162,2516
2020-09-07,Kansas,20,47409,1258,485,2,436686,9481,46914,1694,389772,7787
2020-09-07,Kentucky,21,56545,373,1036,1,869233,-2896,53064,290,816169,-3186
2020-09-07,Louisiana,22,154073,309,5105,12,1964229,4985,154073,309,1810156,4676
2020-09-07,Maine,23,4701,19,134,0,300032,3178,4701,19,295331,3159
2020-09-07,Maryland,24,113378,821,3804,5,1405189,11865,112883,764,1292306,11101
2020-09-07,Massachusetts,25,122791,229,9133,8,1869279,9877,122791,229,1746488,9648
2020-09-07,Michigan,26,118388,1078,6813,4,2962678,43676,118403,1212,2844275,42464
2020-09-07,Minnesota,27,81277,638,1912,3,1197675,9382,81225,638,1116450,8744
2020-09-07,Mississippi,28,87130,242,2585,1,598051,242,87130,242,510921,0
2020-09-07,Missouri,29,95795,872,1739,0,1054385,8542,94340,906,960045,7636
2020-09-07,Montana,30,8340,68,118,1,267125,5099,8316,52,258809,5047
2020-09-07,Nebraska,31,35975,84,415,0,377461,633,35886,81,341575,552
2020-09-07,Nevada,32,72048,337,1394,0,622642,3160,71967,357,550675,2803
2020-09-07,New Hampshire,33,7476,29,433,0,222299,1637,7476,29,214823,1608
2020-09-07,New Jersey,34,196173,332,15991,2,3054528,52221,194390,332,2860138,51889
2020-09-07,New Mexico,35,26144,37,807,4,795247,3411,26144,37,769103,3374
2020-09-07,New York,36,444751,525,32600,15,8855109,58865,440021,520,8415088,58345
2020-09-07,North Carolina,37,178212,1071,2920,0,2459582,16632,177919,1018,2281663,15614
2020-09-07,North Dakota,38,13805,170,160,0,211894,900,13797,171,198097,729
2020-09-07,Northern Mariana Islands,69,59,1,2,0,13542,0,58,0,13484,0
2020-09-07,Ohio,39,131336,778,4276,17,2426014,21779,131336,778,2294678,21001
2020-09-07,Oklahoma,40,64220,613,853,0,924306,613,64220,613,860086,0
2020-09-07,Oregon,41,28191,146,487,4,588166,2741,28190,146,559976,2595
2020-09-07,Pennsylvania,42,144658,756,7855,18,1748241,9626,139863,547,1608378,9079
2020-09-07,Puerto Rico,72,35375,842,477,0,322664,423,16692,423,305972,0
2020-09-07,Rhode Island,44,22243,0,1055,0,291029,1821,22572,53,268457,1768
2020-09-07,South Carolina,45,125607,655,2907,20,1009710,8485,125607,655,884103,7830
2020-09-07,South Dakota,46,15300,191,173,0,156093,992,15300,191,140793,801
2020-09-07,Tennessee,47,162531,942,1845,4,2344781,13582,165109,983,2179672,12599
2020-09-07,Texas,48,666209,871,13781,42,5320999,38420,640370,2060,4680629,36360
2020-09-07,Utah,49,55052,392,424,1,688805,2882,55033,373,633772,2509
2020-09-07,Vermont,50,1651,3,58,0,144415,1847,1650,4,142765,1843
2020-09-07,Virgin Islands,78,1190,9,17,0,17420,95,1190,9,16230,86
2020-09-07,Virginia,51,127571,645,2684,6,1682098,12014,127571,645,1554527,11369
2020-09-07,Washington,53,80485,116,2043,0,1563053,12576,77235,399,1485818,12177
2020-09-07,West Virginia,54,11575,163,247,1,461765,3387,11575,163,450190,3224
2020-09-07,Wisconsin,55,86981,575,1177,0,1313721,5474,86928,575,1226793,4899
2020-09-07,Wyoming,56,4032,0,42,0,78344,0,4032,0,74312,0
2020-09-08,Alabama,01,133606,633,2277,1,992395,4400,133606,633,858789,3767
2020-09-08,Alaska,02,6670,33,39,0,391656,3035,5843,33,385813,3002
2020-09-08,Arizona,04,206048,77,5221,2,1266599,3202,206045,81,1060554,3121
2020-09-08,Arkansas,05,66757,477,917,9,783730,10917,66757,477,716973,10440
2020-09-08,California,06,746113,3424,13843,80,12267948,109656,737911,2676,11530037,106980
2020-09-08,Colorado,08,60003,180,1980,0,757241,2922,59674,187,697567,2735
2020-09-08,Connecticut,09,53782,417,4474,6,1286887,49229,53782,417,1233105,48812
2020-09-08,Delaware,10,18308,59,609,0,253970,1368,18308,59,235662,1309
2020-09-08,District of Columbia,11,14362,47,611,0,316598,2883,14362,47,302236,2836
2020-09-08,Florida,12,650084,1823,11914,44,4809556,15163,642775,1797,4166781,13366
2020-09-08,Georgia,13,268684,1446,5931,24,2511826,22985,285350,1543,2226476,21442
2020-09-08,Guam,66,2682,94,20,1,41412,671,1713,42,39699,629
2020-09-08,Hawaii,15,10130,197,87,2,237012,2109,9959,104,227053,2005
2020-09-08,Idaho,16,34461,308,390,3,269238,1049,33741,74,235497,975
2020-09-08,Illinois,17,255229,1580,8431,14,4480638,31363,254281,1392,4226357,29971
2020-09-08,Indiana,18,102917,390,3380,12,1150863,4291,100780,386,1050083,3905
2020-09-08,Iowa,19,71018,481,1185,15,658977,3131,69139,455,589838,2676
2020-09-08,Kansas,20,47878,469,486,1,436686,0,46914,0,389772,0
2020-09-08,Kentucky,21,56877,332,1039,3,870650,1417,53319,255,817331,1162
2020-09-08,Louisiana,22,154329,256,5118,13,1968354,4125,154329,256,1814025,3869
2020-09-08,Maine,23,4713,12,134,0,302706,2674,4713,12,297993,2662
2020-09-08,Maryland,24,113734,356,3807,3,1410598,5409,113239,356,1297359,5053
2020-09-08,Massachusetts,25,122962,171,9141,8,1878721,9442,122962,171,1755759,9271
2020-09-08,Michigan,26,118984,596,6814,1,2980084,17406,118902,499,2861182,16907
2020-09-08,Minnesota,27,81660,383,1914,2,1201870,4195,81608,383,1120262,3812
2020-09-08,Mississippi,28,87379,249,2585,0,606461,8410,87379,249,519082,8161
2020-09-08,Missouri,29,97044,1249,1746,7,1061230,6845,95113,773,966117,6072
2020-09-08,Montana,30,8409,69,119,1,268780,1655,8381,65,260399,1590
2020-09-08,Nebraska,31,36477,502,418,3,378300,839,35975,89,342325,750
2020-09-08,Nevada,32,72165,117,1395,1,624052,1410,72104,137,551948,1273
2020-09-08,New Hampshire,33,7494,18,433,0,222963,664,7494,18,215469,646
2020-09-08,New Jersey,34,196450,277,15996,5,3070746,16218,194667,277,2876079,15941
2020-09-08,New Mexico,35,26181,37,807,0,799673,4426,26181,37,773492,4389
2020-09-08,New York,36,445308,557,32612,12,8912935,57826,440578,557,8472357,57269
2020-09-08,North Carolina,37,179150,938,2942,22,2469977,10395,178635,716,2291342,9679
2020-09-08,North Dakota,38,13876,71,160,0,212129,235,13872,75,198257,160
2020-09-08,Northern Mariana Islands,69,59,0,2,0,13543,1,59,1,13484,0
2020-09-08,Ohio,39,131992,656,4298,22,2449545,23531,131992,656,2317553,22875
2020-09-08,Oklahoma,40,65053,833,854,1,925139,833,65053,833,860086,0
2020-09-08,Oregon,41,28355,164,492,5,591499,3333,28355,165,563144,3168
2020-09-08,Pennsylvania,42,145191,533,7862,7,1755076,6835,140359,496,1614717,6339
2020-09-08,Puerto Rico,72,35504,129,482,5,322760,96,16788,96,305972,0
2020-09-08,Rhode Island,44,22592,349,1059,4,291439,410,22592,20,268847,390
2020-09-08,South Carolina,45,125908,301,2912,5,1014151,4441,125908,301,888243,4140
2020-09-08,South Dakota,46,15403,103,173,0,156686,593,15403,103,141283,490
2020-09-08,Tennessee,47,163180,649,1873,28,2350991,6210,165754,645,2185237,5565
2020-09-08,Texas,48,670427,4218,13855,74,5339126,18127,641791,1421,4697335,16706
2020-09-08,Utah,49,55424,372,426,2,691359,2554,55359,326,636000,2228
2020-09-08,Vermont,50,1654,3,58,0,145089,674,1652,2,143437,672
2020-09-08,Virgin Islands,78,1191,1,18,1,17444,24,1191,1,16253,23
2020-09-08,Virginia,51,128407,836,2686,2,1689744,7646,128407,836,1561337,6810
2020-09-08,Washington,53,81048,563,2045,2,1563053,0,77235,0,1485818,0
2020-09-08,West Virginia,54,11661,86,250,3,462760,995,11661,86,451099,909
2020-09-08,Wisconsin,55,87730,749,1179,2,1317836,4115,87677,749,1230159,3366
2020-09-08,Wyoming,56,4103,71,42,0,81469,3125,4103,71,77366,3054
2020-09-09,Alabama,01,134417,811,2285,8,998399,6004,134417,811,863982,5193
2020-09-09,Alaska,02,6735,65,39,0,391937,281,5908,65,386029,216
2020-09-09,Arizona,04,206548,500,5253,32,1269197,2598,206541,496,1062656,2102
2020-09-09,Arkansas,05,67255,498,928,11,784228,498,67255,498,716973,0
2020-09-09,California,06,749196,3083,13990,147,12343797,75849,739527,1616,11604270,74233
2020-09-09,Colorado,08,60291,288,1984,4,760352,3111,59920,246,700432,2865
2020-09-09,Connecticut,09,53871,89,4474,0,1292847,5960,53871,89,1238976,5871
2020-09-09,Delaware,10,18308,0,609,0,253970,0,18308,0,235662,0
2020-09-09,District of Columbia,11,14387,25,615,4,317660,1062,14387,25,303273,1037
2020-09-09,Florida,12,652140,2056,12114,200,4823881,14325,644781,2006,4179100,12319
2020-09-09,Georgia,13,270624,1940,5987,56,2527779,15953,287287,1937,2240492,14016
2020-09-09,Guam,66,2727,45,21,1,42095,683,1758,45,40337,638
2020-09-09,Hawaii,15,10228,98,90,3,237917,905,10156,197,227761,708
2020-09-09,Idaho,16,34707,246,406,16,270534,1296,33981,240,236553,1056
2020-09-09,Illinois,17,256614,1385,8457,26,4528667,48029,255618,1337,4273049,46692
2020-09-09,Indiana,18,103641,724,3397,17,1158018,7155,101485,705,1056533,6450
2020-09-09,Iowa,19,71594,576,1204,19,661575,2598,69503,364,592072,2234
2020-09-09,Kansas,20,48389,511,497,11,441414,4728,47410,496,394004,4232
2020-09-09,Kentucky,21,57518,641,1058,19,878290,7640,53977,658,824313,6982
2020-09-09,Louisiana,22,155890,1561,5140,22,1999962,31608,155890,1561,1844072,30047
2020-09-09,Maine,23,4734,21,134,0,309725,7019,4734,21,304991,6998
2020-09-09,Maryland,24,114070,336,3816,9,1415522,4924,113575,336,1301947,4588
2020-09-09,Massachusetts,25,123143,181,9146,5,1890070,11349,123143,181,1766927,11168
2020-09-09,Michigan,26,119952,968,6889,75,3003277,23193,119863,961,2883414,22232
2020-09-09,Minnesota,27,81920,260,1921,7,1204193,2323,81868,260,1122325,2063
2020-09-09,Mississippi,28,87805,426,2623,38,609638,3177,87805,426,521833,2751
2020-09-09,Missouri,29,98446,1402,1755,9,1070909,9679,96475,1362,974434,8317
2020-09-09,Montana,30,8499,90,122,3,271150,2370,8468,87,262682,2283
2020-09-09,Nebraska,31,36917,440,434,16,385349,7049,36477,502,348872,6547
2020-09-09,Nevada,32,72317,152,1414,19,624874,822,72258,154,552616,668
2020-09-09,New Hampshire,33,7517,23,433,0,222963,0,7494,0,215469,0
2020-09-09,New Jersey,34,196779,329,16009,13,3091149,20403,194990,323,2896159,20080
2020-09-09,New Mexico,35,26268,87,813,6,803101,3428,26268,87,776833,3341
2020-09-09,New York,36,445881,573,32611,-1,8976165,63230,441154,576,8535011,62654
2020-09-09,North Carolina,37,180061,911,2990,48,2490113,20136,179532,897,2310581,19239
2020-09-09,North Dakota,38,14114,238,161,1,212959,830,14110,238,198849,592
2020-09-09,Northern Mariana Islands,69,59,0,2,0,13543,0,59,0,13484,0
2020-09-09,Ohio,39,132965,973,4324,26,2470564,21019,132965,973,2337599,20046
2020-09-09,Oklahoma,40,65929,876,863,9,953536,28397,65929,876,887607,27521
2020-09-09,Oregon,41,28474,119,499,7,594077,2578,28471,116,565606,2462
2020-09-09,Pennsylvania,42,146058,867,7882,20,1766930,11854,141290,931,1625640,10923
2020-09-09,Puerto Rico,72,35507,3,500,18,322761,1,16789,1,305972,0
2020-09-09,Rhode Island,44,22676,84,1062,3,299014,7575,22676,84,276338,7491
2020-09-09,South Carolina,45,126213,305,2942,30,1017319,3168,126213,305,891106,2863
2020-09-09,South Dakota,46,15571,168,173,0,157889,1203,15571,168,142318,1035
2020-09-09,Tennessee,47,164032,852,1908,35,2367502,16511,166587,833,2200915,15678
2020-09-09,Texas,48,675149,4722,13986,131,5372132,33006,645791,4000,4726341,29006
2020-09-09,Utah,49,55730,306,428,2,694309,2950,55673,314,638636,2636
2020-09-09,Vermont,50,1656,2,58,0,145473,384,1657,5,143816,379
2020-09-09,Virgin Islands,78,1197,6,18,0,17444,0,1191,0,16253,0
2020-09-09,Virginia,51,129289,882,2697,11,1700004,10260,129289,882,1570715,9378
2020-09-09,Washington,53,81528,480,2066,21,1583903,20850,78009,774,1505894,20076
2020-09-09,West Virginia,54,11808,147,254,4,463930,1170,11808,147,452122,1023
2020-09-09,Wisconsin,55,88643,913,1193,14,1326763,8927,88590,913,1238173,8014
2020-09-09,Wyoming,56,4151,48,42,0,84835,3366,4151,48,80684,3318
2020-09-10,Alabama,01,135565,1148,2301,16,1005738,7339,135565,1148,870173,6191
2020-09-10,Alaska,02,6860,125,39,0,393077,1140,6022,114,387055,1026
2020-09-10,Arizona,04,207002,454,5275,22,1272734,3537,207002,461,1065732,3076
2020-09-10,Arkansas,05,67803,548,940,12,797178,12950,67803,548,729375,12402
2020-09-10,California,06,753017,3821,14094,104,12389991,46194,742865,3338,11647126,42856
2020-09-10,Colorado,08,60576,285,1988,4,764682,4330,60185,265,704497,4065
2020-09-10,Connecticut,09,54093,222,4478,4,1309460,16613,54093,222,1255367,16391
2020-09-10,Delaware,10,18466,158,613,4,256698,2728,18466,158,238232,2570
2020-09-10,District of Columbia,11,14412,25,616,1,319188,1528,14412,25,304776,1503
2020-09-10,Florida,12,654723,2583,12325,211,4842846,18965,647318,2537,4195528,16428
2020-09-10,Georgia,13,272588,1964,6062,75,2542594,14815,289123,1836,2253471,12979
2020-09-10,Guam,66,2815,88,22,1,42618,523,1846,88,40772,435
2020-09-10,Hawaii,15,10397,169,93,3,239403,1486,10254,98,229149,1388
2020-09-10,Idaho,16,35027,320,407,1,272164,1630,34310,329,237854,1301
2020-09-10,Illinois,17,258573,1959,8480,23,4577649,48982,257571,1953,4320078,47029
2020-09-10,Indiana,18,104429,788,3410,13,1164141,6123,102243,758,1061898,5365
2020-09-10,Iowa,19,72548,954,1208,4,667869,6294,70405,902,597464,5392
2020-09-10,Kansas,20,48443,54,499,2,441414,0,47410,0,394004,0
2020-09-10,Kentucky,21,58452,934,1073,15,884491,6201,54772,795,829719,5406
2020-09-10,Louisiana,22,156354,464,5161,21,2010519,10557,156354,464,1854165,10093
2020-09-10,Maine,23,4760,26,134,0,313909,4184,4760,26,309149,4158
2020-09-10,Maryland,24,114574,504,3824,8,1423727,8205,114078,503,1309649,7702
2020-09-10,Massachusetts,25,123546,403,9166,20,1907999,17929,123546,403,1784453,17526
2020-09-10,Michigan,26,120896,944,6894,5,3036448,33171,120846,983,2915602,32188
2020-09-10,Minnesota,27,82301,381,1936,15,1205501,1308,82249,381,1123252,927
2020-09-10,Mississippi,28,88322,517,2656,33,613238,3600,88322,517,524916,3083
2020-09-10,Missouri,29,99677,1231,1773,18,1083924,13015,97591,1116,986333,11899
2020-09-10,Montana,30,8694,195,123,1,273353,2203,8663,195,264690,2008
2020-09-10,Nebraska,31,37373,456,440,6,390318,4969,36917,440,353401,4529
2020-09-10,Nevada,32,72620,303,1432,18,627319,2445,72546,288,554773,2157
2020-09-10,New Hampshire,33,7573,56,434,1,225659,2696,7573,79,218086,2617
2020-09-10,New Jersey,34,197203,424,16014,5,3113654,22505,195414,424,2918240,22081
2020-09-10,New Mexico,35,26429,161,816,3,806999,3898,26429,161,780570,3737
2020-09-10,New York,36,446637,756,32618,7,9052978,76813,441911,757,8611067,76056
2020-09-10,North Carolina,37,181335,1274,3016,26,2521839,31726,180754,1222,2341085,30504
2020-09-10,North Dakota,38,14446,332,163,2,214292,1333,14443,333,199849,1000
2020-09-10,Northern Mariana Islands,69,59,0,2,0,14375,832,59,0,14316,832
2020-09-10,Ohio,39,134086,1121,4354,30,2490351,19787,134086,1121,2356265,18666
2020-09-10,Oklahoma,40,66700,771,876,13,961710,8174,66700,771,895010,7403
2020-09-10,Oregon,41,28661,187,501,2,596988,2911,28654,183,568334,2728
2020-09-10,Pennsylvania,42,146735,677,7894,12,1781226,14296,141877,587,1639349,13709
2020-09-10,Puerto Rico,72,36279,772,512,12,323220,459,17248,459,305972,0
2020-09-10,Rhode Island,44,22782,106,1067,5,301313,2299,22782,106,278531,2193
2020-09-10,South Carolina,45,126592,379,2975,33,1032459,15140,126592,379,905867,14761
2020-09-10,South Dakota,46,15834,263,177,4,159250,1361,15834,263,143416,1098
2020-09-10,Tennessee,47,165911,1879,1963,55,2393040,25538,168237,1650,2224803,23888
2020-09-10,Texas,48,677888,2739,13998,12,5405257,33125,649809,4018,4755448,29107
2020-09-10,Utah,49,56182,452,431,3,698425,4116,56019,346,642406,3770
2020-09-10,Vermont,50,1661,5,58,0,145992,519,1660,3,144332,516
2020-09-10,Virgin Islands,78,1201,4,18,0,17865,421,1197,6,16668,415
2020-09-10,Virginia,51,130525,1236,2708,11,1716462,16458,130525,1236,1585937,15222
2020-09-10,Washington,53,82125,597,2073,7,1597987,14084,78467,458,1519520,13626
2020-09-10,West Virginia,54,12017,209,257,3,467790,3860,12017,209,455773,3651
2020-09-10,Wisconsin,55,90232,1589,1202,9,1335630,8867,90182,1592,1245448,7275
2020-09-10,Wyoming,56,4199,48,42,0,85299,464,4199,48,81100,416
2020-09-11,Alabama,01,136703,1138,2333,32,1010922,5184,136703,1138,874219,4046
2020-09-11,Alaska,02,6968,108,40,1,394586,1509,6111,89,388475,1420
2020-09-11,Arizona,04,207525,523,5290,15,1279424,6690,207523,521,1071901,6169
2020-09-11,Arkansas,05,68987,1184,953,13,798358,1180,68983,1180,729375,0
2020-09-11,California,06,757125,4108,14265,171,12451660,61669,746191,3326,11705469,58343
2020-09-11,Colorado,08,60881,305,1991,3,770227,5545,60492,307,709735,5238
2020-09-11,Connecticut,09,54326,233,4480,2,1330984,21524,54326,233,1276658,21291
2020-09-11,Delaware,10,18559,93,613,0,256698,0,18466,0,238232,0
2020-09-11,District of Columbia,11,14493,81,616,0,321436,2248,14493,81,306943,2167
2020-09-11,Florida,12,658373,3650,12501,176,4869297,26451,650922,3604,4218375,22847
2020-09-11,Georgia,13,274242,1654,6103,41,2558319,15725,290781,1658,2267538,14067
2020-09-11,Guam,66,2832,17,24,2,43013,395,1863,17,41150,378
2020-09-11,Hawaii,15,10567,170,95,2,246614,7211,10423,169,236191,7042
2020-09-11,Idaho,16,35354,327,415,8,273816,1652,34617,307,239199,1345
2020-09-11,Illinois,17,260949,2376,8522,42,4634477,56828,259883,2312,4374594,54516
2020-09-11,Indiana,18,105703,1274,3420,10,1183104,18963,103505,1262,1079599,17701
2020-09-11,Iowa,19,73399,851,1216,8,673597,5728,71133,728,602464,5000
2020-09-11,Kansas,20,49393,950,520,21,448930,7516,48386,976,400544,6540
2020-09-11,Kentucky,21,59349,897,1087,14,900690,16199,55704,932,844986,15267
2020-09-11,Louisiana,22,157109,755,5202,41,2037753,27234,157109,755,1880644,26479
2020-09-11,Maine,23,4792,32,134,0,320008,6099,4792,32,315216,6067
2020-09-11,Maryland,24,115217,643,3828,4,1432876,9149,114724,646,1318152,8503
2020-09-11,Massachusetts,25,123986,440,9180,14,1927402,19403,123986,440,1803416,18963
2020-09-11,Michigan,26,122319,1423,6900,6,3072786,36338,122251,1405,2950535,34933
2020-09-11,Minnesota,27,82768,467,1949,13,1212560,7059,82716,467,1129844,6592
2020-09-11,Mississippi,28,89175,853,2670,14,618379,5141,89175,853,529204,4288
2020-09-11,Missouri,29,101285,1608,1784,11,1096572,12648,99160,1569,997412,11079
2020-09-11,Montana,30,8817,123,132,9,274658,1305,8785,122,265873,1183
2020-09-11,Nebraska,31,37841,468,449,9,393812,3494,37373,456,356439,3038
2020-09-11,Nevada,32,72886,266,1441,9,633282,5963,72806,260,560476,5703
2020-09-11,New Hampshire,33,7620,47,434,0,227291,1632,7620,47,219671,1585
2020-09-11,New Jersey,34,197677,474,16023,9,3140786,27132,195888,474,2944898,26658
2020-09-11,New Mexico,35,26563,134,818,2,812050,5051,26563,134,785487,4917
2020-09-11,New York,36,447498,861,32619,1,9142700,89722,442791,880,8699909,88842
2020-09-11,North Carolina,37,182934,1599,3050,34,2558654,36815,182286,1532,2376368,35283
2020-09-11,North Dakota,38,14687,241,167,4,215076,784,14684,241,200392,543
2020-09-11,Northern Mariana Islands,69,59,0,2,0,14375,0,59,0,14316,0
2020-09-11,Ohio,39,135326,1240,4403,49,2519213,28862,135326,1240,2383887,27622
2020-09-11,Oklahoma,40,67642,942,888,12,974751,13041,67642,942,907109,12099
2020-09-11,Oregon,41,28888,227,500,-1,605739,8751,28865,211,576874,8540
2020-09-11,Pennsylvania,42,147744,1009,7914,20,1794913,13687,142885,1008,1652028,12679
2020-09-11,Puerto Rico,72,36581,302,523,11,323329,109,17357,109,305972,0
2020-09-11,Rhode Island,44,22905,123,1071,4,303023,1710,22905,123,280118,1587
2020-09-11,South Carolina,45,129046,2454,3028,53,1044476,12017,129046,2454,915430,9563
2020-09-11,South Dakota,46,16117,283,177,0,160963,1713,16117,283,144846,1430
2020-09-11,Tennessee,47,167263,1352,1999,36,2420379,27339,169859,1622,2250520,25717
2020-09-11,Texas,48,683295,5407,14279,281,5454041,48784,653356,3547,4800685,45237
2020-09-11,Utah,49,56789,607,433,2,703161,4736,56675,656,646486,4080
2020-09-11,Vermont,50,1668,7,58,0,147231,1239,1668,8,145563,1231
2020-09-11,Virgin Islands,78,1201,0,18,0,18050,185,1201,4,16849,181
2020-09-11,Virginia,51,131640,1115,2711,3,1734047,17585,131640,1115,1602407,16470
2020-09-11,Washington,53,82590,465,2079,6,1614748,16761,79011,544,1535737,16217
2020-09-11,West Virginia,54,12174,157,263,6,471791,4001,12174,157,459617,3844
2020-09-11,Wisconsin,55,91672,1440,1206,4,1345659,10029,91625,1443,1254034,8586
2020-09-11,Wyoming,56,4264,65,42,0,86355,1056,4264,65,82091,991
2020-09-12,Alabama,01,137646,943,2350,17,1016369,5447,137646,943,878723,4504
2020-09-12,Alaska,02,7074,106,41,1,399629,5043,6214,103,393415,4940
2020-09-12,Arizona,04,208128,603,5316,26,1288729,9305,208128,605,1080601,8700
2020-09-12,Arkansas,05,69710,723,969,16,820000,21642,69710,727,750290,20915
2020-09-12,California,06,760581,3456,14333,68,12556967,105307,750298,4107,11806669,101200
2020-09-12,Colorado,08,61311,430,1994,3,777488,7261,60907,415,716581,6846
2020-09-12,Connecticut,09,54326,0,4480,0,1330984,0,54326,0,1276658,0
2020-09-12,Delaware,10,18726,167,613,0,259585,2887,18726,260,240859,2627
2020-09-12,District of Columbia,11,14552,59,616,0,327437,6001,14552,59,312885,5942
2020-09-12,Florida,12,661563,3190,12599,98,4894199,24902,654090,3168,4240109,21734
2020-09-12,Georgia,13,276319,2077,6144,41,2610171,51852,292905,2124,2317266,49728
2020-09-12,Guam,66,2832,0,24,0,43363,350,1891,28,41472,322
2020-09-12,Hawaii,15,10696,129,96,1,250173,3559,10593,170,239580,3389
2020-09-12,Idaho,16,35588,234,416,1,275610,1794,34950,333,240660,1461
2020-09-12,Illinois,17,262957,2008,8546,24,4691071,56594,262004,2121,4429067,54473
2020-09-12,Indiana,18,106777,1074,3437,17,1206980,23876,104561,1056,1102419,22820
2020-09-12,Iowa,19,74204,805,1218,2,678890,5293,71706,573,607184,4720
2020-09-12,Kansas,20,49398,5,533,13,448930,0,48386,0,400544,0
2020-09-12,Kentucky,21,60187,838,1099,12,930222,29532,56415,711,873807,28821
2020-09-12,Louisiana,22,157109,0,5202,0,2037753,0,157109,0,1880644,0
2020-09-12,Maine,23,4834,42,135,1,325003,4995,4834,42,320169,4953
2020-09-12,Maryland,24,115876,659,3836,8,1444452,11576,115533,809,1328919,10767
2020-09-12,Massachusetts,25,124540,554,9196,16,1945834,18432,124540,554,1821294,17878
2020-09-12,Michigan,26,123048,729,6912,12,3110610,37824,123058,807,2987552,37017
2020-09-12,Minnesota,27,83640,872,1958,9,1222522,9962,83588,872,1138934,9090
2020-09-12,Mississippi,28,89620,445,2685,15,622539,4160,89620,445,532919,3715
2020-09-12,Missouri,29,103085,1800,1802,18,1113373,16801,101134,1974,1012239,14827
2020-09-12,Montana,30,8946,129,134,2,278728,4070,8925,140,269803,3930
2020-09-12,Nebraska,31,38108,267,449,0,397354,3542,37841,468,359513,3074
2020-09-12,Nevada,32,73291,405,1453,12,637902,4620,73220,414,564682,4206
2020-09-12,New Hampshire,33,7652,32,435,1,229024,1733,7652,32,221372,1701
2020-09-12,New Jersey,34,198126,449,16027,4,3141235,449,196337,449,2944898,0
2020-09-12,New Mexico,35,26661,98,821,3,817270,5220,26661,98,790609,5122
2020-09-12,New York,36,448347,849,32625,6,9245625,102925,443640,849,8801985,102076
2020-09-12,North Carolina,37,184305,1371,3073,23,2581132,22478,183740,1454,2397392,21024
2020-09-12,North Dakota,38,15154,467,170,3,216581,1505,15151,467,201430,1038
2020-09-12,Northern Mariana Islands,69,60,1,2,0,14376,1,60,1,14316,0
2020-09-12,Ohio,39,136568,1242,4411,8,2567011,47798,136568,1242,2430443,46556
2020-09-12,Oklahoma,40,68659,1017,899,11,988835,14084,68659,1017,920176,13067
2020-09-12,Oregon,41,29156,268,505,5,610104,4365,29156,291,580948,4074
2020-09-12,Pennsylvania,42,148635,891,7915,1,1807805,12892,143805,920,1664000,11972
2020-09-12,Puerto Rico,72,37092,511,535,12,323570,241,17598,241,305972,0
2020-09-12,Rhode Island,44,22905,0,1071,0,306136,3113,22999,94,283137,3019
2020-09-12,South Carolina,45,129978,932,3040,12,1054872,10396,129978,932,924894,9464
2020-09-12,South Dakota,46,16437,320,183,6,162609,1646,16437,320,146172,1326
2020-09-12,Tennessee,47,168552,1289,2040,41,2442734,22355,170891,1032,2271843,21323
2020-09-12,Texas,48,685921,2626,14384,105,5519641,65600,657589,4233,4862052,61367
2020-09-12,Utah,49,57276,487,434,1,708231,5070,57247,572,650984,4498
2020-09-12,Vermont,50,1677,9,58,0,148224,993,1677,9,146547,984
2020-09-12,Virgin Islands,78,1220,19,19,1,18223,173,1211,10,17012,163
2020-09-12,Virginia,51,132940,1300,2722,11,1750110,16063,132940,1300,1617170,14763
2020-09-12,Washington,53,82957,367,2079,0,1631162,16414,79476,465,1551686,15949
2020-09-12,West Virginia,54,12521,347,265,2,478876,7085,12521,347,466355,6738
2020-09-12,Wisconsin,55,93102,1430,1218,12,1357360,11701,93055,1430,1264305,10271
2020-09-12,Wyoming,56,4297,33,42,0,86388,33,4297,33,82091,0
2020-09-13,Alabama,01,138755,1109,2351,1,1023187,6818,138755,1109,884432,5709
2020-09-13,Alaska,02,7136,62,41,0,401213,1584,6275,61,394938,1523
2020-09-13,Arizona,04,208514,386,5322,6,1296137,7408,208512,384,1087625,7024
2020-09-13,Arkansas,05,70219,509,981,12,822068,2068,70219,509,751849,1559
2020-09-13,California,06,763389,2808,14386,53,12690016,133049,754923,4625,11935093,128424
2020-09-13,Colorado,08,61641,330,1994,0,784530,7042,61324,417,723206,6625
2020-09-13,Connecticut,09,54326,0,4480,0,1330984,0,54326,0,1276658,0
2020-09-13,Delaware,10,18849,123,615,2,261296,1711,18849,123,242447,1588
2020-09-13,District of Columbia,11,14592,40,616,0,330641,3204,14592,40,316049,3164
2020-09-13,Florida,12,663986,2423,12607,8,4916421,22222,656485,2395,4259936,19827
2020-09-13,Georgia,13,277715,1396,6191,47,2602202,-7969,294314,1409,2307888,-9378
2020-09-13,Guam,66,2832,0,24,0,43363,0,1891,0,41472,0
2020-09-13,Hawaii,15,10808,112,98,2,255533,5360,10722,129,244811,5231
2020-09-13,Idaho,16,35693,105,416,0,277123,1513,35167,217,241956,1296
2020-09-13,Illinois,17,264340,1383,8562,16,4737961,46890,263466,1462,4474495,45428
2020-09-13,Indiana,18,108020,1243,3438,1,1238984,32004,105804,1243,1133180,30761
2020-09-13,Iowa,19,74675,471,1220,2,683445,4555,72490,784,610955,3771
2020-09-13,Kansas,20,49408,10,536,3,448930,0,48386,0,400544,0
2020-09-13,Kentucky,21,60607,420,1102,3,930752,530,56945,530,873807,0
2020-09-13,Louisiana,22,158390,1281,5235,33,2066730,28977,158390,1281,1908340,27696
2020-09-13,Maine,23,4863,29,136,1,330168,5165,4863,29,325305,5136
2020-09-13,Maryland,24,116600,724,3838,2,1455845,11393,116110,577,1339735,10816
2020-09-13,Massachusetts,25,124826,286,9210,14,1957955,12121,124826,286,1833129,11835
2020-09-13,Michigan,26,123075,27,6912,0,3110610,0,123058,0,2987552,0
2020-09-13,Minnesota,27,84363,723,1971,13,1233305,10783,84311,723,1148994,10060
2020-09-13,Mississippi,28,89874,254,2697,12,622793,254,89874,254,532919,0
2020-09-13,Missouri,29,104603,1518,1812,10,1128700,15327,102747,1613,1025953,13714
2020-09-13,Montana,30,9037,91,136,2,280124,1396,9021,96,271103,1300
2020-09-13,Nebraska,31,38188,80,449,0,400684,3330,38108,267,362576,3063
2020-09-13,Nevada,32,73648,357,1454,1,642075,4173,73537,317,568538,3856
2020-09-13,New Hampshire,33,7696,44,436,1,230542,1518,7696,44,222846,1474
2020-09-13,New Jersey,34,198423,297,16031,4,3168530,27295,196634,297,2971896,26998
2020-09-13,New Mexico,35,26761,100,823,2,823145,5875,26761,100,796384,5775
2020-09-13,New York,36,449072,725,32629,4,9318293,72668,444365,725,8873928,71943
2020-09-13,North Carolina,37,185325,1020,3080,7,2616108,34976,184936,1196,2431172,33780
2020-09-13,North Dakota,38,15580,426,171,1,218606,2025,15577,426,203029,1599
2020-09-13,Northern Mariana Islands,69,60,0,2,0,14376,0,60,0,14316,0
2020-09-13,Ohio,39,137405,837,4415,4,2593830,26819,137405,837,2456425,25982
2020-09-13,Oklahoma,40,69354,695,905,6,989530,695,69354,695,920176,0
2020-09-13,Oregon,41,29337,181,509,4,612620,2516,29337,181,583283,2335
2020-09-13,Pennsylvania,42,148635,0,7915,0,1807881,76,143881,76,1664000,0
2020-09-13,Puerto Rico,72,37380,288,539,4,323741,171,17769,171,305972,0
2020-09-13,Rhode Island,44,22905,0,1071,0,307483,1347,23098,99,284385,1248
2020-09-13,South Carolina,45,131864,1886,3064,24,1071863,16991,131864,1886,939999,15105
2020-09-13,South Dakota,46,16638,201,184,1,163956,1347,16638,201,147318,1146
2020-09-13,Tennessee,47,169310,758,2055,15,2456149,13415,171824,933,2284325,12482
2020-09-13,Texas,48,689941,4020,14458,74,5550139,30498,659434,1845,4890705,28653
2020-09-13,Utah,49,57892,616,434,0,711973,3742,57875,628,654098,3114
2020-09-13,Vermont,50,1684,7,58,0,149125,901,1684,7,147441,894
2020-09-13,Virgin Islands,78,1220,0,19,0,18343,120,1220,9,17123,111
2020-09-13,Virginia,51,133814,874,2724,2,1766238,16128,133814,874,1632424,15254
2020-09-13,Washington,53,83177,220,2079,0,1644585,13423,79826,350,1564759,13073
2020-09-13,West Virginia,54,12699,178,266,1,483764,4888,12699,178,471065,4710
2020-09-13,Wisconsin,55,94723,1621,1219,1,1365137,7777,94679,1624,1270458,6153
2020-09-13,Wyoming,56,4346,49,42,0,86437,49,4346,49,82091,0
2020-09-14,Alabama,01,139459,704,2355,4,1027551,4364,139459,704,888092,3660
2020-09-14,Alaska,02,7213,77,41,0,403413,2200,6350,75,397063,2125
2020-09-14,Arizona,04,208726,212,5322,0,1300664,4527,208725,213,1091939,4314
2020-09-14,Arkansas,05,70627,408,992,11,828267,6199,70627,408,757640,5791
2020-09-14,California,06,767062,3673,14458,72,12806189,116173,757778,2855,12048411,113318
2020-09-14,Colorado,08,62032,391,2000,6,790757,6227,61699,375,729058,5852
2020-09-14,Connecticut,09,54895,569,4485,5,1379988,49004,54895,569,1325093,48435
2020-09-14,Delaware,10,18937,88,617,2,262504,1208,18937,88,243567,1120
2020-09-14,District of Columbia,11,14622,30,616,0,332148,1507,14622,30,317526,1477
2020-09-14,Florida,12,665722,1736,12641,34,4933481,17060,658203,1718,4275278,15342
2020-09-14,Georgia,13,278699,984,6211,20,2615247,13045,295337,1023,2319910,12022
2020-09-14,Guam,66,2896,64,27,3,43894,531,1927,36,41967,495
2020-09-14,Hawaii,15,10887,79,98,0,259665,4132,10834,112,248831,4020
2020-09-14,Idaho,16,35984,291,420,4,278613,1490,35279,112,243334,1378
2020-09-14,Illinois,17,265869,1529,8571,9,4773891,35930,264839,1373,4509052,34557
2020-09-14,Indiana,18,108755,735,3439,1,1247293,8309,106540,736,1140753,7573
2020-09-14,Iowa,19,75069,394,1233,13,686636,3191,72876,386,613760,2805
2020-09-14,Kansas,20,50871,1463,546,10,458381,9451,49899,1513,408482,7938
2020-09-14,Kentucky,21,61182,575,1105,3,996575,65823,57282,337,939293,65486
2020-09-14,Louisiana,22,158882,492,5252,17,2079299,12569,158882,492,1920417,12077
2020-09-14,Maine,23,4903,40,136,0,333777,3609,4903,40,328874,3569
2020-09-14,Maryland,24,117147,547,3839,1,1464863,9018,116646,536,1348217,8482
2020-09-14,Massachusetts,25,125080,254,9219,9,1970175,12220,125080,254,1845095,11966
2020-09-14,Michigan,26,124276,1201,6922,10,3162087,51477,124287,1229,3037800,50248
2020-09-14,Minnesota,27,85001,638,1974,3,1243355,10050,84949,638,1158406,9412
2020-09-14,Mississippi,28,90018,144,2706,9,625806,3013,90018,144,535788,2869
2020-09-14,Missouri,29,106057,1454,1812,0,1145207,16507,104079,1332,1041128,15175
2020-09-14,Montana,30,9164,127,139,3,285870,5746,9107,86,276763,5660
2020-09-14,Nebraska,31,38642,454,450,1,403965,3281,38335,227,365630,3054
2020-09-14,Nevada,32,73889,241,1456,2,644871,2796,73814,277,571057,2519
2020-09-14,New Hampshire,33,7714,18,436,0,231816,1274,7714,18,224102,1256
2020-09-14,New Jersey,34,198757,334,16034,3,3189970,21440,196968,334,2993002,21106
2020-09-14,New Mexico,35,26842,81,823,0,826619,3474,26842,81,799777,3393
2020-09-14,New York,36,449658,586,32639,10,9381651,63358,444948,583,8936703,62775
2020-09-14,North Carolina,37,186447,1122,3094,14,2634819,18711,185781,845,2449038,17866
2020-09-14,North Dakota,38,15834,254,173,2,220230,1624,15831,254,204399,1370
2020-09-14,Northern Mariana Islands,69,61,1,2,0,14377,1,61,1,14316,0
2020-09-14,Ohio,39,138484,1079,4419,4,2623256,29426,138484,1079,2484772,28347
2020-09-14,Oklahoma,40,70223,869,905,0,990399,869,70223,869,920176,0
2020-09-14,Oregon,41,29488,151,511,2,614804,2184,29484,147,585320,2037
2020-09-14,Pennsylvania,42,150044,1409,7940,25,1829672,21791,145063,1182,1684609,20609
2020-09-14,Puerto Rico,72,37750,370,542,3,323949,208,17977,208,305972,0
2020-09-14,Rhode Island,44,23130,225,1075,4,308197,714,23130,32,285067,682
2020-09-14,South Carolina,45,132680,816,3077,13,1088473,16610,132680,816,955793,15794
2020-09-14,South Dakota,46,16801,163,184,0,165139,1183,16801,163,148338,1020
2020-09-14,Tennessee,47,171498,2188,2073,18,2492851,36702,174274,2450,2318577,34252
2020-09-14,Texas,48,694547,4606,14508,50,5213247,-336892,663445,4011,4549802,-340903
2020-09-14,Utah,49,58451,559,436,2,714922,2949,58438,563,656484,2386
2020-09-14,Vermont,50,1696,12,58,0,149882,757,1695,11,148187,746
2020-09-14,Virgin Islands,78,1221,1,19,0,18351,8,1221,1,17130,7
2020-09-14,Virginia,51,134571,757,2743,19,1779329,13091,134571,757,1644758,12334
2020-09-14,Washington,53,83861,684,2095,16,1653967,9382,80138,312,1573829,9070
2020-09-14,West Virginia,54,12820,121,275,9,488015,4251,12820,121,475195,4130
2020-09-14,Wisconsin,55,95564,841,1219,0,1369104,3967,95497,818,1273607,3149
2020-09-14,Wyoming,56,4392,46,46,4,89006,2569,4392,46,84614,2523
2020-09-15,Alabama,01,140160,701,2387,32,1032970,5419,140160,701,892810,4718
2020-09-15,Alaska,02,7256,43,41,0,407124,3711,6393,43,400731,3668
2020-09-15,Arizona,04,209215,489,5346,24,1312304,11640,209209,484,1103095,11156
2020-09-15,Arkansas,05,71497,870,1150,158,872116,43849,71357,730,800759,43119
2020-09-15,California,06,769917,2855,14606,148,12928170,121981,760013,2235,12168157,119746
2020-09-15,Colorado,08,62575,543,2006,6,795733,4976,62099,400,733634,4576
2020-09-15,Connecticut,09,55031,136,4485,0,1390771,10783,55031,136,1335740,10647
2020-09-15,Delaware,10,19137,200,618,1,264159,1655,19137,200,245022,1455
2020-09-15,District of Columbia,11,14687,65,616,0,336280,4132,14687,65,321593,4067
2020-09-15,Florida,12,668838,3116,12786,145,4960947,27466,660946,2743,4300001,24723
2020-09-15,Georgia,13,280356,1657,6255,44,2629090,13843,296833,1496,2332257,12347
2020-09-15,Guam,66,2935,39,29,2,44329,435,1966,39,42363,396
2020-09-15,Hawaii,15,10951,64,99,1,262041,2376,10913,79,251128,2297
2020-09-15,Idaho,16,36306,322,425,5,280170,1557,35532,253,244638,1304
2020-09-15,Illinois,17,267380,1511,8589,18,4812922,39031,266305,1466,4546617,37565
2020-09-15,Indiana,18,109445,690,3460,21,1254731,7438,107229,689,1147502,6749
2020-09-15,Iowa,19,75722,653,1234,1,689612,2976,73277,401,616335,2575
2020-09-15,Kansas,20,51006,135,555,9,458381,0,49899,0,408482,0
2020-09-15,Kentucky,21,61986,804,1112,7,1006439,9864,58000,718,948439,9146
2020-09-15,Louisiana,22,159253,371,5278,26,2091958,12659,159253,371,1932705,12288
2020-09-15,Maine,23,4918,15,137,1,336489,2712,4918,15,331571,2697
2020-09-15,Maryland,24,117745,598,3849,10,1472782,7919,117245,599,1355537,7320
2020-09-15,Massachusetts,25,125393,313,9225,6,1981998,11823,125393,313,1856605,11510
2020-09-15,Michigan,26,124978,702,6933,11,3187621,25534,124969,682,3062652,24852
2020-09-15,Minnesota,27,85403,402,1979,5,1247867,4512,85351,402,1162516,4110
2020-09-15,Mississippi,28,90523,505,2734,28,626311,505,90523,505,535788,0
2020-09-15,Missouri,29,107687,1630,1830,18,1155752,10545,105396,1317,1050356,9228
2020-09-15,Montana,30,9281,117,141,2,289368,3498,9244,137,280124,3361
2020-09-15,Nebraska,31,38970,328,451,1,406675,2710,38642,307,368033,2403
2020-09-15,Nevada,32,74129,240,1484,28,646536,1665,74040,226,572496,1439
2020-09-15,New Hampshire,33,7748,34,438,2,232458,642,7748,34,224710,608
2020-09-15,New Jersey,34,199193,436,16043,9,3212311,22341,197404,436,3014907,21905
2020-09-15,New Mexico,35,26923,81,830,7,831995,5376,26923,81,805072,5295
2020-09-15,New York,36,450425,767,32655,16,9455329,73678,445714,766,9009615,72912
2020-09-15,North Carolina,37,187486,1039,3135,41,2652440,17621,186887,1106,2465553,16515
2020-09-15,North Dakota,38,16067,233,175,2,220645,415,16064,233,204581,182
2020-09-15,Northern Mariana Islands,69,61,0,2,0,14377,0,61,0,14316,0
2020-09-15,Ohio,39,139485,1001,4506,87,2659531,36275,139485,1001,2520046,35274
2020-09-15,Oklahoma,40,71314,1091,912,7,1016508,26109,71314,1091,945194,25018
2020-09-15,Oregon,41,29664,176,519,8,618064,3260,29662,178,588402,3082
2020-09-15,Pennsylvania,42,151081,1037,7945,5,1841498,11826,146214,1151,1695284,10675
2020-09-15,Puerto Rico,72,38172,422,551,9,324178,229,18206,229,305972,0
2020-09-15,Rhode Island,44,23250,120,1078,3,310041,1844,23250,120,286791,1724
2020-09-15,South Carolina,45,133470,790,3098,21,1074737,-13736,133470,790,941267,-14526
2020-09-15,South Dakota,46,16994,193,184,0,166096,957,16994,193,149102,764
2020-09-15,Tennessee,47,172692,1194,2102,29,2515429,22578,175231,957,2340198,21621
2020-09-15,Texas,48,701509,6962,14661,153,5247542,34295,668746,5301,4578796,28994
2020-09-15,Utah,49,59017,566,436,0,720331,5409,59000,562,661331,4847
2020-09-15,Vermont,50,1702,6,58,0,150303,421,1702,7,148601,414
2020-09-15,Virgin Islands,78,1232,11,19,0,18545,194,1225,4,17320,190
2020-09-15,Virginia,51,135514,943,2839,96,1791808,12479,135514,943,1656294,11536
2020-09-15,Washington,53,84222,361,2107,12,1665715,11748,80465,327,1585250,11421
2020-09-15,West Virginia,54,12976,156,280,5,490646,2631,12976,156,477670,2475
2020-09-15,Wisconsin,55,97002,1438,1230,11,1381463,12359,96938,1441,1284525,10918
2020-09-15,Wyoming,56,4438,46,46,0,89745,739,4438,46,85307,693
2020-09-16,Alabama,01,141087,927,2392,5,1040771,7801,141087,927,899684,6874
2020-09-16,Alaska,02,7308,52,41,0,408564,1440,6443,50,402121,1390
2020-09-16,Arizona,04,209911,696,5376,30,1328461,16157,209907,698,1118554,15459
2020-09-16,Arkansas,05,72219,722,1157,7,846177,-25939,72219,862,773958,-26801
2020-09-16,California,06,773318,3401,14716,110,13000522,72352,762963,2950,12237559,69402
2020-09-16,Colorado,08,63068,493,2010,4,801922,6189,62686,587,739236,5602
2020-09-16,Connecticut,09,55166,135,4487,2,1394405,3634,55166,135,1339239,3499
2020-09-16,Delaware,10,19234,97,619,1,265905,1746,19234,97,246671,1649
2020-09-16,District of Columbia,11,14743,56,617,1,338241,1961,14743,56,323498,1905
2020-09-16,Florida,12,671193,2355,12938,152,4976056,15109,663234,2288,4312822,12821
2020-09-16,Georgia,13,282363,2007,6276,21,2654121,25031,299056,2223,2355065,22808
2020-09-16,Guam,66,2982,47,29,0,44851,522,2013,47,42838,475
2020-09-16,Hawaii,15,11052,101,102,3,263142,1101,10978,65,252164,1036
2020-09-16,Idaho,16,36594,288,430,5,281642,1472,35810,278,245832,1194
2020-09-16,Illinois,17,269282,1902,8622,33,4865233,52311,268246,1941,4596987,50370
2020-09-16,Indiana,18,110025,580,3472,12,1261892,7161,107809,580,1154083,6581
2020-09-16,Iowa,19,76680,958,1248,14,695111,5499,74080,803,621031,4696
2020-09-16,Kansas,20,51829,823,586,31,464226,5845,50870,971,413356,4874
2020-09-16,Kentucky,21,62723,737,1118,6,1027779,21340,58764,764,969015,20576
2020-09-16,Louisiana,22,159865,612,5294,16,2115184,23226,159865,612,1955319,22614
2020-09-16,Maine,23,4941,23,138,1,342187,5698,4941,23,337246,5675
2020-09-16,Maryland,24,118387,642,3855,6,1482958,10176,117888,643,1365070,9533
2020-09-16,Massachusetts,25,125699,306,9245,20,1998641,16643,125699,306,1872942,16337
2020-09-16,Michigan,26,125782,804,6944,11,3218461,30840,125742,773,3092719,30067
2020-09-16,Minnesota,27,85865,462,1985,6,1252392,4525,85813,462,1166579,4063
2020-09-16,Mississippi,28,91234,711,2756,22,632731,6420,91234,711,541497,5709
2020-09-16,Missouri,29,108997,1310,1844,14,1164383,8631,106587,1191,1057796,7440
2020-09-16,Montana,30,9487,206,141,0,292401,3033,9431,187,282970,2846
2020-09-16,Nebraska,31,39419,449,455,4,408961,2286,38970,328,369991,1958
2020-09-16,Nevada,32,74377,248,1496,12,649533,2997,74248,208,575285,2789
2020-09-16,New Hampshire,33,7780,32,438,0,233731,1273,7780,32,225951,1241
2020-09-16,New Jersey,34,199583,390,16054,11,3234972,22661,197792,388,3037180,22273
2020-09-16,New Mexico,35,27041,118,832,2,837400,5405,27041,118,810359,5287
2020-09-16,New York,36,451078,653,32662,7,9530416,75087,446366,652,9084050,74435
2020-09-16,North Carolina,37,188800,1314,3176,41,2683384,30944,188024,1137,2495360,29807
2020-09-16,North Dakota,38,16336,269,180,5,222057,1412,16333,269,205724,1143
2020-09-16,Northern Mariana Islands,69,61,0,2,0,14377,0,61,0,14316,0
2020-09-16,Ohio,39,140518,1033,4555,49,2689480,29949,140518,1033,2548962,28916
2020-09-16,Oklahoma,40,72284,970,924,12,1027596,11088,72284,970,955312,10118
2020-09-16,Oregon,41,29856,192,521,2,621273,3209,29850,188,591423,3021
2020-09-16,Pennsylvania,42,151889,808,7963,18,1855121,13623,146990,776,1708131,12847
2020-09-16,Puerto Rico,72,38284,112,570,19,324224,46,18252,46,305972,0
2020-09-16,Rhode Island,44,23358,108,1081,3,311344,1303,23358,108,287986,1195
2020-09-16,South Carolina,45,134122,652,3132,34,1080922,6185,134122,652,946800,5533
2020-09-16,South Dakota,46,17291,297,192,8,169655,3559,17291,297,152364,3262
2020-09-16,Tennessee,47,174400,1708,2127,25,2543236,27807,177087,1856,2366149,25951
2020-09-16,Texas,48,706034,4525,14803,142,5299620,52078,674772,6026,4624848,46052
2020-09-16,Utah,49,59770,753,437,1,726490,6159,59747,747,666743,5412
2020-09-16,Vermont,50,1702,0,58,0,150652,349,1704,2,148948,347
2020-09-16,Virgin Islands,78,1232,0,19,0,18672,127,1232,7,17440,120
2020-09-16,Virginia,51,136359,845,2884,45,1806247,14439,136359,845,1669888,13594
2020-09-16,Washington,53,84714,492,2113,6,1676702,10987,80812,347,1595890,10640
2020-09-16,West Virginia,54,13196,220,290,10,493883,3237,13196,220,480687,3017
2020-09-16,Wisconsin,55,98501,1499,1238,8,1393753,12290,98440,1502,1295313,10788
2020-09-16,Wyoming,56,4566,128,46,0,89969,224,4566,128,85403,96
2020-09-17,Alabama,01,141757,670,2401,9,1044913,4142,141757,670,903156,3472
2020-09-17,Alaska,02,7413,105,41,0,415863,7299,6551,108,409312,7191
2020-09-17,Arizona,04,211663,1752,5411,35,1352882,24421,211660,1753,1141222,22668
2020-09-17,Arkansas,05,73211,992,1166,9,856918,10741,73211,992,783707,9749
2020-09-17,California,06,776944,3626,14807,91,13080037,79515,766201,3238,12313836,76277
2020-09-17,Colorado,08,63613,545,2016,6,809241,7319,63145,459,746096,6860
2020-09-17,Connecticut,09,55386,220,4488,1,1408273,13868,55386,220,1352887,13648
2020-09-17,Delaware,10,19318,84,619,0,267168,1263,19318,84,247850,1179
2020-09-17,District of Columbia,11,14790,47,619,2,341318,3077,14790,47,326528,3030
2020-09-17,Florida,12,674448,3255,13085,147,5003024,26968,666507,3273,4336517,23695
2020-09-17,Georgia,13,284219,1856,6328,52,2679891,25770,300903,1847,2378988,23923
2020-09-17,Guam,66,3014,32,31,2,45253,402,2045,32,43208,370
2020-09-17,Hawaii,15,11211,159,106,4,265634,2492,11080,102,254554,2390
2020-09-17,Idaho,16,36924,330,435,5,283365,1723,36093,283,247272,1440
2020-09-17,Illinois,17,271370,2088,8643,21,4923033,57800,270302,2056,4652731,55744
2020-09-17,Indiana,18,110863,838,3478,6,1269650,7758,108646,837,1161004,6921
2020-09-17,Iowa,19,77865,1185,1257,9,701438,6327,75028,948,626410,5379
2020-09-17,Kansas,20,52039,210,586,0,464226,0,50870,0,413356,0
2020-09-17,Kentucky,21,63412,689,1127,9,1038685,10906,59370,606,979315,10300
2020-09-17,Louisiana,22,160343,478,5311,17,2124190,9006,160343,478,1963847,8528
2020-09-17,Maine,23,4962,21,138,0,351378,9191,4962,21,346416,9170
2020-09-17,Maryland,24,119017,630,3861,6,1494342,11384,118519,631,1375823,10753
2020-09-17,Massachusetts,25,126128,429,9260,15,2026295,27654,126128,429,1900167,27225
2020-09-17,Michigan,26,126794,1012,6956,12,3251731,33270,126722,980,3125009,32290
2020-09-17,Minnesota,27,86774,909,1994,9,1263546,11154,86722,909,1176824,10245
2020-09-17,Mississippi,28,91935,701,2780,24,633432,701,91935,701,541497,0
2020-09-17,Missouri,29,110554,1557,1864,20,1178581,14198,108334,1747,1070247,12451
2020-09-17,Montana,30,9721,234,143,2,295299,2898,9647,216,285652,2682
2020-09-17,Nebraska,31,39921,502,457,2,412851,3890,39419,449,373432,3441
2020-09-17,Nevada,32,74792,415,1509,13,652583,3050,74595,347,577988,2703
2020-09-17,New Hampshire,33,7814,34,438,0,235510,1779,7814,34,227696,1745
2020-09-17,New Jersey,34,200152,569,16057,3,3265818,30846,198361,569,3067457,30277
2020-09-17,New Mexico,35,27199,158,836,4,845167,7767,27199,158,817968,7609
2020-09-17,New York,36,451971,893,32669,7,9621920,91504,447262,896,9174658,90608
2020-09-17,North Carolina,37,190307,1507,3208,32,2714175,30791,189576,1552,2524599,29239
2020-09-17,North Dakota,38,16726,390,185,5,223170,1113,16723,390,206447,723
2020-09-17,Northern Mariana Islands,69,62,1,2,0,14378,1,62,1,14316,0
2020-09-17,Ohio,39,141585,1067,4580,25,2718333,28853,141585,1067,2576748,27786
2020-09-17,Oklahoma,40,73318,1034,930,6,1039837,12241,73318,1034,966519,11207
2020-09-17,Oregon,41,30068,212,521,0,625424,4151,29850,0,595574,4151
2020-09-17,Pennsylvania,42,152813,924,7978,15,1869198,14077,147923,933,1721275,13144
2020-09-17,Puerto Rico,72,38867,583,588,18,324606,382,18634,382,305972,0
2020-09-17,Rhode Island,44,23488,130,1085,4,313275,1931,23488,130,289787,1801
2020-09-17,South Carolina,45,135446,1324,3158,26,1087587,6665,135446,1324,952141,5341
2020-09-17,South Dakota,46,17686,395,193,1,171523,1868,17686,395,153837,1473
2020-09-17,Tennessee,47,175702,1302,2141,14,2564879,21643,178140,1053,2386739,20590
2020-09-17,Texas,48,710423,4389,14909,106,5345176,45556,678819,4047,4666357,41509
2020-09-17,Utah,49,60662,892,437,0,732682,6192,60658,911,672024,5281
2020-09-17,Vermont,50,1705,3,58,0,151715,1063,1707,3,150008,1060
2020-09-17,Virgin Islands,78,1238,6,19,0,18779,107,1238,6,17541,101
2020-09-17,Virginia,51,137460,1101,2920,36,1828512,22265,137460,1101,1691052,21164
2020-09-17,Washington,53,85101,387,2123,10,1691047,14345,81198,386,1609849,13959
2020-09-17,West Virginia,54,13430,234,294,4,498283,4400,13430,234,484853,4166
2020-09-17,Wisconsin,55,100619,2118,1240,2,1405298,11545,100574,2134,1304724,9411
2020-09-17,Wyoming,56,4652,86,49,3,91452,1483,4652,86,86800,1397
2020-09-18,Alabama,01,142863,1106,2428,27,1053055,8142,142863,1106,910192,7036
2020-09-18,Alaska,02,7528,115,42,1,418293,2430,6658,107,411635,2323
2020-09-18,Arizona,04,213663,2000,5455,44,1362319,9437,212942,1282,1149377,8155
2020-09-18,Arkansas,05,74082,871,1173,7,868179,11261,74082,871,794097,10390
2020-09-18,California,06,781436,4492,14912,105,13177186,97149,769831,3630,12407355,93519
2020-09-18,Colorado,08,64277,664,2020,4,817869,8628,63750,605,754119,8023
2020-09-18,Connecticut,09,55527,141,4492,4,1422148,13875,55527,141,1366621,13734
2020-09-18,Delaware,10,19366,48,620,1,268638,1470,19366,48,249272,1422
2020-09-18,District of Columbia,11,14852,62,619,0,347118,5800,14852,62,332266,5738
2020-09-18,Florida,12,677652,3204,13224,139,5030285,27261,669684,3177,4360601,24084
2020-09-18,Georgia,13,286170,1951,6390,62,2701952,22061,302737,1834,2399215,20227
2020-09-18,Guam,66,3043,29,34,3,45653,400,2074,29,43579,371
2020-09-18,Hawaii,15,11348,137,119,13,269463,3829,11239,159,258224,3670
2020-09-18,Idaho,16,37358,434,439,4,285552,2187,36489,396,249063,1791
2020-09-18,Illinois,17,273596,2226,8666,23,4985054,62021,272525,2223,4712529,59798
2020-09-18,Indiana,18,111900,1037,3495,17,1281438,11788,109683,1037,1171755,10751
2020-09-18,Iowa,19,78839,974,1264,7,708031,6593,76211,1183,631820,5410
2020-09-18,Kansas,20,53403,1364,596,10,474749,10523,52285,1415,422464,9108
2020-09-18,Kentucky,21,64155,743,1132,5,1051851,13166,60128,758,991723,12408
2020-09-18,Louisiana,22,161322,979,5340,29,2146986,22796,161322,979,1985664,21817
2020-09-18,Maine,23,5005,43,138,0,364424,13046,5005,43,359419,13003
2020-09-18,Maryland,24,119559,542,3869,8,1504867,10525,119062,543,1385805,9982
2020-09-18,Massachusetts,25,126582,454,9269,9,2048535,22240,126582,454,1921953,21786
2020-09-18,Michigan,26,127558,764,6955,-1,3285030,33299,127500,778,3157530,32521
2020-09-18,Minnesota,27,87859,1085,2002,8,1278837,15291,87807,1085,1191030,14206
2020-09-18,Mississippi,28,92432,497,2792,12,633432,0,91935,0,541497,0
2020-09-18,Missouri,29,112547,1993,1892,28,1190380,11799,110129,1795,1080251,10004
2020-09-18,Montana,30,9934,213,146,3,298555,3256,9871,224,288684,3032
2020-09-18,Nebraska,31,40387,466,457,0,416575,3724,39921,502,376654,3222
2020-09-18,Nevada,32,75153,361,1526,17,656601,4018,75096,501,581505,3517
2020-09-18,New Hampshire,33,7861,47,438,0,237518,2008,7861,47,229657,1961
2020-09-18,New Jersey,34,200639,487,16061,4,3291916,26098,198848,487,3093068,25611
2020-09-18,New Mexico,35,27350,151,841,5,850963,5796,27350,151,823613,5645
2020-09-18,New York,36,452764,793,32682,13,9711647,89727,448052,790,9263595,88937
2020-09-18,North Carolina,37,191672,1365,3232,24,2749020,34845,191019,1443,2558001,33402
2020-09-18,North Dakota,38,17233,507,187,2,225193,2023,17230,507,207963,1516
2020-09-18,Northern Mariana Islands,69,62,0,2,0,14378,0,62,0,14316,0
2020-09-18,Ohio,39,142596,1011,4608,28,2753105,34772,142596,1011,2610509,33761
2020-09-18,Oklahoma,40,74567,1249,939,9,1054217,14380,74567,1249,979650,13131
2020-09-18,Oregon,41,30351,283,524,3,629422,3998,30342,492,599080,3506
2020-09-18,Pennsylvania,42,153560,747,8006,28,1881488,12290,148683,760,1732805,11530
2020-09-18,Puerto Rico,72,39684,817,599,11,325085,479,19113,479,305972,0
2020-09-18,Rhode Island,44,23620,132,1088,3,315555,2280,23620,132,291935,2148
2020-09-18,South Carolina,45,136318,872,3177,19,1111404,23817,136318,872,975086,22945
2020-09-18,South Dakota,46,18075,389,198,5,173704,2181,18075,389,155629,1792
2020-09-18,Tennessee,47,177707,2005,2173,32,2603342,38463,180497,2357,2422845,36106
2020-09-18,Texas,48,713652,3229,15037,128,5444801,99625,682241,3422,4762560,96203
2020-09-18,Utah,49,61786,1124,437,0,738980,6298,61775,1117,677205,5181
2020-09-18,Vermont,50,1706,1,58,0,152587,872,1709,2,150878,870
2020-09-18,Virgin Islands,78,1257,19,19,0,18954,175,1242,4,17712,171
2020-09-18,Virginia,51,138702,1242,2949,29,1838235,9723,138702,1242,1699533,8481
2020-09-18,Washington,53,85583,482,2130,7,1704670,13623,81602,404,1623068,13219
2020-09-18,West Virginia,54,13683,253,297,3,503133,4850,13683,253,489450,4597
2020-09-18,Wisconsin,55,103211,2592,1247,7,1418412,13114,103154,2580,1315258,10534
2020-09-18,Wyoming,56,4747,95,49,0,92307,855,4747,95,87560,760
2020-09-19,Alabama,01,144164,1301,2437,9,1062612,9557,144164,1301,918448,8256
2020-09-19,Alaska,02,7613,85,42,0,422850,4557,6752,94,416098,4463
2020-09-19,Arizona,04,213551,-112,5471,16,1373159,10840,213551,609,1159608,10231
2020-09-19,Arkansas,05,75160,1078,1181,8,869257,1078,75160,1078,794097,0
2020-09-19,California,06,785076,3640,15023,111,13343886,166700,774135,4304,12569751,162396
2020-09-19,Colorado,08,64694,417,2022,2,825702,7833,64356,606,761346,7227
2020-09-19,Connecticut,09,55527,0,4492,0,1422148,0,55527,0,1366621,0
2020-09-19,Delaware,10,19449,83,621,1,269711,1073,19449,83,250262,990
2020-09-19,District of Columbia,11,14902,50,619,0,350877,3759,14902,50,335975,3709
2020-09-19,Florida,12,681225,3573,13286,62,5060515,30230,673194,3510,4387321,26720
2020-09-19,Georgia,13,288059,1889,6450,60,2735389,33437,305021,2284,2430368,31153
2020-09-19,Guam,66,3043,0,35,1,45958,305,2117,43,43841,262
2020-09-19,Hawaii,15,11457,109,119,0,279899,10436,11376,137,268523,10299
2020-09-19,Idaho,16,37624,266,441,2,288195,2643,36959,470,251236,2173
2020-09-19,Illinois,17,276057,2461,8688,22,5059340,74286,275054,2529,4784286,71757
2020-09-19,Indiana,18,112982,1082,3503,8,1292615,11177,110759,1076,1181856,10101
2020-09-19,Iowa,19,79785,946,1265,1,713775,5744,77058,847,636717,4897
2020-09-19,Kansas,20,53420,17,596,0,474749,0,52285,0,422464,0
2020-09-19,Kentucky,21,65068,913,1137,5,1054776,2925,61106,978,993670,1947
2020-09-19,Louisiana,22,161322,0,5340,0,2146986,0,161322,0,1985664,0
2020-09-19,Maine,23,5035,30,139,1,371187,6763,5035,30,366152,6733
2020-09-19,Maryland,24,120107,548,3876,7,1518804,13937,119744,682,1399060,13255
2020-09-19,Massachusetts,25,127181,599,9295,26,2069863,21328,127181,599,1942682,20729
2020-09-19,Michigan,26,128112,554,6970,15,3318469,33439,128087,587,3190382,32852
2020-09-19,Minnesota,27,88773,914,2015,13,1291395,12558,88721,914,1202674,11644
2020-09-19,Mississippi,28,93087,655,2809,17,702886,69454,93087,1152,609799,68302
2020-09-19,Missouri,29,113794,1247,1905,13,1202624,12244,111516,1387,1091108,10857
2020-09-19,Montana,30,10193,259,156,10,300840,2285,10163,292,290677,1993
2020-09-19,Nebraska,31,40797,410,457,0,419995,3420,40387,466,379608,2954
2020-09-19,Nevada,32,75524,371,1528,2,660686,4085,75419,323,585267,3762
2020-09-19,New Hampshire,33,7920,59,438,0,238732,1214,7920,59,230812,1155
2020-09-19,New Jersey,34,201100,461,16064,3,3292377,461,199309,461,3093068,0
2020-09-19,New Mexico,35,27512,162,847,6,857456,6493,27512,162,829944,6331
2020-09-19,New York,36,453747,983,32679,-3,9822091,110444,449038,986,9373053,109458
2020-09-19,North Carolina,37,192751,1079,3260,28,2771020,22000,192248,1229,2578772,20771
2020-09-19,North Dakota,38,17610,377,195,8,226502,1309,17607,377,208895,932
2020-09-19,Northern Mariana Islands,69,68,6,2,0,14378,0,62,0,14316,0
2020-09-19,Ohio,39,143547,951,4612,4,2788695,35590,143547,951,2645148,34639
2020-09-19,Oklahoma,40,75804,1237,943,4,1071501,17284,75804,1237,995697,16047
2020-09-19,Oregon,41,30600,249,527,3,633910,4488,30599,257,603311,4231
2020-09-19,Pennsylvania,42,154261,701,8028,22,1896125,14637,149845,1162,1746280,13475
2020-09-19,Puerto Rico,72,40993,1309,605,6,325779,694,19807,694,305972,0
2020-09-19,Rhode Island,44,23620,0,1088,0,318016,2461,23798,178,294218,2283
2020-09-19,South Carolina,45,137240,922,3188,11,1123265,11861,137240,922,986025,10939
2020-09-19,South Dakota,46,18444,369,200,2,175221,1517,18444,369,156777,1148
2020-09-19,Tennessee,47,179017,1310,2193,20,2627087,23745,181439,942,2445648,22803
2020-09-19,Texas,48,716914,3262,15124,87,5563176,118375,686068,3827,4877108,114548
2020-09-19,Utah,49,62893,1107,440,3,746137,7157,62852,1077,683285,6080
2020-09-19,Vermont,50,1710,4,58,0,153246,659,1713,4,151533,655
2020-09-19,Virgin Islands,78,1257,0,19,0,18954,0,1242,0,17712,0
2020-09-19,Virginia,51,139655,953,2990,41,1873355,35120,139655,953,1733700,34167
2020-09-19,Washington,53,85886,303,2130,0,1704670,0,81602,0,1623068,0
2020-09-19,West Virginia,54,13874,191,308,11,509486,6353,13874,191,495612,6162
2020-09-19,Wisconsin,55,105609,2398,1249,2,1431004,12592,105557,2403,1325447,10189
2020-09-19,Wyoming,56,4780,33,49,0,92340,33,4780,33,87560,0
2020-09-20,Alabama,01,144962,798,2437,0,1068328,5716,144962,798,923366,4918
2020-09-20,Alaska,02,7704,91,42,0,426925,4075,6860,108,420065,3967
2020-09-20,Arizona,04,214018,467,5480,9,1383924,10765,214018,467,1169906,10298
2020-09-20,Arkansas,05,75723,563,1181,0,886017,16760,75723,563,810294,16197
2020-09-20,California,06,788077,3001,15018,-5,13523158,179272,778400,4265,12744758,175007
2020-09-20,Colorado,08,65248,554,2023,1,832709,7007,64857,501,767852,6506
2020-09-20,Connecticut,09,55527,0,4492,0,1422148,0,55527,0,1366621,0
2020-09-20,Delaware,10,19566,117,621,0,271421,1710,19566,117,251855,1593
2020-09-20,District of Columbia,11,14955,53,620,1,355144,4267,14955,53,340189,4214
2020-09-20,Florida,12,683746,2521,13295,9,5087026,26511,675691,2497,4411335,24014
2020-09-20,Georgia,13,289096,1037,6453,3,2750822,15433,306155,1134,2444667,14299
2020-09-20,Guam,66,3043,0,35,0,45958,0,2117,0,43841,0
2020-09-20,Hawaii,15,11534,77,119,0,280008,109,11485,109,268523,0
2020-09-20,Idaho,16,37768,144,443,2,289928,1733,37247,288,252681,1445
2020-09-20,Illinois,17,277373,1316,8700,12,5107351,48011,276456,1402,4830895,46609
2020-09-20,Indiana,18,113728,746,3506,3,1301940,9325,111505,746,1190435,8579
2020-09-20,Iowa,19,80410,625,1265,0,718279,4504,77679,621,640600,3883
2020-09-20,Kansas,20,53433,13,597,1,474749,0,52285,0,422464,0
2020-09-20,Kentucky,21,65413,345,1139,2,1055212,436,61542,436,993670,0
2020-09-20,Louisiana,22,162258,936,5366,26,2178999,32013,162258,936,2016741,31077
2020-09-20,Maine,23,5079,44,139,0,374138,2951,5079,44,369059,2907
2020-09-20,Maryland,24,120656,549,3879,3,1529476,10672,120156,412,1409320,10260
2020-09-20,Massachusetts,25,127540,359,9310,15,2087281,17418,127540,359,1959741,17059
2020-09-20,Michigan,26,128148,36,6971,1,3318469,0,128087,0,3190382,0
2020-09-20,Minnesota,27,90069,1296,2017,2,1303475,12080,90017,1296,1213458,10784
2020-09-20,Mississippi,28,93364,277,2810,1,703163,277,93364,277,609799,0
2020-09-20,Missouri,29,115000,1206,1896,-9,1212508,9884,112844,1328,1099664,8556
2020-09-20,Montana,30,10325,132,157,1,302813,1973,10299,136,292514,1837
2020-09-20,Nebraska,31,41083,286,457,0,423360,3365,40797,410,382563,2955
2020-09-20,Nevada,32,75914,390,1532,4,665184,4498,75804,385,589380,4113
2020-09-20,New Hampshire,33,7947,27,438,0,240401,1669,7947,27,232454,1642
2020-09-20,New Jersey,34,201553,453,16067,3,3352791,60414,199762,453,3153029,59961
2020-09-20,New Mexico,35,27579,67,849,2,862899,5443,27579,67,835320,5376
2020-09-20,New York,36,454612,865,32686,7,9922446,100355,449900,862,9472546,99493
2020-09-20,North Carolina,37,193978,1227,3270,10,2804818,33798,193581,1333,2611237,32465
2020-09-20,North Dakota,38,17961,351,195,0,228255,1753,17958,351,210297,1402
2020-09-20,Northern Mariana Islands,69,68,0,2,0,14384,6,68,6,14316,0
2020-09-20,Ohio,39,144309,762,4615,3,2825297,36602,144309,762,2680988,35840
2020-09-20,Oklahoma,40,76807,1003,946,3,1072504,1003,76807,1003,995697,0
2020-09-20,Oregon,41,30802,202,528,1,636069,2159,30801,202,605268,1957
2020-09-20,Pennsylvania,42,154924,663,8049,21,1908910,12785,150578,733,1758332,12052
2020-09-20,Puerto Rico,72,41838,845,608,3,326041,262,20069,262,305972,0
2020-09-20,Rhode Island,44,23620,0,1088,0,319803,1787,23880,82,295923,1705
2020-09-20,South Carolina,45,137708,468,3199,11,1132595,9330,137708,468,994887,8862
2020-09-20,South Dakota,46,18696,252,202,2,176353,1132,18696,252,157657,880
2020-09-20,Tennessee,47,180621,1604,2195,2,2667126,40039,183514,2075,2483612,37964
2020-09-20,Texas,48,722460,5546,15159,35,5593488,30312,688534,2466,4904954,27846
2020-09-20,Utah,49,63774,881,440,0,752105,5968,63772,920,688333,5048
2020-09-20,Vermont,50,1715,5,58,0,154201,955,1718,5,152483,950
2020-09-20,Virgin Islands,78,1269,12,19,0,19312,358,1269,27,18043,331
2020-09-20,Virginia,51,140511,856,3015,25,1888817,15462,140511,856,1748306,14606
2020-09-20,Washington,53,86169,283,2130,0,1723040,18370,82199,597,1640841,17773
2020-09-20,West Virginia,54,14054,180,310,2,514304,4818,14054,180,500250,4638
2020-09-20,Wisconsin,55,107343,1734,1250,1,1439394,8390,107292,1735,1332102,6655
2020-09-20,Wyoming,56,4871,91,49,0,92431,91,4871,91,87560,0
2020-09-21,Alabama,01,145780,818,2439,2,1073892,5564,145780,818,928112,4746
2020-09-21,Alaska,02,7775,71,42,0,428645,1720,6930,70,421715,1650
2020-09-21,Arizona,04,214251,233,5482,2,1390962,7038,214251,233,1176711,6805
2020-09-21,Arkansas,05,76364,641,1197,16,893602,7585,76364,641,817238,6944
2020-09-21,California,06,792217,4140,15069,51,13672782,149624,781694,3294,12891088,146330
2020-09-21,Colorado,08,65936,688,2031,8,838884,6175,65399,542,773485,5633
2020-09-21,Connecticut,09,56024,497,4495,3,1467766,45618,56024,497,1411742,45121
2020-09-21,Delaware,10,19667,101,627,6,273213,1792,19667,101,253546,1691
2020-09-21,District of Columbia,11,14978,23,621,1,357744,2600,14978,23,342766,2577
2020-09-21,Florida,12,685431,1685,13316,21,5105183,18157,677362,1671,4427821,16486
2020-09-21,Georgia,13,289975,879,6455,2,2770863,20041,307339,1184,2463524,18857
2020-09-21,Guam,66,3116,73,36,1,46354,396,2147,30,44207,366
2020-09-21,Hawaii,15,11590,56,119,0,281577,1569,11562,77,270015,1492
2020-09-21,Idaho,16,38196,428,447,4,292286,2358,37491,244,254795,2114
2020-09-21,Illinois,17,279032,1659,8717,17,5145585,38234,277933,1477,4867652,36757
2020-09-21,Indiana,18,114251,523,3512,6,1308645,6705,112027,522,1196618,6183
2020-09-21,Iowa,19,81006,596,1284,19,721595,3316,78339,660,643256,2656
2020-09-21,Kansas,20,54956,1523,604,7,484691,9942,53959,1674,430732,8268
2020-09-21,Kentucky,21,65905,492,1141,2,1065404,10192,61917,375,1003487,9817
2020-09-21,Louisiana,22,162501,243,5375,9,2185792,6793,162501,243,2023291,6550
2020-09-21,Maine,23,5106,27,140,1,375392,1254,5106,27,370286,1227
2020-09-21,Maryland,24,121068,412,3883,4,1537629,8153,120568,412,1417061,7741
2020-09-21,Massachusetts,25,127796,256,9317,7,2098116,10835,127796,256,1970320,10579
2020-09-21,Michigan,26,129655,1507,6982,11,3370667,52198,129662,1575,3241005,50623
2020-09-21,Minnesota,27,90994,925,2021,4,1312937,9462,90942,925,1221995,8537
2020-09-21,Mississippi,28,93556,192,2810,0,706906,3743,93556,192,613350,3551
2020-09-21,Missouri,29,116814,1814,1936,40,1219559,7051,114307,1463,1105252,5588
2020-09-21,Montana,30,10509,184,160,3,311262,8449,10429,130,300833,8319
2020-09-21,Nebraska,31,41388,305,464,7,425816,2456,41083,286,384733,2170
2020-09-21,Nevada,32,76119,205,1531,-1,666792,1608,76036,232,590756,1376
2020-09-21,New Hampshire,33,7952,5,438,0,242242,1841,7952,5,234290,1836
2020-09-21,New Jersey,34,201945,392,16069,2,3353183,392,200154,392,3153029,0
2020-09-21,New Mexico,35,27683,104,851,2,866683,3784,27683,104,839000,3680
2020-09-21,New York,36,455187,575,32691,5,9980765,58319,450473,573,9530292,57746
2020-09-21,North Carolina,37,195093,1115,3283,13,2817539,12721,194381,800,2623158,11921
2020-09-21,North Dakota,38,18247,286,196,1,229511,1256,18244,286,211267,970
2020-09-21,Northern Mariana Islands,69,69,1,2,0,14385,1,69,1,14316,0
2020-09-21,Ohio,39,145165,856,4623,8,2856161,30864,145165,856,2710996,30008
2020-09-21,Oklahoma,40,77908,1101,948,2,1073605,1101,77908,1101,995697,0
2020-09-21,Oregon,41,30999,197,532,4,638798,2729,30995,194,607803,2535
2020-09-21,Pennsylvania,42,155729,805,8080,31,1917993,9083,150812,234,1767181,8849
2020-09-21,Puerto Rico,72,42476,638,609,1,326283,242,20311,242,305972,0
2020-09-21,Rhode Island,44,23932,312,1097,9,320566,763,23932,52,296634,711
2020-09-21,South Carolina,45,138124,416,3212,13,1144118,11523,138124,416,1005994,11107
2020-09-21,South Dakota,46,18869,173,202,0,177023,670,18869,173,158154,497
2020-09-21,Tennessee,47,181725,1104,2209,14,2679406,12280,184409,895,2494997,11385
2020-09-21,Texas,48,744736,22276,15212,53,5622498,29010,698387,9853,4924111,19157
2020-09-21,Utah,49,64404,630,441,1,756090,3985,64394,622,691696,3363
2020-09-21,Vermont,50,1719,4,58,0,155039,838,1722,4,153317,834
2020-09-21,Virgin Islands,78,1269,0,19,0,19312,0,1269,0,18043,0
2020-09-21,Virginia,51,141138,627,3021,6,1905474,16657,141138,627,1764336,16030
2020-09-21,Washington,53,86803,634,2137,7,1736556,13516,82548,349,1654008,13167
2020-09-21,West Virginia,54,14171,117,312,2,519516,5212,14171,117,505345,5095
2020-09-21,Wisconsin,55,108656,1313,1253,3,1446215,6821,108588,1296,1337627,5525
2020-09-21,Wyoming,56,4944,73,49,0,94131,1700,4944,73,89187,1627
2020-09-22,Alabama,01,146584,804,2457,18,1080149,6257,146584,804,933565,5453
2020-09-22,Alaska,02,7821,46,42,0,431191,2546,6987,57,424204,2489
2020-09-22,Arizona,04,214846,595,5501,19,1400654,9692,214846,595,1185808,9097
2020-09-22,Arkansas,05,76981,617,1209,12,900206,6604,76981,617,823225,5987
2020-09-22,California,06,795077,2860,15209,140,13804055,131273,784324,2630,13019731,128643
2020-09-22,Colorado,08,66552,616,2034,3,845111,6227,66053,654,779058,5573
2020-09-22,Connecticut,09,56160,136,4496,1,1479824,12058,56160,136,1423664,11922
2020-09-22,Delaware,10,19761,94,628,1,274837,1624,19761,94,255076,1530
2020-09-22,District of Columbia,11,15021,43,621,0,361633,3889,15021,43,346612,3846
2020-09-22,Florida,12,687901,2470,13415,99,5124209,19026,679776,2414,4444433,16612
2020-09-22,Georgia,13,290930,955,6524,69,2783427,12564,308221,882,2475206,11682
2020-09-22,Guam,66,3159,43,38,2,46828,474,2190,43,44638,431
2020-09-22,Hawaii,15,11653,63,119,0,282739,1162,11618,56,271121,1106
2020-09-22,Idaho,16,38676,480,452,5,294071,1785,37901,410,256170,1375
2020-09-22,Illinois,17,280511,1479,8741,24,5187414,41829,279464,1531,4907950,40298
2020-09-22,Indiana,18,114864,613,3520,8,1315440,6795,112626,599,1202814,6196
2020-09-22,Iowa,19,81674,668,1293,9,725082,3487,78887,548,646195,2939
2020-09-22,Kansas,20,55237,281,618,14,484691,0,53959,0,430732,0
2020-09-22,Kentucky,21,66624,719,1148,7,1075620,10216,62731,814,1012889,9402
2020-09-22,Louisiana,22,163253,752,5386,11,2206974,21182,163253,752,2043721,20430
2020-09-22,Maine,23,5146,40,140,0,375432,40,5146,40,370286,0
2020-09-22,Maryland,24,121409,341,3895,12,1544014,6385,120912,344,1423102,6041
2020-09-22,Massachusetts,25,127969,173,9328,11,2107281,9165,127969,173,1979312,8992
2020-09-22,Michigan,26,130406,751,6998,16,3390878,20211,130357,695,3260521,19516
2020-09-22,Minnesota,27,91474,480,2031,10,1317433,4496,91422,480,1226011,4016
2020-09-22,Mississippi,28,94021,465,2846,36,712501,5595,94021,465,618480,5130
2020-09-22,Missouri,29,118574,1760,1974,38,1241749,22190,115366,1059,1126383,21131
2020-09-22,Montana,30,10792,283,163,3,314009,2747,10700,271,303309,2476
2020-09-22,Nebraska,31,41828,440,473,9,428046,2230,41388,305,386658,1925
2020-09-22,Nevada,32,76376,257,1546,15,669074,2282,76298,262,592776,2020
2020-09-22,New Hampshire,33,7990,38,438,0,243527,1285,7990,38,235537,1247
2020-09-22,New Jersey,34,202371,426,16076,7,3397649,44466,200580,426,3197069,44040
2020-09-22,New Mexico,35,27790,107,854,3,872331,5648,27790,107,844541,5541
2020-09-22,New York,36,455938,751,32690,-1,10064762,83997,451227,754,9613535,83243
2020-09-22,North Carolina,37,196258,1165,3320,37,2824929,7390,195549,1168,2629380,6222
2020-09-22,North Dakota,38,18511,264,199,3,230070,559,18508,264,211562,295
2020-09-22,Northern Mariana Islands,69,69,0,2,0,14385,0,69,0,14316,0
2020-09-22,Ohio,39,145850,685,4635,12,2888787,32626,145850,685,2742937,31941
2020-09-22,Oklahoma,40,79072,1164,962,14,1101839,28234,79072,1164,1022767,27070
2020-09-22,Oregon,41,31323,324,535,3,642581,3783,31313,318,611268,3465
2020-09-22,Pennsylvania,42,156512,783,8099,19,1929562,11569,151646,834,1777916,10735
2020-09-22,Puerto Rico,72,42596,120,613,4,326371,88,20399,88,305972,0
2020-09-22,Rhode Island,44,24044,112,1099,2,322391,1825,24044,112,298347,1713
2020-09-22,South Carolina,45,140789,2665,3243,31,1172484,28366,140789,2665,1031695,25701
2020-09-22,South Dakota,46,19189,320,202,0,178346,1323,19189,320,159157,1003
2020-09-22,Tennessee,47,182546,821,2236,27,2691404,11998,185148,739,2506256,11259
2020-09-22,Texas,48,749069,4333,15322,110,5667732,45234,716207,17820,4951525,27414
2020-09-22,Utah,49,65058,654,443,2,762359,6269,65044,650,697315,5619
2020-09-22,Vermont,50,1721,2,58,0,155551,512,1724,2,153827,510
2020-09-22,Virgin Islands,78,1278,9,19,0,19464,152,1276,7,18188,145
2020-09-22,Virginia,51,142010,872,3060,39,1918489,13015,142010,872,1776479,12143
2020-09-22,Washington,53,87233,430,2163,26,1740899,4343,83193,645,1657706,3698
2020-09-22,West Virginia,54,14384,213,317,5,522669,3153,14384,213,508285,2940
2020-09-22,Wisconsin,55,110393,1737,1259,6,1458819,12604,110327,1739,1348492,10865
2020-09-22,Wyoming,56,5016,72,49,0,94840,709,5016,72,89824,637
2020-09-23,Alabama,01,147153,569,2488,31,1085604,5455,147153,569,938451,4886
2020-09-23,Alaska,02,7875,54,42,0,433198,2007,7063,76,426135,1931
2020-09-23,Arizona,04,215284,438,5526,25,1409866,9212,215284,438,1194582,8774
2020-09-23,Arkansas,05,77963,982,1229,20,909264,9058,77963,982,831301,8076
2020-09-23,California,06,798350,3273,15313,104,13879423,75368,787470,3146,13091953,72222
2020-09-23,Colorado,08,67186,634,2038,4,853592,8481,66669,616,786923,7865
2020-09-23,Connecticut,09,56315,155,4497,1,1489898,10074,56315,155,1433583,9919
2020-09-23,Delaware,10,19830,69,629,1,276044,1207,19830,69,256214,1138
2020-09-23,District of Columbia,11,15050,29,621,0,363448,1815,15050,29,348398,1786
2020-09-23,Florida,12,690491,2590,13617,202,5147851,23642,682370,2594,4465481,21048
2020-09-23,Georgia,13,292797,1867,6620,96,2803215,19788,309678,1457,2493537,18331
2020-09-23,Guam,66,3204,45,38,0,47251,423,2235,45,45016,378
2020-09-23,Hawaii,15,11820,167,121,2,284228,1489,11681,63,272547,1426
2020-09-23,Idaho,16,39030,354,454,2,295401,1330,38347,446,257054,884
2020-09-23,Illinois,17,282331,1820,8762,21,5233805,46391,281312,1848,4952493,44543
2020-09-23,Indiana,18,115578,714,3530,10,1322819,7379,113337,711,1209482,6668
2020-09-23,Iowa,19,82956,1282,1298,5,731853,6771,79923,1036,651930,5735
2020-09-23,Kansas,20,56355,1118,629,11,492281,7590,55226,1267,437055,6323
2020-09-23,Kentucky,21,67590,966,1161,13,1224142,148522,63517,786,1160625,147736
2020-09-23,Louisiana,22,163869,616,5407,21,2220009,13035,163869,616,2056140,12419
2020-09-23,Maine,23,5171,25,140,0,386035,10603,5171,25,380864,10578
2020-09-23,Maryland,24,121793,384,3902,7,1552105,8091,121297,385,1430808,7706
2020-09-23,Massachusetts,25,128512,543,9347,19,2127944,20663,128512,543,1999432,20120
2020-09-23,Michigan,26,131292,886,7013,15,3425107,34229,131259,902,3293848,33327
2020-09-23,Minnesota,27,92152,678,2037,6,1323951,6518,92100,678,1231851,5840
2020-09-23,Mississippi,28,94573,552,2870,24,716711,4210,94573,552,622138,3658
2020-09-23,Missouri,29,120124,1550,2035,61,1244563,2814,116946,1580,1127617,1234
2020-09-23,Montana,30,11034,242,165,2,317160,3151,10912,212,306248,2939
2020-09-23,Nebraska,31,42278,450,477,4,431102,3056,41785,397,389317,2659
2020-09-23,Nevada,32,76907,531,1556,10,671924,2850,76807,509,595117,2341
2020-09-23,New Hampshire,33,8007,17,438,0,244489,962,8007,17,236482,945
2020-09-23,New Jersey,34,202779,408,16082,6,3422747,25098,200988,408,3221759,24690
2020-09-23,New Mexico,35,27987,197,857,3,878406,6075,27987,197,850419,5878
2020-09-23,New York,36,456604,666,32691,1,10135692,70930,451892,665,9683800,70265
2020-09-23,North Carolina,37,197431,1173,3345,25,2842427,17498,196501,952,2645926,16546
2020-09-23,North Dakota,38,18984,473,206,7,231852,1782,18981,473,212871,1309
2020-09-23,Northern Mariana Islands,69,69,0,2,0,14845,460,69,0,14776,460
2020-09-23,Ohio,39,146753,903,4687,52,2931199,42412,146753,903,2784446,41509
2020-09-23,Oklahoma,40,80161,1089,970,8,1114326,12487,80161,1089,1034165,11398
2020-09-23,Oregon,41,31513,190,538,3,646125,3544,31503,190,614622,3354
2020-09-23,Pennsylvania,42,157373,861,8137,38,1942956,13394,152544,898,1790412,12496
2020-09-23,Puerto Rico,72,42660,64,617,4,326411,40,20439,40,305972,0
2020-09-23,Rhode Island,44,24177,133,1102,3,325120,2729,24177,133,300943,2596
2020-09-23,South Carolina,45,141686,897,3262,19,1190584,18100,141686,897,1048898,17203
2020-09-23,South Dakota,46,19634,445,202,0,180132,1786,19634,445,160498,1341
2020-09-23,Tennessee,47,184068,1522,2252,16,2713343,21939,186709,1561,2526634,20378
2020-09-23,Texas,48,753551,4482,15455,133,5740674,72942,719599,3392,5021075,69550
2020-09-23,Utah,49,65948,890,444,1,769910,7551,65921,877,703989,6674
2020-09-23,Vermont,50,1722,1,58,0,155914,363,1725,1,154189,362
2020-09-23,Virgin Islands,78,1290,12,19,0,19618,154,1278,2,18340,152
2020-09-23,Virginia,51,142590,580,3089,29,1929570,11081,142590,580,1786980,10501
2020-09-23,Washington,53,88042,809,2175,12,1740899,0,83193,0,1657706,0
2020-09-23,West Virginia,54,14504,120,319,2,525580,2911,14504,120,511076,2791
2020-09-23,Wisconsin,55,112276,1883,1269,10,1472405,13586,112222,1895,1360183,11691
2020-09-23,Wyoming,56,5169,153,50,1,94993,153,5169,153,89824,0
2020-09-24,Alabama,01,148206,1053,2506,18,1092953,7349,148206,1053,944747,6296
2020-09-24,Alaska,02,8015,140,43,1,433198,0,7194,131,426004,-131
2020-09-24,Arizona,04,215852,568,5560,34,1420417,10551,215852,568,1204565,9983
2020-09-24,Arkansas,05,79049,1086,1246,17,919786,10522,79049,1086,840737,9436
2020-09-24,California,06,801671,3321,15389,76,13952857,73434,790640,3170,13162217,70264
2020-09-24,Colorado,08,67745,559,2042,4,862805,9213,67217,548,795588,8665
2020-09-24,Connecticut,09,56472,157,4499,2,1505473,15575,56472,157,1449001,15418
2020-09-24,Delaware,10,19947,117,630,1,277916,1872,19947,117,257969,1755
2020-09-24,District of Columbia,11,15106,56,621,0,367867,4419,15106,56,352761,4363
2020-09-24,Florida,12,693032,2541,13794,177,5171306,23455,684847,2477,4486459,20978
2020-09-24,Georgia,13,294334,1537,6667,47,2824816,21601,311046,1368,2513770,20233
2020-09-24,Guam,66,3232,28,39,1,47687,436,2263,28,45424,408
2020-09-24,Hawaii,15,11908,88,123,2,286944,2716,11848,167,275096,2549
2020-09-24,Idaho,16,39547,517,458,4,297443,2042,38743,396,258700,1646
2020-09-24,Illinois,17,284620,2289,8793,31,5295876,62071,283569,2257,5012307,59814
2020-09-24,Indiana,18,116481,903,3548,18,1331608,8789,114236,899,1217372,7890
2020-09-24,Iowa,19,83993,1037,1303,5,738580,6727,81071,1148,657509,5579
2020-09-24,Kansas,20,56461,106,633,4,492281,0,55226,0,437055,0
2020-09-24,Kentucky,21,68230,640,1166,5,1233935,9793,64158,641,1169777,9152
2020-09-24,Louisiana,22,164446,577,5423,16,2237534,17525,164446,577,2073088,16948
2020-09-24,Maine,23,5215,44,140,0,399966,13931,5215,44,394751,13887
2020-09-24,Maryland,24,122293,500,3909,7,1561579,9474,121800,503,1439779,8971
2020-09-24,Massachusetts,25,128993,481,9362,15,2146526,18582,128993,481,2017533,18101
2020-09-24,Michigan,26,132400,1108,7020,7,3462824,37717,132337,1078,3330487,36639
2020-09-24,Minnesota,27,93064,912,2040,3,1336851,12900,93012,912,1243839,11988
2020-09-24,Mississippi,28,95310,737,2874,4,721759,5048,95310,737,626449,4311
2020-09-24,Missouri,29,121485,1361,2055,20,1259531,14968,118311,1365,1141220,13603
2020-09-24,Montana,30,11381,347,165,0,321518,4358,11242,330,310276,4028
2020-09-24,Nebraska,31,42731,453,478,1,434369,3267,42278,493,392091,2774
2020-09-24,Nevada,32,77338,431,1565,9,675488,3564,77197,390,598291,3174
2020-09-24,New Hampshire,33,8044,37,438,0,247151,2662,8044,37,239107,2625
2020-09-24,New Jersey,34,203343,564,16091,9,3451804,29057,201552,564,3250252,28493
2020-09-24,New Mexico,35,28224,237,859,2,885373,6967,28224,237,857149,6730
2020-09-24,New York,36,457557,953,32696,5,10228645,92953,452847,955,9775798,91998
2020-09-24,North Carolina,37,199236,1805,3380,35,2870191,27764,198189,1688,2672002,26076
2020-09-24,North Dakota,38,19454,470,215,9,233113,1261,19451,470,213662,791
2020-09-24,Northern Mariana Islands,69,69,0,2,0,14845,0,69,0,14776,0
2020-09-24,Ohio,39,147744,991,4715,28,2955715,24516,147744,991,2807971,23525
2020-09-24,Oklahoma,40,81244,1083,981,11,1126926,12600,81244,1083,1045682,11517
2020-09-24,Oregon,41,31869,356,540,2,650498,4373,31865,362,618633,4011
2020-09-24,Pennsylvania,42,158221,848,8150,13,1956867,13911,153397,853,1803470,13058
2020-09-24,Puerto Rico,72,43842,1182,627,10,327128,717,21156,717,305972,0
2020-09-24,Rhode Island,44,24311,134,1106,4,327583,2463,24311,134,303272,2329
2020-09-24,South Carolina,45,142707,1021,3279,17,1207106,16522,142707,1021,1064399,15501
2020-09-24,South Dakota,46,20097,463,210,8,181661,1529,20097,463,161564,1066
2020-09-24,Tennessee,47,185121,1053,2287,35,2729388,16045,187544,835,2541844,15210
2020-09-24,Texas,48,758379,4828,15587,132,5860833,120159,723919,4320,5136914,115839
2020-09-24,Utah,49,67167,1219,444,0,778412,8502,67119,1198,711293,7304
2020-09-24,Vermont,50,1724,2,58,0,156781,867,1727,2,155054,865
2020-09-24,Virgin Islands,78,1290,0,19,0,19824,206,1290,12,18534,194
2020-09-24,Virginia,51,143492,902,3113,24,1960009,30439,143492,902,1816517,29537
2020-09-24,Washington,53,88597,555,2175,0,1743296,2397,83702,509,1659594,1888
2020-09-24,West Virginia,54,14706,202,325,6,529025,3445,14706,202,514319,3243
2020-09-24,Wisconsin,55,114743,2467,1275,6,1485770,13365,114700,2478,1371070,10887
2020-09-24,Wyoming,56,5305,136,50,0,96640,1647,5305,136,91335,1511
2020-09-25,Alabama,01,150658,2452,2491,-15,1114022,21069,150658,2452,963364,18617
2020-09-25,Alaska,02,8133,118,48,5,441332,8134,7320,126,434012,8008
2020-09-25,Arizona,04,216367,515,5588,28,1428024,7607,216367,515,1211657,7092
2020-09-25,Arkansas,05,79946,897,1266,20,928768,8982,79946,897,848822,8085
2020-09-25,California,06,805733,4062,15533,144,14052247,99390,794040,3400,13258207,95990
2020-09-25,Colorado,08,68506,761,2045,3,872732,9927,67926,709,804806,9218
2020-09-25,Connecticut,09,56587,115,4501,2,1519151,13678,56587,115,1462564,13563
2020-09-25,Delaware,10,20085,138,631,1,279374,1458,20085,138,259289,1320
2020-09-25,District of Columbia,11,15163,57,623,2,373586,5719,15163,57,358423,5662
2020-09-25,Florida,12,695879,2847,13914,120,5197763,26457,687656,2809,4510107,23648
2020-09-25,Georgia,13,296089,1755,6717,50,2847494,22678,312514,1468,2534980,21210
2020-09-25,Guam,66,3255,23,40,1,48256,569,2286,23,45970,546
2020-09-25,Hawaii,15,12039,131,126,3,287034,90,11938,90,275096,0
2020-09-25,Idaho,16,40228,681,458,0,299882,2439,39234,491,260648,1948
2020-09-25,Illinois,17,287375,2755,8826,33,5365960,70084,286374,2805,5079586,67279
2020-09-25,Indiana,18,117656,1175,3566,18,1341462,9854,115407,1171,1226055,8683
2020-09-25,Iowa,19,85031,1038,1312,9,744981,6401,82045,974,662936,5427
2020-09-25,Kansas,20,57852,1391,634,1,502770,10489,56592,1366,446178,9123
2020-09-25,Kentucky,21,69150,920,1179,13,1252328,18393,65066,908,1187262,17485
2020-09-25,Louisiana,22,165152,706,5444,21,2256065,18531,165152,706,2090913,17825
2020-09-25,Maine,23,5235,20,140,0,406394,6428,5235,20,401159,6408
2020-09-25,Maryland,24,122850,557,3917,8,1572484,10905,122359,559,1450125,10346
2020-09-25,Massachusetts,25,129481,488,9373,11,2162414,15888,129481,488,2032933,15400
2020-09-25,Michigan,26,133443,1043,7028,8,3502312,39488,133377,1040,3368935,38448
2020-09-25,Minnesota,27,94241,1177,2046,6,1351156,14305,94189,1177,1256967,13128
2020-09-25,Mississippi,28,96032,722,2894,20,726386,4627,96032,722,630354,3905
2020-09-25,Missouri,29,123544,2059,2075,20,1273165,13634,120298,1987,1152867,11647
2020-09-25,Montana,30,11656,275,170,5,326116,4598,11564,322,314552,4276
2020-09-25,Nebraska,31,43162,431,483,5,437304,2935,42731,453,394573,2482
2020-09-25,Nevada,32,77930,592,1573,8,681336,5848,77753,556,603583,5292
2020-09-25,New Hampshire,33,8085,41,438,0,247151,0,8044,0,239107,0
2020-09-25,New Jersey,34,203891,548,16097,6,3478711,26907,202100,548,3276611,26359
2020-09-25,New Mexico,35,28487,263,865,6,893489,8116,28487,263,865002,7853
2020-09-25,New York,36,458466,909,32708,12,10323463,94818,453755,908,9869708,93910
2020-09-25,North Carolina,37,204658,5422,3427,47,2907617,37426,204331,6142,2703286,31284
2020-09-25,North Dakota,38,19888,434,222,7,234634,1521,19885,434,214749,1087
2020-09-25,Northern Mariana Islands,69,69,0,2,0,14845,0,69,0,14776,0
2020-09-25,Ohio,39,148894,1150,4734,19,2995593,39878,148894,1150,2846699,38728
2020-09-25,Oklahoma,40,82520,1276,993,12,1140664,13738,82520,1276,1058144,12462
2020-09-25,Oregon,41,32328,459,545,5,662906,12408,32314,449,630592,11959
2020-09-25,Pennsylvania,42,159051,830,8157,7,1970600,13733,154203,806,1816397,12927
2020-09-25,Puerto Rico,72,44905,1063,635,8,327840,712,21868,712,305972,0
2020-09-25,Rhode Island,44,24181,-130,1107,1,330034,2451,24181,-130,305853,2581
2020-09-25,South Carolina,45,143902,1195,3297,18,1226467,19361,143902,1195,1082565,18166
2020-09-25,South Dakota,46,20554,457,216,6,183947,2286,20554,457,163393,1829
2020-09-25,Tennessee,47,186769,1648,2326,39,2762845,33457,189454,1910,2573391,31547
2020-09-25,Texas,48,761644,3265,15637,50,5913449,52616,728552,4633,5184897,47983
2020-09-25,Utah,49,68537,1370,448,4,785727,7315,68530,1411,717197,5904
2020-09-25,Vermont,50,1731,7,58,0,157654,873,1734,7,155920,866
2020-09-25,Virgin Islands,78,1296,6,19,0,19972,148,1296,6,18676,142
2020-09-25,Virginia,51,144433,941,3136,23,1980649,20640,144433,941,1836216,19699
2020-09-25,Washington,53,89149,552,2193,18,1783279,39983,84238,536,1699041,39447
2020-09-25,West Virginia,54,14953,247,330,5,535394,6369,14953,247,520441,6122
2020-09-25,Wisconsin,55,117355,2612,1285,10,1500974,15204,117329,2629,1383645,12575
2020-09-25,Wyoming,56,5420,115,50,0,97826,1186,5420,115,92406,1071
2020-09-26,Alabama,01,151591,933,2501,10,1121639,7617,151591,933,970048,6684
2020-09-26,Alaska,02,8244,111,48,0,442869,1537,7439,119,435430,1418
2020-09-26,Arizona,04,216826,459,5623,35,1438677,10653,216826,459,1221851,10194
2020-09-26,Arkansas,05,80755,809,1285,19,936390,7622,80755,809,855635,6813
2020-09-26,California,06,809214,3481,15588,55,14182730,130483,798237,4197,13384493,126286
2020-09-26,Colorado,08,68973,467,2047,2,882842,10110,68510,584,814332,9526
2020-09-26,Connecticut,09,56587,0,4501,0,1519151,0,56587,0,1462564,0
2020-09-26,Delaware,10,20156,71,633,2,280399,1025,20156,71,260243,954
2020-09-26,District of Columbia,11,15215,52,624,1,377979,4393,15215,52,362764,4341
2020-09-26,Florida,12,698674,2795,14021,107,5226712,28949,690387,2731,4536325,26218
2020-09-26,Georgia,13,297553,1464,6758,41,2872355,24861,313873,1359,2558482,23502
2020-09-26,Guam,66,3255,0,40,0,48719,463,2354,68,46365,395
2020-09-26,Hawaii,15,12166,127,130,4,290146,3112,12070,132,278076,2980
2020-09-26,Idaho,16,40411,183,460,2,302177,2295,39757,523,262420,1772
2020-09-26,Illinois,17,289683,2308,8847,21,5431177,65217,288815,2441,5142362,62776
2020-09-26,Indiana,18,118819,1163,3577,11,1350390,8928,116549,1142,1233841,7786
2020-09-26,Iowa,19,85908,877,1314,2,750898,5917,82944,899,667954,5018
2020-09-26,Kansas,20,57852,0,634,0,502770,0,56592,0,446178,0
2020-09-26,Kentucky,21,70038,888,1185,6,1282596,30268,66036,970,1216560,29298
2020-09-26,Louisiana,22,165152,0,5444,0,2256065,0,165152,0,2090913,0
2020-09-26,Maine,23,5260,25,140,0,406419,25,5260,25,401159,0
2020-09-26,Maryland,24,123328,478,3925,8,1584300,11816,122972,613,1461328,11203
2020-09-26,Massachusetts,25,130050,569,9391,18,2176778,14364,130050,569,2046728,13795
2020-09-26,Michigan,26,134372,929,7044,16,3543057,40745,134373,996,3408684,39749
2020-09-26,Minnesota,27,95711,1470,2056,10,1368682,17526,95659,1470,1273023,16056
2020-09-26,Mississippi,28,96677,645,2911,17,730713,4327,96677,645,634036,3682
2020-09-26,Missouri,29,124939,1395,2118,43,1289169,16004,122014,1716,1167155,14288
2020-09-26,Montana,30,11943,287,171,1,329285,3169,11907,343,317378,2826
2020-09-26,Nebraska,31,43596,434,484,1,440645,3341,43162,431,397483,2910
2020-09-26,Nevada,32,78464,534,1583,10,685678,4342,78355,602,607323,3740
2020-09-26,New Hampshire,33,8121,36,439,1,265378,18227,8121,77,257257,18150
2020-09-26,New Jersey,34,204641,750,16103,6,3512568,33857,202850,750,3309718,33107
2020-09-26,New Mexico,35,28692,205,870,5,899937,6448,28692,205,871245,6243
2020-09-26,New York,36,459472,1006,32713,5,10423416,99953,454760,1005,9968656,98948
2020-09-26,North Carolina,37,206241,1583,3458,31,2947803,40186,206090,1759,2741713,38427
2020-09-26,North Dakota,38,20383,495,230,8,236229,1595,20380,495,215849,1100
2020-09-26,Northern Mariana Islands,69,69,0,2,0,14845,0,69,0,14776,0
2020-09-26,Ohio,39,150009,1115,4740,6,3033987,38394,150009,1115,2883978,37279
2020-09-26,Oklahoma,40,83510,990,1004,11,1158985,18321,83510,990,1075475,17331
2020-09-26,Oregon,41,32581,253,549,4,668671,5765,32581,267,636090,5498
2020-09-26,Pennsylvania,42,159937,886,8177,20,1985524,14924,155232,1029,1830292,13895
2020-09-26,Puerto Rico,72,45413,508,642,7,328136,296,22164,296,305972,0
2020-09-26,Rhode Island,44,24181,0,1107,0,333148,3114,24284,103,308864,3011
2020-09-26,South Carolina,45,145273,1371,3323,26,1242797,16330,145273,1371,1097524,14959
2020-09-26,South Dakota,46,21133,579,218,2,186134,2187,21133,579,165001,1608
2020-09-26,Tennessee,47,188205,1436,2347,21,2789879,27034,190891,1437,2598988,25597
2020-09-26,Texas,48,764642,2998,15792,155,5994813,81364,733438,4886,5261375,76478
2020-09-26,Utah,49,69556,1019,448,0,794487,8760,69547,1017,724940,7743
2020-09-26,Vermont,50,1739,8,58,0,158543,889,1744,10,156799,879
2020-09-26,Virgin Islands,78,1317,21,19,0,19972,0,1296,0,18676,0
2020-09-26,Virginia,51,145408,975,3144,8,2000579,19930,145408,975,1855171,18955
2020-09-26,Washington,53,89514,365,2196,3,1801021,17742,85226,988,1715795,16754
2020-09-26,West Virginia,54,15158,205,332,2,542291,6897,15158,205,527133,6692
2020-09-26,Wisconsin,55,120249,2894,1291,6,1513643,12669,120231,2902,1393412,9767
2020-09-26,Wyoming,56,5465,45,50,0,97871,45,5465,45,92406,0
2020-09-27,Alabama,01,152321,730,2502,1,1128006,6367,152321,730,975685,5637
2020-09-27,Alaska,02,8359,115,52,4,442869,0,7549,110,435320,-110
2020-09-27,Arizona,04,217237,411,5623,0,1447845,9168,217237,411,1230608,8757
2020-09-27,Arkansas,05,81242,487,1308,23,943134,6744,81242,487,861892,6257
2020-09-27,California,06,811698,2484,15608,20,14333498,150768,802308,4071,13531190,146697
2020-09-27,Colorado,08,69472,499,2048,1,893381,10539,69079,569,824302,9970
2020-09-27,Connecticut,09,56587,0,4501,0,1519151,0,56587,0,1462564,0
2020-09-27,Delaware,10,20260,104,633,0,282024,1625,20260,104,261764,1521
2020-09-27,District of Columbia,11,15250,35,624,0,381159,3180,15250,35,365909,3145
2020-09-27,Florida,12,700556,1882,14031,10,5245111,18399,692234,1847,4552877,16552
2020-09-27,Georgia,13,298321,768,6789,31,2886269,13914,314685,812,2571584,13102
2020-09-27,Guam,66,3255,0,40,0,48719,0,2354,0,46365,0
2020-09-27,Hawaii,15,12264,98,131,1,291836,1690,12197,127,279639,1563
2020-09-27,Idaho,16,40501,90,460,0,304781,2604,40296,539,264485,2065
2020-09-27,Illinois,17,291271,1588,8859,12,5481999,50822,290419,1604,5191580,49218
2020-09-27,Indiana,18,119721,902,3580,3,1358860,8470,117450,901,1241410,7569
2020-09-27,Iowa,19,86624,716,1316,2,754623,3725,83636,692,670987,3033
2020-09-27,Kansas,20,57978,126,636,2,502770,0,56592,0,446178,0
2020-09-27,Kentucky,21,70385,347,1189,4,1283051,455,66491,455,1216560,0
2020-09-27,Louisiana,22,166075,923,5465,21,2283149,27084,166075,923,2117074,26161
2020-09-27,Maine,23,5288,28,140,0,421196,14777,5288,28,415908,14749
2020-09-27,Maryland,24,123895,567,3935,10,1594363,10063,123403,431,1470960,9632
2020-09-27,Massachusetts,25,130642,592,9404,13,2194841,18063,130642,592,2064199,17471
2020-09-27,Michigan,26,134409,37,7044,0,3543057,0,134373,0,3408684,0
2020-09-27,Minnesota,27,96786,1075,2060,4,1384512,15830,96734,1075,1287778,14755
2020-09-27,Mississippi,28,96859,182,2919,8,730895,182,96859,182,634036,0
2020-09-27,Missouri,29,126115,1176,2117,-1,1298106,8937,123406,1392,1174700,7545
2020-09-27,Montana,30,12126,183,173,2,330307,1022,12107,200,318200,822
2020-09-27,Nebraska,31,44063,467,485,1,445129,4484,43596,434,401533,4050
2020-09-27,Nevada,32,78820,356,1585,2,688956,3278,78728,373,610228,2905
2020-09-27,New Hampshire,33,8172,51,439,0,267486,2108,8172,51,259314,2057
2020-09-27,New Jersey,34,205339,698,16106,3,3513266,698,203548,698,3309718,0
2020-09-27,New Mexico,35,28844,152,870,0,905329,5392,28844,152,876485,5240
2020-09-27,New York,36,460340,868,32722,9,10508186,84770,455626,866,10052560,83904
2020-09-27,North Carolina,37,207407,1166,3460,2,2978728,30925,207380,1290,2771348,29635
2020-09-27,North Dakota,38,20727,344,234,4,237618,1389,20724,344,216894,1045
2020-09-27,Northern Mariana Islands,69,69,0,2,0,14846,1,70,1,14776,0
2020-09-27,Ohio,39,150809,800,4741,1,3071187,37200,150809,800,2920378,36400
2020-09-27,Oklahoma,40,84333,823,1006,2,1158985,0,83510,0,1075475,0
2020-09-27,Oregon,41,32820,239,549,0,671490,2819,32820,239,638670,2580
2020-09-27,Pennsylvania,42,160770,833,8180,3,2001220,15696,156150,918,1845070,14778
2020-09-27,Puerto Rico,72,46304,891,644,2,328669,533,22697,533,305972,0
2020-09-27,Rhode Island,44,24181,0,1107,0,335120,1972,24398,114,310722,1858
2020-09-27,South Carolina,45,145887,614,3326,3,1252538,9741,145887,614,1106651,9127
2020-09-27,South Dakota,46,21541,408,218,0,187504,1370,21541,408,165963,962
2020-09-27,Tennessee,47,190037,1832,2350,3,2832536,42657,192995,2104,2639541,40553
2020-09-27,Texas,48,770539,5897,15831,39,6016907,22094,735132,1694,5281775,20400
2020-09-27,Utah,49,70616,1060,453,5,801308,6821,70615,1068,730693,5753
2020-09-27,Vermont,50,1742,3,58,0,159167,624,1746,2,157421,622
2020-09-27,Virgin Islands,78,1317,0,19,0,20160,188,1317,21,18843,167
2020-09-27,Virginia,51,146144,736,3159,15,2010539,9960,146144,736,1864395,9224
2020-09-27,Washington,53,89822,308,2196,0,1820623,19602,85830,604,1734793,18998
2020-09-27,West Virginia,54,15348,190,334,2,549723,7432,15348,190,534375,7242
2020-09-27,Wisconsin,55,122498,2249,1291,0,1521696,8053,122478,2247,1399218,5806
2020-09-27,Wyoming,56,5633,168,50,0,98039,168,5633,168,92406,0
2020-09-28,Alabama,01,152983,662,2501,-1,1133274,5268,152983,662,980291,4606
2020-09-28,Alaska,02,8477,118,52,0,444791,1922,7663,114,437128,1808
2020-09-28,Arizona,04,217513,276,5624,1,1453252,5407,217510,273,1235742,5134
2020-09-28,Arkansas,05,82049,807,1329,21,1000226,57092,82049,807,918177,56285
2020-09-28,California,06,814796,3098,15641,33,14484852,151354,805263,2955,13679589,148399
2020-09-28,Colorado,08,69967,495,2052,4,899874,6493,69490,411,830384,6082
2020-09-28,Connecticut,09,57147,560,4503,2,1571206,52055,57147,560,1514059,51495
2020-09-28,Delaware,10,20389,129,634,1,283815,1791,20389,129,263426,1662
2020-09-28,District of Columbia,11,15264,14,624,0,383048,1889,15264,14,367784,1875
2020-09-28,Florida,12,701294,738,14036,5,5253332,8221,692962,728,4560370,7493
2020-09-28,Georgia,13,298963,642,6803,14,2898498,12229,315281,596,2583217,11633
2020-09-28,Guam,66,3255,0,40,0,49211,492,2390,36,46821,456
2020-09-28,Hawaii,15,12351,87,131,0,293741,1905,12295,98,281446,1807
2020-09-28,Idaho,16,41386,885,460,0,306854,2073,40501,205,266353,1868
2020-09-28,Illinois,17,293169,1898,8877,18,5523141,41142,292128,1709,5231013,39433
2020-09-28,Indiana,18,120581,860,3591,11,1366294,7434,118322,872,1247972,6562
2020-09-28,Iowa,19,87256,632,1324,8,755316,693,84002,366,671314,327
2020-09-28,Kansas,20,59793,1815,641,5,513909,11139,58629,2037,455280,9102
2020-09-28,Kentucky,21,71003,618,1195,6,1301191,18140,66939,448,1234252,17692
2020-09-28,Louisiana,22,166315,240,5480,15,2289618,6469,166315,240,2123303,6229
2020-09-28,Maine,23,5300,12,140,0,423396,2200,5300,12,418096,2188
2020-09-28,Maryland,24,124371,476,3938,3,1603099,8736,123880,477,1479219,8259
2020-09-28,Massachusetts,25,131072,430,9415,11,2207953,13112,131072,430,2076881,12682
2020-09-28,Michigan,26,135782,1373,7052,8,3593990,50933,135702,1329,3458288,49604
2020-09-28,Minnesota,27,97690,904,2067,7,1397865,13353,97638,904,1300227,12449
2020-09-28,Mississippi,28,97049,190,2921,2,735892,4997,97049,190,638843,4807
2020-09-28,Missouri,29,127894,1779,2132,15,1302958,4852,124686,1280,1178272,3572
2020-09-28,Montana,30,12538,412,174,1,337196,6889,12413,306,324783,6583
2020-09-28,Nebraska,31,44578,515,487,2,448361,3232,44063,467,404298,2765
2020-09-28,Nevada,32,79313,493,1586,1,692673,3717,79191,463,613482,3254
2020-09-28,New Hampshire,33,8208,36,439,0,269367,1881,8208,36,261159,1845
2020-09-28,New Jersey,34,205898,559,16107,1,3566304,53038,204107,559,3362197,52479
2020-09-28,New Mexico,35,28985,141,873,3,909505,4176,28985,141,880520,4035
2020-09-28,New York,36,461176,836,32737,15,10561122,52936,456460,834,10104662,52102
2020-09-28,North Carolina,37,208497,1090,3469,9,3004533,25805,208248,868,2796285,24937
2020-09-28,North Dakota,38,20986,259,237,3,238737,1119,20983,259,217754,860
2020-09-28,Northern Mariana Islands,69,69,0,2,0,14846,0,70,0,14776,0
2020-09-28,Ohio,39,151802,993,4746,5,3106176,34989,151802,993,2954374,33996
2020-09-28,Oklahoma,40,85194,861,1007,1,1160669,1684,85194,1684,1075475,0
2020-09-28,Oregon,41,32995,175,549,0,675029,3539,32994,174,642035,3365
2020-09-28,Pennsylvania,42,161642,872,8181,1,2012317,11097,156826,676,1855491,10421
2020-09-28,Puerto Rico,72,47422,1118,648,4,329329,660,23357,660,305972,0
2020-09-28,Rhode Island,44,24424,243,1110,3,335684,564,24424,26,311260,538
2020-09-28,South Carolina,45,146455,568,3337,11,1273928,21390,146455,568,1127473,20822
2020-09-28,South Dakota,46,21738,197,218,0,188344,840,21738,197,166606,643
2020-09-28,Tennessee,47,190991,954,2362,12,2847342,14806,193732,737,2653610,14069
2020-09-28,Texas,48,773679,3140,15898,67,6171755,154848,739743,4611,5432012,150237
2020-09-28,Utah,49,71442,826,453,0,805996,4688,71442,827,734554,3861
2020-09-28,Vermont,50,1745,3,58,0,159999,832,1749,3,158250,829
2020-09-28,Virgin Islands,78,1318,1,20,1,20160,0,1317,0,18843,0
2020-09-28,Virginia,51,146593,449,3172,13,2034617,24078,146593,449,1888024,23629
2020-09-28,Washington,53,90596,774,2199,3,1837206,16583,86269,439,1750937,16144
2020-09-28,West Virginia,54,15512,164,337,3,553270,3547,15512,164,537758,3383
2020-09-28,Wisconsin,55,124320,1822,1293,2,1529594,7898,124217,1739,1405377,6159
2020-09-28,Wyoming,56,5754,121,50,0,100116,2077,5754,121,94362,1956
2020-09-29,Alabama,01,153554,571,2517,16,1136717,3443,153554,571,983163,2872
2020-09-29,Alaska,02,8602,125,52,0,451056,6265,7785,122,443271,6143
2020-09-29,Arizona,04,218185,672,5632,8,1458090,4838,218184,674,1239906,4164
2020-09-29,Arkansas,05,82755,706,1350,21,1010657,10431,82755,706,927902,9725
2020-09-29,California,06,817939,3143,15791,150,14613545,128693,807425,2162,13806120,126531
2020-09-29,Colorado,08,70458,491,2058,6,907152,7278,70025,535,837127,6743
2020-09-29,Connecticut,09,57329,182,4505,2,1581592,10386,57329,182,1524263,10204
2020-09-29,Delaware,10,20531,142,635,1,285488,1673,20531,142,264957,1531
2020-09-29,District of Columbia,11,15300,36,626,2,386396,3348,15300,36,371096,3312
2020-09-29,Florida,12,704560,3266,14142,106,5281719,28387,696171,3209,4585548,25178
2020-09-29,Georgia,13,300019,1056,6836,33,2910833,12335,316306,1025,2594527,11310
2020-09-29,Guam,66,3412,157,48,8,49727,516,2443,53,47284,463
2020-09-29,Hawaii,15,12436,85,133,2,296593,2852,12382,87,284211,2765
2020-09-29,Idaho,16,41854,468,466,6,308542,1688,40923,422,267619,1266
2020-09-29,Illinois,17,294673,1504,8901,24,5568765,45624,293490,1362,5275275,44262
2020-09-29,Indiana,18,121327,746,3612,21,1371355,5061,119066,744,1252289,4317
2020-09-29,Iowa,19,88234,978,1341,17,758388,3072,84476,474,673912,2598
2020-09-29,Kansas,20,59951,158,650,9,513909,0,58629,0,455280,0
2020-09-29,Kentucky,21,71921,918,1205,10,1371241,70050,67856,917,1303385,69133
2020-09-29,Louisiana,22,166848,533,5490,10,2307757,18139,166848,533,2140909,17606
2020-09-29,Maine,23,5337,37,141,1,428054,4658,5337,37,422717,4621
2020-09-29,Maryland,24,124805,434,3946,8,1610310,7211,124311,431,1485999,6780
2020-09-29,Massachusetts,25,131584,512,9423,8,2222139,14186,131584,512,2090555,13674
2020-09-29,Michigan,26,136899,1117,7073,21,3618084,24094,136820,1118,3481264,22976
2020-09-29,Minnesota,27,98499,809,2072,5,1406578,8713,98447,809,1308131,7904
2020-09-29,Mississippi,28,97638,589,2957,36,736481,589,97638,589,638843,0
2020-09-29,Missouri,29,128816,922,2148,16,1303034,76,124762,76,1178272,0
2020-09-29,Montana,30,12825,287,177,3,339926,2730,12724,311,327202,2419
2020-09-29,Nebraska,31,45044,466,493,6,452557,4196,44578,515,407979,3681
2020-09-29,Nevada,32,79691,378,1594,8,695720,3047,79595,404,616125,2643
2020-09-29,New Hampshire,33,8233,25,439,0,270204,837,8233,25,261971,812
2020-09-29,New Jersey,34,206354,456,16117,10,3566760,456,204563,456,3362197,0
2020-09-29,New Mexico,35,29157,172,875,2,914986,5481,29157,172,885829,5309
2020-09-29,New York,36,462364,1188,32743,6,10649353,88231,457649,1189,10191704,87042
2020-09-29,North Carolina,37,209384,887,3511,42,3019586,15053,209137,889,2810449,14164
2020-09-29,North Dakota,38,21404,418,242,5,239848,1111,21401,418,218447,693
2020-09-29,Northern Mariana Islands,69,69,0,2,0,14846,0,70,0,14776,0
2020-09-29,Ohio,39,152907,1105,4783,37,3141377,35201,152907,1105,2988470,34096
2020-09-29,Oklahoma,40,86219,1025,1018,11,1192403,31734,86219,1025,1106184,30709
2020-09-29,Oregon,41,33297,302,555,6,679383,4354,33291,297,646092,4057
2020-09-29,Pennsylvania,42,163219,1577,8196,15,2024575,12258,157814,988,1866761,11270
2020-09-29,Puerto Rico,72,48467,1045,654,6,329773,444,23801,444,305972,0
2020-09-29,Rhode Island,44,24556,132,1113,3,337898,2214,24556,132,313342,2082
2020-09-29,South Carolina,45,147634,1179,3359,22,1300414,26486,147634,1179,1152780,25307
2020-09-29,South Dakota,46,21997,259,223,5,189146,802,21997,259,167149,543
2020-09-29,Tennessee,47,191859,868,2393,31,2860481,13139,194611,879,2665870,12260
2020-09-29,Texas,48,780543,6864,15994,96,6200826,29071,743284,3541,5457542,25530
2020-09-29,Utah,49,72136,694,457,4,812209,6213,72136,694,740073,5519
2020-09-29,Vermont,50,1749,4,58,0,160754,755,1753,4,159001,751
2020-09-29,Virgin Islands,78,1318,0,20,0,20373,213,1318,1,19055,212
2020-09-29,Virginia,51,147516,923,3187,15,2047065,12448,147516,923,1899549,11525
2020-09-29,Washington,53,91011,415,2218,19,1848463,11257,86638,369,1761825,10888
2020-09-29,West Virginia,54,15692,180,345,8,558313,5043,15692,180,542621,4863
2020-09-29,Wisconsin,55,126744,2424,1312,19,1540438,10844,126664,2447,1413774,8397
2020-09-29,Wyoming,56,5821,67,50,0,100543,427,5821,67,94722,360
2020-09-30,Alabama,01,154701,1147,2540,23,1149176,12459,154701,1147,994475,11312
2020-09-30,Alaska,02,8707,105,52,0,457207,6151,7889,104,449318,6047
2020-09-30,Arizona,04,218511,326,5654,22,1462148,4058,218507,323,1243641,3735
2020-09-30,Arkansas,05,83697,942,1369,19,1032804,22147,83697,942,949107,21205
2020-09-30,California,06,821125,3186,15898,107,14705202,91657,810625,3200,13894577,88457
2020-09-30,Colorado,08,71090,632,2061,3,916384,9232,70536,511,845848,8721
2020-09-30,Connecticut,09,57550,221,4508,3,1593993,12401,57550,221,1536443,12180
2020-09-30,Delaware,10,20613,82,636,1,286562,1074,20613,82,265949,992
2020-09-30,District of Columbia,11,15326,26,627,1,387860,1464,15326,26,372534,1438
2020-09-30,Florida,12,706508,1948,14316,174,5292719,11000,698051,1880,4594668,9120
2020-09-30,Georgia,13,301485,1466,6861,25,2933679,22846,318026,1720,2615653,21126
2020-09-30,Guam,66,3457,45,50,2,50114,387,2488,45,47626,342
2020-09-30,Hawaii,15,12555,119,135,2,296680,87,12469,87,284211,0
2020-09-30,Idaho,16,42549,695,469,3,310441,1899,41434,511,269007,1388
2020-09-30,Illinois,17,296935,2262,8935,34,5627311,58546,295763,2273,5331548,56273
2020-09-30,Indiana,18,122295,968,3632,20,1379850,8495,120019,953,1259831,7542
2020-09-30,Iowa,19,89248,1014,1358,17,764867,6479,85596,1120,679271,5359
2020-09-30,Kansas,20,60957,1006,678,28,521450,7541,59749,1120,461701,6421
2020-09-30,Kentucky,21,72830,909,1208,3,1384609,13368,68840,984,1315769,12384
2020-09-30,Louisiana,22,167458,610,5511,21,2318604,10847,167458,610,2151146,10237
2020-09-30,Maine,23,5391,54,141,0,435100,7046,5391,54,429709,6992
2020-09-30,Maryland,24,125217,412,3949,3,1618007,7697,124725,414,1493282,7283
2020-09-30,Massachusetts,25,132116,532,9456,33,2236565,14426,132116,532,2104449,13894
2020-09-30,Michigan,26,138074,1175,7084,11,3647862,29778,138014,1194,3509848,28584
2020-09-30,Minnesota,27,99187,688,2089,17,1414701,8123,99134,687,1315567,7436
2020-09-30,Mississippi,28,98190,552,2969,12,737033,552,98190,552,638843,0
2020-09-30,Missouri,29,130065,1249,2157,9,1304385,1351,126113,1351,1178272,0
2020-09-30,Montana,30,13179,354,180,3,343158,3232,13071,347,330087,2885
2020-09-30,Nebraska,31,45564,520,493,0,455638,3081,45044,466,410594,2615
2020-09-30,Nevada,32,80084,393,1600,6,698096,2376,79980,385,618116,1991
2020-09-30,New Hampshire,33,8266,33,439,0,273713,3509,8266,33,265447,3476
2020-09-30,New Jersey,34,207062,708,16122,5,3613032,46272,205275,712,3407757,45560
2020-09-30,New Mexico,35,29435,278,877,2,921009,6023,29435,278,891574,5745
2020-09-30,New York,36,463369,1005,32757,14,10747313,97960,458649,1000,10288664,96960
2020-09-30,North Carolina,37,211004,1620,3565,54,3034871,15285,210632,1495,2824239,13790
2020-09-30,North Dakota,38,21849,445,250,8,241492,1644,21846,445,219646,1199
2020-09-30,Northern Mariana Islands,69,70,1,2,0,15182,336,70,0,15112,336
2020-09-30,Ohio,39,153987,1080,4804,21,3165935,24558,153987,1080,3011948,23478
2020-09-30,Oklahoma,40,87199,980,1031,13,1204028,11625,87199,980,1116829,10645
2020-09-30,Oregon,41,33554,257,560,5,685873,6490,33509,218,652364,6272
2020-09-30,Pennsylvania,42,164135,916,8216,20,2038094,13519,158967,1153,1879127,12366
2020-09-30,Puerto Rico,72,48755,288,661,7,329972,199,24000,199,305972,0
2020-09-30,Rhode Island,44,24748,192,1114,1,340601,2703,24748,192,315853,2511
2020-09-30,South Carolina,45,147942,308,3378,19,1309098,8684,147942,308,1161156,8376
2020-09-30,South Dakota,46,22389,392,223,0,190769,1623,22389,392,168380,1231
2020-09-30,Tennessee,47,193357,1498,2429,36,2884356,23875,196139,1528,2688217,22347
2020-09-30,Texas,48,784027,3484,16102,108,6237157,36331,748967,5683,5488190,30648
2020-09-30,Utah,49,73053,917,460,3,819987,7778,73042,906,746945,6872
2020-09-30,Vermont,50,1752,3,58,0,161360,606,1756,3,159604,603
2020-09-30,Virgin Islands,78,1318,0,20,0,20561,188,1318,0,19243,188
2020-09-30,Virginia,51,148271,755,3208,21,2057645,10580,148271,755,1909374,9825
2020-09-30,Washington,53,91560,549,2222,4,1854399,5936,87042,404,1767357,5532
2020-09-30,West Virginia,54,15848,156,350,5,561568,3255,15848,156,545720,3099
2020-09-30,Wisconsin,55,129172,2428,1338,26,1552370,11932,129123,2459,1423247,9473
2020-09-30,Wyoming,56,5948,127,50,0,101160,617,5948,127,95212,490
2020-10-01,Alabama,01,155744,1043,2548,8,1156314,7138,155744,1043,1000570,6095
2020-10-01,Alaska,02,8838,131,53,1,462323,5116,8026,137,454297,4979
2020-10-01,Arizona,04,219214,703,5674,20,1475972,13824,219212,705,1256760,13119
2020-10-01,Arkansas,05,84821,1124,1384,15,1045906,13102,84821,1124,961085,11978
2020-10-01,California,06,824306,3181,15989,91,14771851,66649,813687,3062,13958164,63587
2020-10-01,Colorado,08,71723,633,2064,3,927208,10824,71218,682,855990,10142
2020-10-01,Connecticut,09,57742,192,4511,3,1604380,10387,57742,192,1546638,10195
2020-10-01,Delaware,10,20787,174,636,0,288217,1655,20787,174,267430,1481
2020-10-01,District of Columbia,11,15358,32,628,1,390180,2320,15358,32,374822,2288
2020-10-01,Florida,12,709136,2628,14443,127,5317293,24574,700602,2551,4616691,22023
2020-10-01,Georgia,13,303010,1525,6903,42,2954392,20713,319334,1308,2635058,19405
2020-10-01,Guam,66,3519,62,50,0,50548,434,2550,62,47998,372
2020-10-01,Hawaii,15,12660,105,138,3,298642,1962,12589,120,286053,1842
2020-10-01,Idaho,16,42915,366,473,4,313018,2577,42048,614,270970,1963
2020-10-01,Illinois,17,299111,2176,8956,21,5692926,65615,297929,2166,5394997,63449
2020-10-01,Indiana,18,123459,1164,3645,13,1387731,7881,121176,1157,1266555,6724
2020-10-01,Iowa,19,90483,1235,1366,8,770943,6076,86634,1038,684309,5038
2020-10-01,Kansas,20,61103,146,678,0,521450,0,59749,0,461701,0
2020-10-01,Kentucky,21,73619,789,1225,17,1408615,24006,69728,888,1338887,23118
2020-10-01,Louisiana,22,168009,551,5519,8,2334745,16141,168009,551,2166736,15590
2020-10-01,Maine,23,5431,40,142,1,442391,7291,5431,40,436960,7251
2020-10-01,Maryland,24,125997,780,3949,0,1628200,10193,125510,785,1502690,9408
2020-10-01,Massachusetts,25,132870,754,9480,24,2254770,18205,132870,754,2121900,17451
2020-10-01,Michigan,26,139064,990,7103,19,3683581,35719,139012,998,3544569,34721
2020-10-01,Minnesota,27,100253,1066,2102,13,1429575,14874,100200,1066,1329375,13808
2020-10-01,Mississippi,28,98886,696,2979,10,737729,696,98886,696,638843,0
2020-10-01,Missouri,29,131778,1713,2184,27,1315418,11033,127912,1799,1187506,9234
2020-10-01,Montana,30,13626,447,181,1,348709,5551,13500,429,335209,5122
2020-10-01,Nebraska,31,46185,621,497,4,459542,3904,45564,520,413978,3384
2020-10-01,Nevada,32,80507,423,1603,3,701557,3461,80410,430,621147,3031
2020-10-01,New Hampshire,33,8317,51,441,2,275834,2121,8317,51,267517,2070
2020-10-01,New Jersey,34,207676,614,16127,5,3613646,614,205889,614,3407757,0
2020-10-01,New Mexico,35,29661,226,882,5,928389,7380,29661,226,898728,7154
2020-10-01,New York,36,464752,1383,32768,11,10856531,109218,460031,1382,10396500,107836
2020-10-01,North Carolina,37,213218,2214,3601,36,3063661,28790,212909,2277,2850752,26513
2020-10-01,North Dakota,38,22221,372,259,9,242900,1408,22218,372,220682,1036
2020-10-01,Northern Mariana Islands,69,70,0,2,0,15182,0,70,0,15112,0
2020-10-01,Ohio,39,155314,1327,4817,13,3240197,74262,155314,1327,3084883,72935
2020-10-01,Oklahoma,40,88369,1170,1035,4,1215441,11413,88369,1170,1127072,10243
2020-10-01,Oregon,41,33865,311,561,1,691945,6072,33862,353,658083,5719
2020-10-01,Pennsylvania,42,165078,943,8234,18,2049762,11668,160123,1156,1889639,10512
2020-10-01,Puerto Rico,72,49067,312,665,4,330148,176,24176,176,305972,0
2020-10-01,Rhode Island,44,24914,166,1117,3,343499,2898,24914,166,318585,2732
2020-10-01,South Carolina,45,148323,381,3400,22,1316454,7356,148323,381,1168131,6975
2020-10-01,South Dakota,46,23136,747,236,13,195003,4234,23136,747,171867,3487
2020-10-01,Tennessee,47,194601,1244,2473,44,2902732,18376,197432,1293,2705300,17083
2020-10-01,Texas,48,788066,4039,16220,118,6282329,45172,752501,3534,5529828,41638
2020-10-01,Utah,49,74099,1046,460,0,827136,7149,74050,1008,753086,6141
2020-10-01,Vermont,50,1755,3,58,0,162367,1007,1759,3,160608,1004
2020-10-01,Virgin Islands,78,1326,8,20,0,20771,210,1323,5,19448,205
2020-10-01,Virginia,51,148721,450,3228,20,2081967,24322,148721,450,1933246,23872
2020-10-01,Washington,53,92166,606,2227,5,1868089,13690,87522,480,1780567,13210
2020-10-01,West Virginia,54,16024,176,354,4,566588,5020,16024,176,550564,4844
2020-10-01,Wisconsin,55,132176,3004,1358,20,1566844,14474,132123,3000,1434721,11474
2020-10-01,Wyoming,56,6083,135,53,3,101295,135,6083,135,95212,0
2020-10-02,Alabama,01,156698,954,2550,2,1163310,6996,156698,954,1006612,6042
2020-10-02,Alaska,02,8964,126,53,0,469290,6967,8167,141,461123,6826
2020-10-02,Arizona,04,219778,564,5693,19,1483180,7208,219763,551,1263417,6657
2020-10-02,Arkansas,05,85779,958,1391,7,1057730,11824,85779,958,971951,10866
2020-10-02,California,06,828364,4058,16074,85,14868431,96580,817277,3590,14051154,92990
2020-10-02,Colorado,08,72454,731,2069,5,937921,10713,71898,680,866023,10033
2020-10-02,Connecticut,09,58297,555,4513,2,1676410,72030,58297,555,1618113,71475
2020-10-02,Delaware,10,20937,150,642,6,290283,2066,20937,150,269346,1916
2020-10-02,District of Columbia,11,15423,65,629,1,394118,3938,15423,65,378695,3873
2020-10-02,Florida,12,711796,2660,14553,110,5342929,25636,703212,2610,4639717,23026
2020-10-02,Georgia,13,304406,1396,6945,42,2970013,15621,320634,1300,2649379,14321
2020-10-02,Guam,66,3586,67,51,1,51118,570,2617,67,48501,503
2020-10-02,Hawaii,15,12754,94,141,3,300459,1817,12694,105,287765,1712
2020-10-02,Idaho,16,43528,613,478,5,315314,2296,42561,513,272753,1783
2020-10-02,Illinois,17,301540,2429,9007,51,5765867,72941,300385,2456,5465482,70485
2020-10-02,Indiana,18,124959,1500,3656,11,1398522,10791,122640,1464,1275882,9327
2020-10-02,Iowa,19,91483,1000,1377,11,775992,5049,87559,925,688433,4124
2020-10-02,Kansas,20,62424,1321,699,21,531117,9667,61111,1362,470006,8305
2020-10-02,Kentucky,21,74566,947,1232,7,1431600,22985,70727,999,1360873,21986
2020-10-02,Louisiana,22,168826,817,5545,26,2357449,22704,168826,817,2188623,21887
2020-10-02,Maine,23,5468,37,142,0,449290,6899,5468,37,443822,6862
2020-10-02,Maryland,24,126711,714,3950,1,1639785,11585,126222,712,1513563,10873
2020-10-02,Massachusetts,25,133631,761,9490,10,2276229,21459,133631,761,2142598,20698
2020-10-02,Michigan,26,140057,993,7110,7,3723748,40167,139996,984,3583752,39183
2020-10-02,Minnesota,27,101419,1166,2112,10,1447050,17475,101366,1166,1345684,16309
2020-10-02,Mississippi,28,99558,672,2999,20,738401,672,99558,672,638843,0
2020-10-02,Missouri,29,133725,1947,2207,23,1326189,10771,129397,1485,1196792,9286
2020-10-02,Montana,30,14044,418,186,5,353362,4653,13855,355,339507,4298
2020-10-02,Nebraska,31,46977,792,498,1,464264,4722,46185,621,418079,4101
2020-10-02,Nevada,32,81285,778,1611,8,706635,5078,81182,772,625453,4306
2020-10-02,New Hampshire,33,8534,217,442,1,277869,2035,8534,217,269335,1818
2020-10-02,New Jersey,34,208416,740,16131,4,3672127,58481,206629,740,3465498,57741
2020-10-02,New Mexico,35,30000,339,887,5,935401,7012,30000,339,905401,6673
2020-10-02,New York,36,466353,1601,32789,21,10976024,119493,461629,1598,10514395,117895
2020-10-02,North Carolina,37,215035,1817,3628,27,3099704,36043,214684,1775,2885020,34268
2020-10-02,North Dakota,38,22697,476,267,8,244312,1412,22694,476,221618,936
2020-10-02,Northern Mariana Islands,69,70,0,2,0,15185,3,73,3,15112,0
2020-10-02,Ohio,39,156809,1495,4905,88,3271748,31551,156809,1495,3114939,30056
2020-10-02,Oklahoma,40,89559,1190,1044,9,1230160,14719,89559,1190,1140601,13529
2020-10-02,Oregon,41,34180,315,566,5,697293,5348,34163,301,663130,5047
2020-10-02,Pennsylvania,42,166270,1192,8254,20,2066255,16493,161284,1161,1904971,15332
2020-10-02,Puerto Rico,72,49747,680,673,8,330477,329,24505,329,305972,0
2020-10-02,Rhode Island,44,25076,162,1118,1,345909,2410,25076,162,320833,2248
2020-10-02,South Carolina,45,149185,862,3409,9,1338052,21598,149185,862,1188867,20736
2020-10-02,South Dakota,46,23522,386,237,1,196261,1258,23522,386,172739,872
2020-10-02,Tennessee,47,195680,1079,2489,16,2919014,16282,198403,971,2720611,15311
2020-10-02,Texas,48,793962,5896,16307,87,6368742,86413,756004,3503,5612738,82910
2020-10-02,Utah,49,75175,1076,474,14,835124,7988,75157,1107,759967,6881
2020-10-02,Vermont,50,1768,13,58,0,163280,913,1773,14,161507,899
2020-10-02,Virgin Islands,78,1326,0,20,0,21011,240,1326,3,19685,237
2020-10-02,Virginia,51,149687,966,3250,22,2102198,20231,149687,966,1952511,19265
2020-10-02,Washington,53,92727,561,2239,12,1884704,16615,88116,594,1796588,16021
2020-10-02,West Virginia,54,16307,283,355,1,576499,9911,16307,283,560192,9628
2020-10-02,Wisconsin,55,134996,2820,1364,6,1580519,13675,134948,2825,1445571,10850
2020-10-02,Wyoming,56,6214,131,53,0,103278,1983,6214,131,97064,1852
2020-10-03,Alabama,01,158380,1682,2558,8,1174699,11389,158380,1682,1016319,9707
2020-10-03,Alaska,02,9111,147,54,1,473256,3966,8306,139,464950,3827
2020-10-03,Arizona,04,220403,625,5705,12,1492856,9676,220399,636,1272457,9040
2020-10-03,Arkansas,05,86525,746,1407,16,1068412,10682,86525,746,981887,9936
2020-10-03,California,06,831494,3130,16122,48,14998888,130457,819436,2159,14179452,128298
2020-10-03,Colorado,08,72929,475,2071,2,947395,9474,72555,657,874840,8817
2020-10-03,Connecticut,09,58297,0,4513,0,1676410,0,58297,0,1618113,0
2020-10-03,Delaware,10,21125,188,645,3,292458,2175,21125,188,271333,1987
2020-10-03,District of Columbia,11,15473,50,629,0,397549,3431,15473,50,382076,3381
2020-10-03,Florida,12,714583,2787,14627,74,5367833,24904,705965,2753,4661868,22151
2020-10-03,Georgia,13,305941,1535,6972,27,3001381,31368,322078,1444,2679303,29924
2020-10-03,Guam,66,3668,82,52,1,51756,638,2699,82,49057,556
2020-10-03,Hawaii,15,12887,133,152,11,302213,1754,12788,94,289425,1660
2020-10-03,Idaho,16,43702,174,480,2,318543,3229,43238,677,275305,2552
2020-10-03,Illinois,17,303807,2267,9033,26,5837501,71634,302827,2442,5534674,69192
2020-10-03,Indiana,18,126414,1455,3669,13,1408475,9953,124059,1419,1284416,8534
2020-10-03,Iowa,19,92302,819,1381,4,781309,5317,88470,911,692839,4406
2020-10-03,Kansas,20,62446,22,698,-1,531117,0,61111,0,470006,0
2020-10-03,Kentucky,21,75576,1010,1239,7,1443856,12256,72001,1274,1371855,10982
2020-10-03,Louisiana,22,168826,0,5545,0,2357449,0,168826,0,2188623,0
2020-10-03,Maine,23,5486,18,142,0,449308,18,5486,18,443822,0
2020-10-03,Maryland,24,127194,483,3957,7,1649725,9940,126819,597,1522906,9343
2020-10-03,Massachusetts,25,134303,672,9507,17,2290114,13885,134303,672,2155811,13213
2020-10-03,Michigan,26,141236,1179,7125,15,3764274,40526,141271,1275,3623003,39251
2020-10-03,Minnesota,27,102840,1421,2126,14,1462532,15482,102787,1421,1359745,14061
2020-10-03,Mississippi,28,100167,609,3011,12,739010,609,100167,609,638843,0
2020-10-03,Missouri,29,134826,1101,2220,13,1339556,13367,131105,1708,1208451,11659
2020-10-03,Montana,30,14490,446,186,0,354783,1421,14356,501,340427,920
2020-10-03,Nebraska,31,47403,426,503,5,469968,5704,46977,792,422991,4912
2020-10-03,Nevada,32,81829,544,1623,12,710210,3575,81708,526,628502,3049
2020-10-03,New Hampshire,33,8597,63,442,0,279564,1695,8597,63,270967,1632
2020-10-03,New Jersey,34,209363,947,16135,4,3673074,947,207576,947,3465498,0
2020-10-03,New Mexico,35,30296,296,890,3,941512,6111,30296,296,911216,5815
2020-10-03,New York,36,468081,1728,32794,5,11110291,134267,463360,1731,10646931,132536
2020-10-03,North Carolina,37,217049,2014,3647,19,3136266,36562,216886,2202,2919380,34360
2020-10-03,North Dakota,38,23137,440,274,7,246006,1694,23134,440,222872,1254
2020-10-03,Northern Mariana Islands,69,70,0,2,0,15185,0,73,0,15112,0
2020-10-03,Ohio,39,157966,1157,4925,20,3318775,47027,157966,1157,3160809,45870
2020-10-03,Oklahoma,40,90748,1189,1051,7,1247822,17662,90748,1189,1157074,16473
2020-10-03,Oregon,41,34512,332,572,6,701903,4610,34511,348,667392,4262
2020-10-03,Pennsylvania,42,166270,0,8271,17,2066255,0,161284,0,1904971,0
2020-10-03,Puerto Rico,72,50375,628,681,8,330776,299,24804,299,305972,0
2020-10-03,Rhode Island,44,25076,0,1118,0,348613,2704,25245,169,323368,2535
2020-10-03,South Carolina,45,150891,1706,3442,33,1339758,1706,150891,1706,1188867,0
2020-10-03,South Dakota,46,23986,464,248,11,198019,1758,23986,464,174033,1294
2020-10-03,Tennessee,47,196870,1190,2534,45,2936962,17948,199595,1192,2737367,16756
2020-10-03,Texas,48,799411,5449,16440,133,6472939,104197,763010,7006,5709929,97191
2020-10-03,Utah,49,76231,1056,476,2,842884,7760,76225,1068,766659,6692
2020-10-03,Vermont,50,1778,10,58,0,164142,862,1782,9,162360,853
2020-10-03,Virgin Islands,78,1327,1,20,0,21011,0,1326,0,19685,0
2020-10-03,Virginia,51,150803,1116,3270,20,2121758,19560,150803,1116,1970955,18444
2020-10-03,Washington,53,93160,433,2238,-1,1905759,21055,88810,694,1816949,20361
2020-10-03,West Virginia,54,16468,161,357,2,582705,6206,16468,161,566237,6045
2020-10-03,Wisconsin,55,138018,3022,1383,19,1594765,14246,138002,3054,1456763,11192
2020-10-03,Wyoming,56,6365,151,53,0,103429,151,6365,151,97064,0
2020-10-04,Alabama,01,159169,789,2558,0,1181242,6543,159169,789,1022073,5754
2020-10-04,Alaska,02,9300,189,54,0,476818,3562,8447,141,468371,3421
2020-10-04,Arizona,04,220757,354,5706,1,1500858,8002,220754,355,1280104,7647
2020-10-04,Arkansas,05,87013,488,1425,18,1076050,7638,87013,488,989037,7150
2020-10-04,California,06,834635,3141,16150,28,15160287,161399,823729,4293,14336558,157106
2020-10-04,Colorado,08,73389,460,2077,6,955819,8424,73076,521,882743,7903
2020-10-04,Connecticut,09,58297,0,4513,0,1676410,0,58297,0,1618113,0
2020-10-04,Delaware,10,21243,118,645,0,294089,1631,21243,118,272846,1513
2020-10-04,District of Columbia,11,15519,46,631,2,399825,2276,15519,46,384306,2230
2020-10-04,Florida,12,716451,1868,14670,43,5388166,20333,707751,1786,4680415,18547
2020-10-04,Georgia,13,306778,837,6999,27,3018618,17237,322925,847,2695693,16390
2020-10-04,Guam,66,3586,-82,53,1,51756,0,2699,0,49057,0
2020-10-04,Hawaii,15,12957,70,155,3,304149,1936,12921,133,291228,1803
2020-10-04,Idaho,16,43964,262,482,2,320578,2035,43702,464,276876,1571
2020-10-04,Illinois,17,305218,1411,9050,17,5889157,51656,304280,1453,5584877,50203
2020-10-04,Indiana,18,127501,1087,3674,5,1418063,9588,125146,1087,1292917,8501
2020-10-04,Iowa,19,92744,442,1387,6,785567,4258,89096,626,696471,3632
2020-10-04,Kansas,20,62479,33,698,0,531117,0,61111,0,470006,0
2020-10-04,Kentucky,21,76086,510,1242,3,1444472,616,72617,616,1371855,0
2020-10-04,Louisiana,22,169719,893,5577,32,2383670,26221,169719,893,2213951,25328
2020-10-04,Maine,23,5519,33,142,0,449341,33,5519,33,443822,0
2020-10-04,Maryland,24,127785,591,3958,1,1659847,10122,127290,471,1532557,9651
2020-10-04,Massachusetts,25,134947,644,9510,3,2309113,18999,134947,644,2174166,18355
2020-10-04,Michigan,26,141287,51,7125,0,3764274,0,141271,0,3623003,0
2020-10-04,Minnesota,27,103879,1039,2133,7,1480219,17687,103826,1039,1376393,16648
2020-10-04,Mississippi,28,100488,321,3013,2,739331,321,100488,321,638843,0
2020-10-04,Missouri,29,135691,865,2220,0,1350745,11189,132431,1326,1218314,9863
2020-10-04,Montana,30,14738,248,187,1,357413,2630,14635,279,342778,2351
2020-10-04,Nebraska,31,47807,404,504,1,473353,3385,47403,426,425950,2959
2020-10-04,Nevada,32,82134,305,1623,0,713389,3179,82100,392,631289,2787
2020-10-04,New Hampshire,33,8645,48,443,1,279612,48,8645,48,270967,0
2020-10-04,New Jersey,34,209989,626,16136,1,3734094,61020,208202,626,3525892,60394
2020-10-04,New Mexico,35,30477,181,892,2,947945,6433,30477,181,917468,6252
2020-10-04,New York,36,469307,1226,32813,19,11220620,110329,464582,1222,10756038,109107
2020-10-04,North Carolina,37,217641,592,3653,6,3160968,24702,217496,610,2943472,24092
2020-10-04,North Dakota,38,23553,416,277,3,247592,1586,23550,416,224042,1170
2020-10-04,Northern Mariana Islands,69,73,3,2,0,15185,0,73,0,15112,0
2020-10-04,Ohio,39,158907,941,4925,0,3356675,37900,158907,941,3197768,36959
2020-10-04,Oklahoma,40,91317,569,1052,1,1248391,569,91317,569,1157074,0
2020-10-04,Oregon,41,34771,259,573,1,705436,3533,34770,259,670666,3274
2020-10-04,Pennsylvania,42,168161,1891,8287,16,2095170,28915,163535,2251,1931635,26664
2020-10-04,Puerto Rico,72,50675,300,686,5,331006,230,25034,230,305972,0
2020-10-04,Rhode Island,44,25076,0,1118,0,350570,1957,25369,124,325201,1833
2020-10-04,South Carolina,45,151582,691,3453,11,1378086,38328,151582,691,1226504,37637
2020-10-04,South Dakota,46,24418,432,248,0,199775,1756,24418,432,175357,1324
2020-10-04,Tennessee,47,198262,1392,2550,16,2970388,33426,201210,1615,2769178,31811
2020-10-04,Texas,48,802440,3029,16471,31,6537885,64946,765894,2884,5771991,62062
2020-10-04,Utah,49,77618,1387,478,2,849830,6946,77618,1393,772212,5553
2020-10-04,Vermont,50,1785,7,58,0,164757,615,1788,6,162969,609
2020-10-04,Virgin Islands,78,1327,0,20,0,21239,228,1327,1,19912,227
2020-10-04,Virginia,51,151870,1067,3273,3,2122825,1067,151870,1067,1970955,0
2020-10-04,Washington,53,93527,367,2238,0,1922956,17197,89419,609,1833537,16588
2020-10-04,West Virginia,54,16628,160,358,1,590079,7374,16628,160,573451,7214
2020-10-04,Wisconsin,55,139941,1923,1388,5,1605641,10876,139928,1926,1465713,8950
2020-10-04,Wyoming,56,6504,139,53,0,103568,139,6504,139,97064,0
2020-10-05,Alabama,01,159713,544,2559,1,1186304,5062,159713,544,1026591,4518
2020-10-05,Alaska,02,9511,211,54,0,479374,2556,8643,196,470731,2360
2020-10-05,Arizona,04,221091,334,5707,1,1507610,6752,221070,316,1286540,6436
2020-10-05,Arkansas,05,87430,417,1447,22,1082876,6826,87430,417,995446,6409
2020-10-05,California,06,837720,3085,16179,29,15301681,141394,826784,3055,14474897,138339
2020-10-05,Colorado,08,74029,640,2085,8,962621,6802,73537,461,889084,6341
2020-10-05,Connecticut,09,59120,823,4517,4,1726721,50311,59120,823,1667601,49488
2020-10-05,Delaware,10,21363,120,645,0,295835,1746,21363,120,274472,1626
2020-10-05,District of Columbia,11,15547,28,631,0,401568,1743,15547,28,386021,1715
2020-10-05,Florida,12,717866,1415,14711,41,5403966,15800,709157,1406,4694809,14394
2020-10-05,Georgia,13,328127,21349,7028,29,3032757,14139,323714,789,2709043,13350
2020-10-05,Guam,66,3722,136,56,3,52365,609,2753,54,49612,555
2020-10-05,Hawaii,15,13007,50,156,1,306112,1963,12991,70,293121,1893
2020-10-05,Idaho,16,44832,868,487,5,322409,1831,43964,262,278445,1569
2020-10-05,Illinois,17,307428,2210,9071,21,5927695,38538,306133,1853,5621562,36685
2020-10-05,Indiana,18,128285,784,3681,7,1425175,7112,125976,830,1299199,6282
2020-10-05,Iowa,19,93261,517,1399,12,788014,2447,89460,364,698554,2083
2020-10-05,Kansas,20,63817,1338,706,8,541106,9989,62708,1597,478398,8392
2020-10-05,Kentucky,21,76787,701,1248,6,1463278,18806,73158,541,1390120,18265
2020-10-05,Louisiana,22,169937,218,5586,9,2391020,7350,169937,218,2221083,7132
2020-10-05,Maine,23,5545,26,142,0,466682,17341,5545,26,461137,17315
2020-10-05,Maryland,24,128277,492,3961,3,1668317,8470,127791,501,1540526,7969
2020-10-05,Massachusetts,25,135462,515,9530,20,2320428,11315,135462,515,2184966,10800
2020-10-05,Michigan,26,142757,1470,7141,16,3818827,54553,142726,1455,3676101,53098
2020-10-05,Minnesota,27,104852,973,2136,3,1494177,13958,104799,973,1389378,12985
2020-10-05,Mississippi,28,100703,215,3013,0,805358,66027,100703,215,704655,65812
2020-10-05,Missouri,29,137297,1606,2229,9,1358668,7923,133418,987,1225250,6936
2020-10-05,Montana,30,15127,389,190,3,369975,12562,14847,212,355128,12350
2020-10-05,Nebraska,31,48259,452,509,5,476952,3599,47807,404,429145,3195
2020-10-05,Nevada,32,82544,410,1624,1,716564,3175,82437,337,634127,2838
2020-10-05,New Hampshire,33,8680,35,444,1,281659,2047,8680,35,272979,2012
2020-10-05,New Jersey,34,210500,511,16138,2,3758058,23964,208713,511,3549345,23453
2020-10-05,New Mexico,35,30632,155,894,2,954596,6651,30632,155,923964,6496
2020-10-05,New York,36,470244,937,32827,14,11297024,76404,465515,933,10831509,75471
2020-10-05,North Carolina,37,220045,2404,3656,3,3193916,32948,219754,2258,2974162,30690
2020-10-05,North Dakota,38,23865,312,280,3,248652,1060,23862,312,224790,748
2020-10-05,Northern Mariana Islands,69,75,2,2,0,15196,11,75,2,15121,9
2020-10-05,Ohio,39,159964,1057,4931,6,3388186,31511,159964,1057,3228222,30454
2020-10-05,Oklahoma,40,91982,665,1055,3,1249056,665,91982,665,1157074,0
2020-10-05,Oregon,41,35056,285,574,1,709012,3576,35049,279,673963,3297
2020-10-05,Pennsylvania,42,169126,965,8300,13,2105159,9989,164207,672,1940952,9317
2020-10-05,Puerto Rico,72,51305,630,695,9,331369,363,25397,363,305972,0
2020-10-05,Rhode Island,44,25419,343,1121,3,351261,691,25419,50,325842,641
2020-10-05,South Carolina,45,152159,577,3456,3,1389106,11020,152159,577,1236947,10443
2020-10-05,South Dakota,46,24598,180,248,0,200443,668,24598,180,175845,488
2020-10-05,Tennessee,47,200603,2341,2570,20,3014664,44276,203699,2489,2810965,41787
2020-10-05,Texas,48,806535,4095,16519,48,6571677,33792,769303,3409,5802374,30383
2020-10-05,Utah,49,78733,1115,483,5,854412,4582,78723,1105,775689,3477
2020-10-05,Vermont,50,1817,32,58,0,165682,925,1821,33,163861,892
2020-10-05,Virgin Islands,78,1322,-5,20,0,21477,238,1322,-5,20155,243
2020-10-05,Virginia,51,152557,687,3276,3,2148109,25284,152557,687,1995552,24597
2020-10-05,Washington,53,94202,675,2253,15,1935899,12943,89874,455,1846025,12488
2020-10-05,West Virginia,54,16742,114,361,3,596531,6452,16742,114,579789,6338
2020-10-05,Wisconsin,55,141780,1839,1393,5,1614232,8591,141655,1727,1472577,6864
2020-10-05,Wyoming,56,6629,125,53,0,106162,2594,6629,125,99533,2469
2020-10-06,Alabama,01,160477,764,2580,21,1191770,5466,160477,764,1031293,4702
2020-10-06,Alaska,02,9656,145,54,0,479374,0,8790,147,470584,-147
2020-10-06,Arizona,04,221937,846,5713,6,1516207,8597,221934,864,1294273,7733
2020-10-06,Arkansas,05,88071,641,1469,22,1091512,8636,88071,641,1003441,7995
2020-10-06,California,06,840322,2602,16251,72,15430421,128740,828461,1677,14601960,127063
2020-10-06,Colorado,08,74535,506,2094,9,970591,7970,74191,654,896400,7316
2020-10-06,Connecticut,09,59241,121,4521,4,1744434,17713,59241,121,1685193,17592
2020-10-06,Delaware,10,21466,103,646,1,297513,1678,21466,103,276047,1575
2020-10-06,District of Columbia,11,15652,105,631,0,410029,8461,15652,105,394377,8356
2020-10-06,Florida,12,720117,2251,14766,55,5424811,20845,711358,2201,4713453,18644
2020-10-06,Georgia,13,329101,974,7062,34,3044792,12035,324650,936,2720142,11099
2020-10-06,Guam,66,3787,65,56,0,53012,647,2814,61,50198,586
2020-10-06,Hawaii,15,13090,83,159,3,307028,916,13041,50,293987,866
2020-10-06,Idaho,16,45487,655,494,7,324236,1827,44422,458,279814,1369
2020-10-06,Illinois,17,308990,1562,9100,29,5977208,49513,307750,1617,5669458,47896
2020-10-06,Indiana,18,129281,996,3711,30,1432219,7044,126946,970,1305273,6074
2020-10-06,Iowa,19,93909,648,1414,15,790843,2829,89934,474,700909,2355
2020-10-06,Kansas,20,64077,260,706,0,541106,0,62708,0,478398,0
2020-10-06,Kentucky,21,77741,954,1255,7,1475754,12476,74194,1036,1401560,11440
2020-10-06,Louisiana,22,170469,532,5592,6,2403780,12760,170469,532,2233311,12228
2020-10-06,Maine,23,5565,20,142,0,469220,2538,5565,20,463655,2518
2020-10-06,Maryland,24,128691,414,3967,6,1675227,6910,128204,413,1547023,6497
2020-10-06,Massachusetts,25,135957,495,9538,8,2333254,12826,135957,495,2197297,12331
2020-10-06,Michigan,26,143901,1144,7163,22,3844962,26135,143878,1152,3701084,24983
2020-10-06,Minnesota,27,105793,941,2140,4,1502736,8559,105740,941,1396996,7618
2020-10-06,Mississippi,28,101678,975,3027,14,805358,0,100703,0,704655,0
2020-10-06,Missouri,29,139172,1875,2258,29,1367139,8471,134583,1165,1232556,7306
2020-10-06,Montana,30,15633,506,192,2,372720,2745,15347,500,357373,2245
2020-10-06,Nebraska,31,48757,498,511,2,481013,4061,48259,452,432754,3609
2020-10-06,Nevada,32,83036,492,1630,6,718732,2168,82916,479,635816,1689
2020-10-06,New Hampshire,33,8731,51,446,2,283471,1812,8731,51,274740,1761
2020-10-06,New Jersey,34,211129,629,16147,9,3758687,629,209342,629,3549345,0
2020-10-06,New Mexico,35,30947,315,894,0,960934,6338,30947,315,929987,6023
2020-10-06,New York,36,471638,1394,32836,9,11393383,96359,466908,1393,10926475,94966
2020-10-06,North Carolina,37,221438,1393,3691,35,3216686,22770,221258,1504,2995428,21266
2020-10-06,North Dakota,38,24368,503,284,4,250087,1435,24364,502,225723,933
2020-10-06,Northern Mariana Islands,69,75,0,2,0,15196,0,75,0,15121,0
2020-10-06,Ohio,39,161299,1335,4947,16,3427972,39786,161299,1335,3266673,38451
2020-10-06,Oklahoma,40,93346,1364,1066,11,1280061,31005,93346,1364,1186715,29641
2020-10-06,Oregon,41,35347,291,581,7,713398,4386,35340,291,678058,4095
2020-10-06,Pennsylvania,42,170255,1129,8318,18,2117235,12076,165243,1036,1951992,11040
2020-10-06,Puerto Rico,72,51737,432,696,1,331607,238,25635,238,305972,0
2020-10-06,Rhode Island,44,25596,177,1125,4,354081,2820,25596,177,328485,2643
2020-10-06,South Carolina,45,152970,811,3471,15,1403136,14030,152970,811,1250166,13219
2020-10-06,South Dakota,46,24876,278,248,0,201477,1034,24876,278,176601,756
2020-10-06,Tennessee,47,202257,1654,2594,24,3040282,25618,205375,1676,2834907,23942
2020-10-06,Texas,48,811191,4656,16622,103,6636248,64571,773435,4132,5862813,60439
2020-10-06,Utah,49,79449,716,489,6,857060,2648,79439,716,777621,1932
2020-10-06,Vermont,50,1821,4,58,0,166167,485,1825,4,164342,481
2020-10-06,Virgin Islands,78,1321,-1,20,0,21477,0,1322,0,20155,0
2020-10-06,Virginia,51,153182,625,3291,15,2162363,14254,153182,625,2009181,13629
2020-10-06,Washington,53,94694,492,2261,8,1951407,15508,90276,402,1861131,15106
2020-10-06,West Virginia,54,16936,194,364,3,599553,3022,16936,194,582617,2828
2020-10-06,Wisconsin,55,143886,2106,1410,17,1625846,11614,143730,2075,1482116,9539
2020-10-06,Wyoming,56,6770,141,53,0,106682,520,6770,141,99912,379
2020-10-07,Alabama,01,161418,941,2601,21,1199944,8174,161418,941,1038526,7233
2020-10-07,Alaska,02,9784,128,55,1,490074,10700,8911,121,481163,10579
2020-10-07,Arizona,04,222558,621,5733,20,1523486,7279,222538,604,1300948,6675
2020-10-07,Arkansas,05,88880,809,1482,13,1101523,10011,88880,809,1012643,9202
2020-10-07,California,06,843732,3410,16358,107,15556706,126285,831225,2764,14725481,123521
2020-10-07,Colorado,08,75410,875,2097,3,980037,9446,74922,731,905115,8715
2020-10-07,Connecticut,09,59364,123,4522,1,1752045,7611,59364,123,1692681,7488
2020-10-07,Delaware,10,21550,84,649,3,299173,1660,21550,84,277623,1576
2020-10-07,District of Columbia,11,15697,45,632,1,412656,2627,15697,45,396959,2582
2020-10-07,Florida,12,722699,2582,14903,137,5450906,26095,713902,2544,4737004,23551
2020-10-07,Georgia,13,330769,1668,7089,27,3058187,13395,326142,1492,2732045,11903
2020-10-07,Guam,66,3837,50,58,2,53488,476,2868,54,50620,422
2020-10-07,Hawaii,15,13196,106,162,3,308277,1249,13124,83,295153,1166
2020-10-07,Idaho,16,46233,746,502,8,326191,1955,45082,660,281109,1295
2020-10-07,Illinois,17,311614,2624,9138,38,6036028,58820,310380,2630,5725648,56190
2020-10-07,Indiana,18,130569,1288,3727,16,1440917,8698,128227,1281,1312690,7417
2020-10-07,Iowa,19,95205,1296,1419,5,796057,5214,90884,950,705173,4264
2020-10-07,Kansas,20,65131,1054,725,19,549398,8292,63952,1244,485446,7048
2020-10-07,Kentucky,21,78669,928,1261,6,1491770,16016,76587,2393,1415183,13623
2020-10-07,Louisiana,22,172625,2156,5604,12,2427915,24135,172625,2156,2255290,21979
2020-10-07,Maine,23,5604,39,142,0,475749,6529,5604,39,470145,6490
2020-10-07,Maryland,24,129158,467,3973,6,1683904,8677,128664,460,1555240,8217
2020-10-07,Massachusetts,25,136492,535,9557,19,2349414,16160,136492,535,2212922,15625
2020-10-07,Michigan,26,145131,1230,7171,8,3879635,34673,145092,1214,3734543,33459
2020-10-07,Minnesota,27,106704,911,2154,14,1511141,8405,106651,911,1404490,7494
2020-10-07,Mississippi,28,102241,563,3051,24,806896,1538,102241,1538,704655,0
2020-10-07,Missouri,29,141262,2090,2334,76,1375015,7876,135651,1068,1239364,6808
2020-10-07,Montana,30,16194,561,193,1,376176,3456,16063,716,360113,2740
2020-10-07,Nebraska,31,49396,639,516,5,485994,4981,48757,498,437237,4483
2020-10-07,Nevada,32,83500,464,1639,9,720509,1777,83347,431,637162,1346
2020-10-07,New Hampshire,33,8800,69,448,2,285128,1657,8800,69,276328,1588
2020-10-07,New Jersey,34,211638,509,16152,5,3781810,23123,209850,508,3571960,22615
2020-10-07,New Mexico,35,31372,425,896,2,965319,4385,31372,425,933947,3960
2020-10-07,New York,36,472994,1356,32850,14,11501629,108246,468268,1360,11033361,106886
2020-10-07,North Carolina,37,223349,1911,3716,25,3235273,18587,222969,1711,3012304,16876
2020-10-07,North Dakota,38,24861,493,308,24,251673,1586,24857,493,226816,1093
2020-10-07,Northern Mariana Islands,69,75,0,2,0,15196,0,75,0,15121,0
2020-10-07,Ohio,39,162723,1424,4970,23,3458869,30897,162723,1424,3296146,29473
2020-10-07,Oklahoma,40,94352,1006,1075,9,1290623,10562,94352,1006,1196271,9556
2020-10-07,Oregon,41,35646,299,585,4,718568,5170,35634,294,682934,4876
2020-10-07,Pennsylvania,42,171550,1295,8347,29,2134094,16859,166552,1309,1967542,15550
2020-10-07,Puerto Rico,72,51768,31,705,9,331630,23,25658,23,305972,0
2020-10-07,Rhode Island,44,25776,180,1126,1,357350,3269,25776,180,331574,3089
2020-10-07,South Carolina,45,153705,735,3502,31,1410596,7460,153705,735,1256891,6725
2020-10-07,South Dakota,46,25906,1030,258,10,208780,7303,25906,1030,182874,6273
2020-10-07,Tennessee,47,204286,2029,2615,21,3062543,22261,207455,2080,2855088,20181
2020-10-07,Texas,48,817166,5975,16747,125,6664440,28192,777556,4121,5886884,24071
2020-10-07,Utah,49,80522,1073,499,10,862274,5214,80446,1007,781828,4207
2020-10-07,Vermont,50,1827,6,58,0,166732,565,1832,7,164900,558
2020-10-07,Virgin Islands,78,1322,1,20,0,21594,117,1321,-1,20273,118
2020-10-07,Virginia,51,153691,509,3303,12,2178542,16179,153691,509,2024851,15670
2020-10-07,Washington,53,95500,806,2274,13,1961067,9660,90663,387,1870404,9273
2020-10-07,West Virginia,54,17139,203,369,5,603345,3792,17139,203,586206,3589
2020-10-07,Wisconsin,55,146376,2490,1427,17,1639497,13651,146193,2463,1493304,11188
2020-10-07,Wyoming,56,6899,129,53,0,107845,1163,6899,129,100946,1034
2020-10-08,Alabama,01,161975,557,2637,36,1204021,4077,161975,557,1042046,3520
2020-10-08,Alaska,02,9919,135,56,1,491171,1097,9045,134,482126,963
2020-10-08,Arizona,04,223407,849,5743,10,1535900,12414,223401,863,1312499,11551
2020-10-08,Arkansas,05,90145,1265,1503,21,1115691,14168,90145,1265,1025546,12903
2020-10-08,California,06,847384,3652,16425,67,15623623,66917,834800,3575,14788823,63342
2020-10-08,Colorado,08,76186,776,2107,10,990222,10185,75785,863,914437,9322
2020-10-08,Connecticut,09,59748,384,4527,5,1779258,27213,59748,384,1719510,26829
2020-10-08,Delaware,10,21682,132,651,2,301502,2329,21682,132,279820,2197
2020-10-08,District of Columbia,11,15765,68,634,2,416816,4160,15765,68,401051,4092
2020-10-08,Florida,12,726005,3306,15067,164,5480893,29987,717148,3246,4763745,26741
2020-10-08,Georgia,13,332142,1373,7125,36,3083121,24934,327407,1265,2755714,23669
2020-10-08,Guam,66,3903,66,59,1,54071,583,2934,66,51137,517
2020-10-08,Hawaii,15,13297,101,163,1,308385,108,13232,108,295153,0
2020-10-08,Idaho,16,46848,615,504,2,328861,2670,45753,671,283108,1999
2020-10-08,Illinois,17,314725,3111,9173,35,6108519,72491,313439,3059,5795080,69432
2020-10-08,Indiana,18,132030,1461,3742,15,1451391,10474,129677,1450,1321714,9024
2020-10-08,Iowa,19,96749,1544,1433,14,803037,6980,92145,1261,710892,5719
2020-10-08,Kansas,20,65296,165,741,16,549398,0,63952,0,485446,0
2020-10-08,Kentucky,21,79550,881,1272,11,1511238,19468,77455,868,1433783,18600
2020-10-08,Louisiana,22,173149,524,5609,5,2440215,12300,173149,524,2267066,11776
2020-10-08,Maine,23,5639,35,142,0,482615,6866,5639,35,476976,6831
2020-10-08,Maryland,24,129919,761,3979,6,1696299,12395,129425,761,1566874,11634
2020-10-08,Massachusetts,25,136936,444,9565,8,2363484,14070,136936,444,2226548,13626
2020-10-08,Michigan,26,146548,1417,7194,23,3921840,42205,146493,1401,3775347,40804
2020-10-08,Minnesota,27,107975,1271,2160,6,1526559,15418,107922,1271,1418637,14147
2020-10-08,Mississippi,28,102819,578,3074,23,807474,578,102819,578,704655,0
2020-10-08,Missouri,29,142732,1470,2360,26,1387139,12124,137156,1505,1249983,10619
2020-10-08,Montana,30,16766,572,197,4,381665,5489,16677,614,364988,4875
2020-10-08,Nebraska,31,50059,663,518,2,490130,4136,49396,639,440734,3497
2020-10-08,Nevada,32,83971,471,1650,11,724198,3689,83827,480,640371,3209
2020-10-08,New Hampshire,33,8878,78,448,0,287628,2500,8878,78,278750,2422
2020-10-08,New Jersey,34,212936,1298,16161,9,3842667,60857,211148,1298,3631519,59559
2020-10-08,New Mexico,35,31756,384,899,3,973945,8626,31756,384,942189,8242
2020-10-08,New York,36,474829,1835,32859,9,11647440,145811,470104,1836,11177336,143975
2020-10-08,North Carolina,37,225738,2389,3744,28,3268955,33682,225397,2428,3043558,31254
2020-10-08,North Dakota,38,25388,527,314,6,253407,1734,25384,527,228023,1207
2020-10-08,Northern Mariana Islands,69,75,0,2,0,15196,0,75,0,15121,0
2020-10-08,Ohio,39,164262,1539,4983,13,3489730,30861,164262,1539,3325468,29322
2020-10-08,Oklahoma,40,95564,1212,1085,10,1304870,14247,95564,1212,1209306,13035
2020-10-08,Oregon,41,36121,475,596,11,724378,5810,36116,482,688262,5328
2020-10-08,Pennsylvania,42,172971,1421,8372,25,2153031,18937,167928,1376,1985103,17561
2020-10-08,Puerto Rico,72,52294,526,715,10,331982,352,26010,352,305972,0
2020-10-08,Rhode Island,44,26045,269,1127,1,364314,6964,26045,269,338269,6695
2020-10-08,South Carolina,45,154755,1050,3514,12,1430639,20043,154755,1050,1275884,18993
2020-10-08,South Dakota,46,26441,535,272,14,211261,2481,26411,505,184850,1976
2020-10-08,Tennessee,47,206265,1979,2676,61,3089853,27310,209447,1992,2880406,25318
2020-10-08,Texas,48,821732,4566,16853,106,6703106,38666,781794,4238,5921312,34428
2020-10-08,Utah,49,81975,1453,504,5,871780,9506,81947,1501,789833,8005
2020-10-08,Vermont,50,1838,11,58,0,167985,1253,1843,11,166142,1242
2020-10-08,Virgin Islands,78,1324,2,20,0,21688,94,1322,1,20366,93
2020-10-08,Virginia,51,155535,1844,3328,25,2198370,19828,155535,1844,2042835,17984
2020-10-08,Washington,53,96227,727,2280,6,1987477,26410,91208,545,1896269,25865
2020-10-08,West Virginia,54,17325,186,370,1,609660,6315,17325,186,592335,6129
2020-10-08,Wisconsin,55,149613,3237,1436,9,1656295,16798,149467,3274,1506828,13524
2020-10-08,Wyoming,56,7092,193,54,1,108942,1097,7092,193,101850,904
2020-10-09,Alabama,01,163465,1490,2653,16,1216017,11996,163465,1490,1052552,10506
2020-10-09,Alaska,02,10099,180,56,0,493070,1899,9232,187,483838,1712
2020-10-09,Arizona,04,224101,694,5746,3,1548282,12382,224084,683,1324198,11699
2020-10-09,Arkansas,05,91312,1167,1530,27,1115691,0,90145,0,1025546,0
2020-10-09,California,06,851228,3844,16502,77,15736497,112874,838606,3806,14897891,109068
2020-10-09,Colorado,08,77068,882,2115,8,1001087,10865,76619,834,924468,10031
2020-10-09,Connecticut,09,60038,290,4530,3,1796539,17281,60038,290,1736501,16991
2020-10-09,Delaware,10,21827,145,651,0,304367,2865,21827,145,282540,2720
2020-10-09,District of Columbia,11,15843,78,634,0,422225,5409,15843,78,406382,5331
2020-10-09,Florida,12,728913,2908,15185,118,5509242,28349,720001,2853,4789241,25496
2020-10-09,Georgia,13,333934,1792,7178,53,3112629,29508,329032,1625,2783597,27883
2020-10-09,Guam,66,3958,55,59,0,54495,424,2989,55,51506,369
2020-10-09,Hawaii,15,13461,164,165,2,308486,101,13333,101,295153,0
2020-10-09,Idaho,16,47674,826,506,2,331475,2614,46426,673,285049,1941
2020-10-09,Illinois,17,317501,2776,9207,34,6180417,71898,316556,3117,5863861,68781
2020-10-09,Indiana,18,133864,1834,3761,19,1463436,12045,131493,1816,1331943,10229
2020-10-09,Iowa,19,98023,1274,1454,21,808801,5764,93187,1042,715614,4722
2020-10-09,Kansas,20,67086,1790,765,24,560189,10791,65807,1855,494382,8936
2020-10-09,Kentucky,21,80633,1083,1283,11,1536085,24847,78456,1001,1457629,23846
2020-10-09,Louisiana,22,173406,257,5635,26,2450087,9872,173406,257,2276681,9615
2020-10-09,Maine,23,5666,27,143,1,491052,8437,5666,27,485386,8410
2020-10-09,Maryland,24,130652,733,3990,11,1707367,11068,130159,734,1577208,10334
2020-10-09,Massachusetts,25,137701,765,9577,12,2383082,19598,137701,765,2245381,18833
2020-10-09,Michigan,26,147880,1332,7202,8,3965016,43176,147816,1323,3817200,41853
2020-10-09,Minnesota,27,109365,1390,2174,14,1543542,16983,109312,1390,1434230,15593
2020-10-09,Mississippi,28,103681,862,3080,6,808336,862,103681,862,704655,0
2020-10-09,Missouri,29,145034,2302,2463,103,1399619,12480,139164,2008,1260455,10472
2020-10-09,Montana,30,17478,712,206,9,386746,5081,17399,722,369347,4359
2020-10-09,Nebraska,31,50168,109,522,4,494467,4337,50059,663,444408,3674
2020-10-09,Nevada,32,84785,814,1658,8,730234,6036,84593,766,645641,5270
2020-10-09,New Hampshire,33,8970,92,450,2,287628,0,8878,0,278750,0
2020-10-09,New Jersey,34,213801,865,16164,3,3878988,36321,212013,865,3666975,35456
2020-10-09,New Mexico,35,32241,485,902,3,980053,6108,32241,485,947812,5623
2020-10-09,New York,36,476422,1593,32867,8,11786740,139300,471696,1592,11315044,137708
2020-10-09,North Carolina,37,227756,2018,3768,24,3311285,42330,227431,2034,3083854,40296
2020-10-09,North Dakota,38,26044,656,325,11,255196,1789,26040,656,229156,1133
2020-10-09,Northern Mariana Islands,69,75,0,2,0,15196,0,75,0,15121,0
2020-10-09,Ohio,39,166102,1840,4994,11,3537962,48232,166102,1840,3371860,46392
2020-10-09,Oklahoma,40,97088,1524,1091,6,1321971,17101,97088,1524,1224883,15577
2020-10-09,Oregon,41,36538,417,600,4,730671,6293,36526,410,694145,5883
2020-10-09,Pennsylvania,42,174352,1381,8387,15,2169073,16042,169308,1380,1999765,14662
2020-10-09,Puerto Rico,72,52892,598,720,5,332298,316,26326,316,305972,0
2020-10-09,Rhode Island,44,26294,249,1130,3,368061,3747,26294,249,341767,3498
2020-10-09,South Carolina,45,155676,921,3530,16,1452568,21929,155676,921,1296892,21008
2020-10-09,South Dakota,46,27215,774,277,5,214153,2892,27215,804,186938,2088
2020-10-09,Tennessee,47,207823,1558,2702,26,3116772,26919,211003,1556,2905769,25363
2020-10-09,Texas,48,826241,4509,16955,102,6746030,42924,785830,4036,5960200,38888
2020-10-09,Utah,49,83307,1332,508,4,880169,8389,83290,1343,796879,7046
2020-10-09,Vermont,50,1846,8,58,0,168961,976,1851,8,167110,968
2020-10-09,Virgin Islands,78,1324,0,20,0,21758,70,1324,2,20434,68
2020-10-09,Virginia,51,156649,1114,3344,16,2228231,29861,156649,1114,2071582,28747
2020-10-09,Washington,53,96837,610,2288,8,2016471,28994,91918,710,1924553,28284
2020-10-09,West Virginia,54,17707,382,376,6,617623,7963,17707,382,599916,7581
2020-10-09,Wisconsin,55,152831,3218,1453,17,1671293,14998,152631,3164,1518662,11834
2020-10-09,Wyoming,56,7335,243,54,0,110511,1569,7335,243,103176,1326
2020-10-10,Alabama,01,164526,1061,2664,11,1223945,7928,164526,1061,1059419,6867
2020-10-10,Alaska,02,10350,251,56,0,499253,6183,9462,230,489791,5953
2020-10-10,Arizona,04,224985,884,5759,13,1560907,12625,224978,894,1335929,11731
2020-10-10,Arkansas,05,92220,908,1552,22,1142188,26497,92220,2075,1049968,24422
2020-10-10,California,06,854302,3074,16568,66,15878445,141948,842776,4170,15035669,137778
2020-10-10,Colorado,08,78047,979,2121,6,1012173,11086,77642,1023,934531,10063
2020-10-10,Connecticut,09,60038,0,4530,0,1796539,0,60038,0,1736501,0
2020-10-10,Delaware,10,21998,171,653,2,307645,3278,21998,171,285647,3107
2020-10-10,District of Columbia,11,15918,75,636,2,429099,6874,15918,75,413181,6799
2020-10-10,Florida,12,728913,0,15185,0,5509242,0,720001,0,4789241,0
2020-10-10,Georgia,13,335351,1417,7223,45,3132559,19930,330269,1237,2802290,18693
2020-10-10,Guam,66,4025,67,60,1,54816,321,3056,67,51760,254
2020-10-10,Hawaii,15,13532,71,167,2,308651,165,13498,165,295153,0
2020-10-10,Idaho,16,47927,253,508,2,335790,4315,47088,662,288702,3653
2020-10-10,Illinois,17,320283,2782,9235,28,6246673,66256,319461,2905,5927212,63351
2020-10-10,Indiana,18,135789,1925,3782,21,1474639,11203,133411,1918,1341228,9285
2020-10-10,Iowa,19,99099,1076,1460,6,814078,5277,94271,1084,719807,4193
2020-10-10,Kansas,20,67193,107,768,3,560189,0,65807,0,494382,0
2020-10-10,Kentucky,21,81630,997,1293,10,1547178,11093,79445,989,1467733,10104
2020-10-10,Louisiana,22,173406,0,5635,0,2450087,0,173406,0,2276681,0
2020-10-10,Maine,23,5696,30,143,0,491082,30,5696,30,485386,0
2020-10-10,Maryland,24,131169,517,3995,5,1719802,12435,130795,636,1589007,11799
2020-10-10,Massachusetts,25,138340,639,9587,10,2398294,15212,138340,639,2259954,14573
2020-10-10,Michigan,26,149406,1526,7221,19,4010309,45293,149464,1648,3860845,43645
2020-10-10,Minnesota,27,110881,1516,2184,10,1561103,17561,110828,1516,1450275,16045
2020-10-10,Mississippi,28,104638,957,3096,16,809293,957,104638,957,704655,0
2020-10-10,Missouri,29,148199,3165,2483,20,1447667,48048,144230,5066,1303437,42982
2020-10-10,Montana,30,18118,640,209,3,388649,1903,18117,718,370532,1185
2020-10-10,Nebraska,31,51887,1719,525,3,504432,9965,51144,1085,453288,8880
2020-10-10,Nevada,32,85463,678,1659,1,734943,4709,85399,806,649544,3903
2020-10-10,New Hampshire,33,9092,122,455,5,292451,4823,9092,214,283359,4609
2020-10-10,New Jersey,34,214665,864,16171,7,3914021,35033,212877,864,3701144,34169
2020-10-10,New Mexico,35,32722,481,907,5,989652,9599,32722,481,956930,9118
2020-10-10,New York,36,477870,1448,32875,8,11921319,134579,473143,1447,11448176,133132
2020-10-10,North Carolina,37,229959,2203,3786,18,3350815,39530,229752,2321,3121063,37209
2020-10-10,North Dakota,38,26632,588,340,15,257186,1990,26628,588,230558,1402
2020-10-10,Northern Mariana Islands,69,77,2,2,0,15198,2,77,2,15121,0
2020-10-10,Ohio,39,167458,1356,4997,3,3583857,45895,167458,1356,3416399,44539
2020-10-10,Oklahoma,40,98621,1533,1095,4,1339139,17168,98621,1533,1240518,15635
2020-10-10,Oregon,41,36925,387,600,0,736598,5927,36935,409,699663,5518
2020-10-10,Pennsylvania,42,175804,1452,8421,34,2190490,21417,171050,1742,2019440,19675
2020-10-10,Puerto Rico,72,53364,472,728,8,332530,232,26558,232,305972,0
2020-10-10,Rhode Island,44,26294,0,1130,0,373851,5790,26580,286,347271,5504
2020-10-10,South Carolina,45,156621,945,3551,21,1470311,17743,156621,945,1313690,16798
2020-10-10,South Dakota,46,27947,732,286,9,216485,2332,27947,732,188538,1600
2020-10-10,Tennessee,47,209593,1770,2729,27,3141232,24460,212649,1646,2928583,22814
2020-10-10,Texas,48,829758,3517,17019,64,6830631,84601,790060,4230,6040571,80371
2020-10-10,Utah,49,84697,1390,512,4,890719,10550,84644,1354,806075,9196
2020-10-10,Vermont,50,1857,11,58,0,169612,651,1861,10,167751,641
2020-10-10,Virgin Islands,78,1325,1,20,0,21758,0,1324,0,20434,0
2020-10-10,Virginia,51,157905,1256,3354,10,2247176,18945,157905,1256,2089271,17689
2020-10-10,Washington,53,97223,386,2289,1,2037946,21475,92560,642,1945386,20833
2020-10-10,West Virginia,54,17913,206,381,5,628006,10383,17913,206,610093,10177
2020-10-10,Wisconsin,55,155752,2921,1470,17,1685908,14615,155602,2971,1530306,11644
2020-10-10,Wyoming,56,7455,120,54,0,110631,120,7455,120,103176,0
2020-10-11,Alabama,01,165342,816,2664,0,1229759,5814,165342,816,1064417,4998
2020-10-11,Alaska,02,10608,258,56,0,502997,3744,9712,250,493285,3494
2020-10-11,Arizona,04,225575,590,5759,0,1571069,10162,225575,597,1345494,9565
2020-10-11,Arkansas,05,92833,613,1569,17,1151185,8997,92833,613,1058352,8384
2020-10-11,California,06,857076,2774,16581,13,16047004,168559,846579,3803,15200425,164756
2020-10-11,Colorado,08,78752,705,2134,13,1022564,10391,78461,819,944103,9572
2020-10-11,Connecticut,09,60038,0,4530,0,1796539,0,60038,0,1736501,0
2020-10-11,Delaware,10,22130,132,654,1,310570,2925,22130,132,288440,2793
2020-10-11,District of Columbia,11,15984,66,637,1,436167,7068,15984,66,420183,7002
2020-10-11,Florida,12,734483,5570,15363,178,5541455,32213,725415,5414,4816040,26799
2020-10-11,Georgia,13,336586,1235,7246,23,3151039,18480,331409,1140,2819630,17340
2020-10-11,Guam,66,4047,22,61,1,54971,155,3078,22,51893,133
2020-10-11,Hawaii,15,13633,101,168,1,308722,71,13569,71,295153,0
2020-10-11,Idaho,16,48155,228,508,0,338770,2980,47701,613,291069,2367
2020-10-11,Illinois,17,322985,2702,9245,10,6310720,64047,322188,2727,5988532,61320
2020-10-11,Indiana,18,137359,1570,3789,7,1486182,11543,134981,1570,1351201,9973
2020-10-11,Iowa,19,99941,842,1462,2,819460,5382,95346,1075,724114,4307
2020-10-11,Kansas,20,67231,38,769,1,560189,0,65807,0,494382,0
2020-10-11,Kentucky,21,82358,728,1295,2,1548025,847,80292,847,1467733,0
2020-10-11,Louisiana,22,174587,1181,5655,20,2488868,38781,174587,1181,2314281,37600
2020-10-11,Maine,23,5723,27,143,0,491109,27,5723,27,485386,0
2020-10-11,Maryland,24,131853,684,3999,4,1731844,12042,131357,562,1600487,11480
2020-10-11,Massachusetts,25,138903,563,9604,17,2414084,15790,138903,563,2275181,15227
2020-10-11,Michigan,26,149448,42,7221,0,4010309,0,149464,0,3860845,0
2020-10-11,Minnesota,27,112321,1440,2194,10,1578724,17621,112268,1440,1466456,16181
2020-10-11,Mississippi,28,104932,294,3101,5,809587,294,104932,294,704655,0
2020-10-11,Missouri,29,148481,282,2483,0,1447667,0,144230,0,1303437,0
2020-10-11,Montana,30,18733,615,210,1,390258,1609,18702,585,371556,1024
2020-10-11,Nebraska,31,52382,495,525,0,508921,4489,51887,743,457034,3746
2020-10-11,Nevada,32,85922,459,1663,4,738304,3361,85779,380,652525,2981
2020-10-11,New Hampshire,33,9143,51,456,1,292451,0,9092,0,283359,0
2020-10-11,New Jersey,34,215416,751,16174,3,3914772,751,213628,751,3701144,0
2020-10-11,New Mexico,35,32983,261,911,4,997373,7721,32983,261,964390,7460
2020-10-11,New York,36,479013,1143,32879,4,12039573,118254,474286,1143,11565287,117111
2020-10-11,North Carolina,37,231564,1605,3791,5,3388250,37435,231471,1719,3156779,35716
2020-10-11,North Dakota,38,27269,637,343,3,259036,1850,27265,637,231771,1213
2020-10-11,Northern Mariana Islands,69,77,0,2,0,15198,0,77,0,15121,0
2020-10-11,Ohio,39,168749,1291,4999,2,3623321,39464,168749,1291,3454572,38173
2020-10-11,Oklahoma,40,99387,766,1098,3,1339905,766,99387,766,1240518,0
2020-10-11,Oregon,41,37263,338,600,0,741233,4635,37262,327,703971,4308
2020-10-11,Pennsylvania,42,176820,1016,8426,5,2205861,15371,172216,1166,2033645,14205
2020-10-11,Puerto Rico,72,53671,307,730,2,332748,218,26776,218,305972,0
2020-10-11,Rhode Island,44,26294,0,1130,0,377850,3999,26750,170,351100,3829
2020-10-11,South Carolina,45,157406,785,3552,1,1484658,14347,157406,785,1327252,13562
2020-10-11,South Dakota,46,28564,617,286,0,218111,1626,28564,617,189547,1009
2020-10-11,Tennessee,47,211426,1833,2738,9,3172361,31129,214717,2068,2957644,29061
2020-10-11,Texas,48,832750,2992,17047,28,6887551,56920,792478,2418,6095073,54502
2020-10-11,Utah,49,85844,1147,518,6,896766,6047,85844,1200,810922,4847
2020-10-11,Vermont,50,1868,11,58,0,171216,1604,1871,10,169345,1594
2020-10-11,Virgin Islands,78,1325,0,20,0,21945,187,1325,1,20620,186
2020-10-11,Virginia,51,158716,811,3358,4,2265905,18729,158716,811,2107189,17918
2020-10-11,Washington,53,97527,304,2289,0,2061438,23492,93035,475,1968403,23017
2020-10-11,West Virginia,54,18128,215,382,1,633942,5936,18128,215,615814,5721
2020-10-11,Wisconsin,55,158426,2674,1477,7,1696192,10284,158315,2713,1537877,7571
2020-10-11,Wyoming,56,7611,156,54,0,110787,156,7611,156,103176,0
2020-10-12,Alabama,01,166076,734,2665,1,1234463,4704,166076,734,1068387,3970
2020-10-12,Alaska,02,10805,197,56,0,505927,2930,9903,191,496024,2739
2020-10-12,Arizona,04,226072,497,5759,0,1579111,8042,226050,475,1353061,7567
2020-10-12,Arkansas,05,93487,654,1586,17,1159683,8498,93487,654,1066196,7844
2020-10-12,California,06,859959,2883,16594,13,16191341,144337,850028,3449,15341313,140888
2020-10-12,Colorado,08,79499,747,2144,10,1028709,6145,79037,576,949672,5569
2020-10-12,Connecticut,09,61377,1339,4532,2,1896944,100405,61377,1339,1835567,99066
2020-10-12,Delaware,10,22289,159,656,2,314281,3711,22289,159,291992,3552
2020-10-12,District of Columbia,11,16022,38,637,0,438819,2652,16022,38,422797,2614
2020-10-12,Florida,12,736016,1533,15411,48,5558193,16738,726934,1519,4831259,15219
2020-10-12,Georgia,13,339577,2991,7259,13,3168126,17087,332311,902,2835815,16185
2020-10-12,Guam,66,4139,92,61,0,55690,719,3170,92,52520,627
2020-10-12,Hawaii,15,13675,42,168,0,308823,101,13670,101,295153,0
2020-10-12,Idaho,16,48663,508,511,3,340623,1853,48066,365,292557,1488
2020-10-12,Illinois,17,325755,2770,9258,13,6358299,47579,324930,2742,6033369,44837
2020-10-12,Indiana,18,138933,1574,3795,6,1495852,9670,136555,1574,1359297,8096
2020-10-12,Iowa,19,100451,510,1481,19,822140,2680,95809,463,726331,2217
2020-10-12,Kansas,20,69158,1927,774,5,572081,11892,67862,2055,504219,9837
2020-10-12,Kentucky,21,83074,716,1300,5,1576416,28391,80930,638,1495486,27753
2020-10-12,Louisiana,22,174647,60,5669,14,2492265,3397,174647,60,2317618,3337
2020-10-12,Maine,23,5752,29,143,0,491138,29,5752,29,485386,0
2020-10-12,Maryland,24,132357,504,4003,4,1742435,10591,131861,504,1610574,10087
2020-10-12,Massachusetts,25,139663,760,9617,13,2432880,18796,139663,760,2293217,18036
2020-10-12,Michigan,26,151284,1836,7227,6,4061097,50788,151396,1932,3909701,48856
2020-10-12,Minnesota,27,113492,1171,2197,3,1589752,11028,113439,1171,1476313,9857
2020-10-12,Mississippi,28,105228,296,3101,0,809883,296,105228,296,704655,0
2020-10-12,Missouri,29,149460,979,2484,1,1447667,0,144230,0,1303437,0
2020-10-12,Montana,30,19205,472,212,2,400458,10200,19125,423,381333,9777
2020-10-12,Nebraska,31,52839,457,529,4,511938,3017,52382,495,459556,2522
2020-10-12,Nevada,32,86433,511,1670,7,741168,2864,86348,569,654820,2295
2020-10-12,New Hampshire,33,9208,65,456,0,293576,1125,9143,51,284433,1074
2020-10-12,New Jersey,34,215885,469,16175,1,3971597,56825,214097,469,3757500,56356
2020-10-12,New Mexico,35,33362,379,915,4,1002906,5533,33362,379,969544,5154
2020-10-12,New York,36,480045,1032,32896,17,12131366,91793,475315,1029,11656051,90764
2020-10-12,North Carolina,37,233059,1495,3799,8,3417814,29564,232747,1276,3185067,28288
2020-10-12,North Dakota,38,27742,473,350,7,260339,1303,27737,472,232602,831
2020-10-12,Northern Mariana Islands,69,77,0,2,0,15198,0,77,0,15121,0
2020-10-12,Ohio,39,170179,1430,5005,6,3661924,38603,170179,1430,3491745,37173
2020-10-12,Oklahoma,40,100184,797,1104,6,1340702,797,100184,797,1240518,0
2020-10-12,Oregon,41,37472,209,600,0,745255,4022,37467,205,707788,3817
2020-10-12,Pennsylvania,42,177844,1024,8444,18,2218010,12149,173304,1088,2044706,11061
2020-10-12,Puerto Rico,72,54234,563,735,5,332976,228,27004,228,305972,0
2020-10-12,Rhode Island,44,26294,0,1130,0,379100,1250,26831,81,352269,1169
2020-10-12,South Carolina,45,158055,649,3559,7,1497817,13159,158055,649,1339762,12510
2020-10-12,South Dakota,46,28925,361,288,2,219244,1133,28925,361,190319,772
2020-10-12,Tennessee,47,214245,2819,2745,7,3211720,39359,217682,2965,2994038,36394
2020-10-12,Texas,48,836807,4057,17073,26,6951394,63843,795126,2648,6156268,61195
2020-10-12,Utah,49,86879,1035,524,6,900997,4231,86832,988,814165,3243
2020-10-12,Vermont,50,1876,8,58,0,172069,853,1880,9,170189,844
2020-10-12,Virgin Islands,78,1325,0,20,0,21945,0,1325,0,20620,0
2020-10-12,Virginia,51,159570,854,3361,3,2281091,15186,159570,854,2121521,14332
2020-10-12,Washington,53,98265,738,2292,3,2061438,0,93035,0,1968403,0
2020-10-12,West Virginia,54,18281,153,385,3,639434,5492,18281,153,621153,5339
2020-10-12,Wisconsin,55,160655,2229,1488,11,1706023,9831,160331,2016,1545692,7815
2020-10-12,Wyoming,56,7802,191,54,0,110978,191,7802,191,103176,0
2020-10-13,Alabama,01,167193,1117,2665,0,1241317,6854,167193,1117,1074124,5737
2020-10-13,Alaska,02,10960,155,56,0,514789,8862,10059,156,504730,8706
2020-10-13,Arizona,04,226749,677,5767,8,1586081,6970,226734,684,1359347,6286
2020-10-13,Arkansas,05,94167,680,1611,25,1167481,7798,94167,680,1073314,7118
2020-10-13,California,06,863614,3655,16650,56,16333717,142376,852406,2378,15481311,139998
2020-10-13,Colorado,08,80414,915,2181,37,1037975,9266,80085,1048,957890,8218
2020-10-13,Connecticut,09,61697,320,4533,1,1910348,13404,61697,320,1848651,13084
2020-10-13,Delaware,10,22394,105,659,3,315752,1471,22394,105,293358,1366
2020-10-13,District of Columbia,11,16068,46,637,0,443081,4262,16068,46,427013,4216
2020-10-13,Florida,12,738741,2725,15530,119,5584266,26073,729591,2657,4854675,23416
2020-10-13,Georgia,13,340758,1181,7282,23,3180548,12422,333304,993,2847244,11429
2020-10-13,Guam,66,4235,96,62,1,56368,678,3266,96,53102,582
2020-10-13,Hawaii,15,13736,61,172,4,308865,42,13712,42,295153,0
2020-10-13,Idaho,16,49987,1324,514,3,343003,2380,48663,597,294340,1783
2020-10-13,Illinois,17,329160,3405,9288,30,6414292,55993,327781,2851,6086511,53142
2020-10-13,Indiana,18,140505,1572,3822,27,1503923,8071,138104,1549,1365819,6522
2020-10-13,Iowa,19,101531,1080,1491,10,824869,2729,96338,529,728531,2200
2020-10-13,Kansas,20,69392,234,786,12,572081,0,67862,0,504219,0
2020-10-13,Kentucky,21,83967,893,1318,18,1602616,26200,81691,761,1520925,25439
2020-10-13,Louisiana,22,175329,682,5679,10,2512847,20582,175329,682,2337518,19900
2020-10-13,Maine,23,5780,28,143,0,514278,23140,5780,28,508498,23112
2020-10-13,Maryland,24,132839,482,4012,9,1751309,8874,132343,482,1618966,8392
2020-10-13,Massachusetts,25,140412,749,9630,13,2446741,13861,140412,749,2306329,13112
2020-10-13,Michigan,26,152842,1558,7257,30,4099559,38462,152862,1466,3946697,36996
2020-10-13,Minnesota,27,114627,1135,2204,7,1600861,11109,114574,1135,1486287,9974
2020-10-13,Mississippi,28,105941,713,3115,14,810596,713,105941,713,704655,0
2020-10-13,Missouri,29,150496,1036,2495,11,1447667,0,144230,0,1303437,0
2020-10-13,Montana,30,19682,477,217,5,409651,9193,19611,486,390040,8707
2020-10-13,Nebraska,31,53543,704,533,4,515493,3555,52839,457,462654,3098
2020-10-13,Nevada,32,86970,537,1677,7,743677,2509,86835,487,656842,2022
2020-10-13,New Hampshire,33,9279,71,456,0,297850,4274,9279,136,288571,4138
2020-10-13,New Jersey,34,216873,988,16182,7,3972585,988,215085,988,3757500,0
2020-10-13,New Mexico,35,33713,351,918,3,1011320,8414,33713,351,977607,8063
2020-10-13,New York,36,481436,1391,32905,9,12230436,99070,476708,1393,11753728,97677
2020-10-13,North Carolina,37,234842,1783,3849,50,3444583,26769,234481,1734,3210102,25035
2020-10-13,North Dakota,38,28250,508,362,12,261745,1406,28245,508,233500,898
2020-10-13,Northern Mariana Islands,69,77,0,2,0,15198,0,77,0,15121,0
2020-10-13,Ohio,39,171626,1447,5017,12,3698741,36817,171626,1447,3527115,35370
2020-10-13,Oklahoma,40,101493,1309,1119,15,1373716,33014,101493,1309,1272223,31705
2020-10-13,Oregon,41,37788,316,605,5,751277,6022,37780,313,713497,5709
2020-10-13,Pennsylvania,42,179673,1829,8458,14,2234739,16729,174646,1342,2060093,15387
2020-10-13,Puerto Rico,72,54540,306,738,3,333111,135,27139,135,305972,0
2020-10-13,Rhode Island,44,26960,666,1139,9,380694,1594,26960,129,353734,1465
2020-10-13,South Carolina,45,158883,828,3576,17,1511481,13664,158883,828,1352598,12836
2020-10-13,South Dakota,46,29339,414,288,0,220402,1158,29339,414,191063,744
2020-10-13,Tennessee,47,215423,1178,2768,23,3225624,13904,218829,1147,3006795,12757
2020-10-13,Texas,48,842316,5509,17165,92,7012023,60629,800415,5289,6211608,55340
2020-10-13,Utah,49,87825,946,524,0,909124,8127,87819,987,821305,7140
2020-10-13,Vermont,50,1886,10,58,0,172773,704,1891,11,170882,693
2020-10-13,Virgin Islands,78,1328,3,20,0,22062,117,1325,0,20737,117
2020-10-13,Virginia,51,160805,1235,3372,11,2302010,20919,160805,1235,2141205,19684
2020-10-13,Washington,53,99311,1046,2311,19,2123908,62470,94775,1740,2029133,60730
2020-10-13,West Virginia,54,18555,274,387,2,644666,5232,18555,274,626111,4958
2020-10-13,Wisconsin,55,164137,3482,1521,33,1720713,14690,163759,3428,1556954,11262
2020-10-13,Wyoming,56,7964,162,57,3,113843,2865,7964,162,105879,2703
2020-10-14,Alabama,01,167977,784,2706,41,1246453,5136,167977,784,1078476,4352
2020-10-14,Alaska,02,11103,143,60,4,517177,2388,10214,155,506963,2233
2020-10-14,Arizona,04,227660,911,5772,5,1594245,8164,227635,901,1366610,7263
2020-10-14,Arkansas,05,95246,1079,1634,23,1178353,10872,95246,1079,1083107,9793
2020-10-14,California,06,867094,3480,16752,102,16425487,91770,855072,2666,15570415,89104
2020-10-14,Colorado,08,81205,791,2186,5,1045267,7292,80777,692,964490,6600
2020-10-14,Connecticut,09,61861,164,4537,4,1918724,8376,61861,164,1856863,8212
2020-10-14,Delaware,10,22465,71,660,1,316823,1071,22465,71,294358,1000
2020-10-14,District of Columbia,11,16132,64,638,1,448262,5181,16132,64,432130,5117
2020-10-14,Florida,12,741624,2883,15594,64,5606014,21748,732399,2808,4873615,18940
2020-10-14,Georgia,13,342302,1544,7298,16,3204308,23760,334601,1297,2869707,22463
2020-10-14,Guam,66,4310,75,62,0,56894,526,3341,75,53553,451
2020-10-14,Hawaii,15,13834,98,182,10,308926,61,13773,61,295153,0
2020-10-14,Idaho,16,50534,547,520,6,345863,2860,49247,584,296616,2276
2020-10-14,Illinois,17,332124,2964,9335,47,6466961,52669,330643,2862,6136318,49807
2020-10-14,Indiana,18,141670,1165,3836,14,1511060,7137,139269,1165,1371791,5972
2020-10-14,Iowa,19,102905,1374,1505,14,829253,4384,97384,1046,731869,3338
2020-10-14,Kansas,20,70665,1273,838,52,579827,7746,69155,1293,510672,6453
2020-10-14,Kentucky,21,85278,1311,1325,7,1613841,11225,83013,1322,1530828,9903
2020-10-14,Louisiana,22,176209,880,5695,16,2519723,6876,176209,880,2343514,5996
2020-10-14,Maine,23,5816,36,143,0,520402,6124,5816,36,514586,6088
2020-10-14,Maryland,24,133413,574,4022,10,1760654,9345,132918,575,1627736,8770
2020-10-14,Massachusetts,25,140992,580,9647,17,2459860,13119,140992,580,2318868,12539
2020-10-14,Michigan,26,154409,1567,7270,13,4129412,29853,154455,1593,3974957,28260
2020-10-14,Minnesota,27,115996,1369,2233,29,1613411,12550,115943,1369,1497468,11181
2020-10-14,Mississippi,28,106817,876,3140,25,811472,876,106817,876,704655,0
2020-10-14,Missouri,29,154213,3717,2598,103,1352161,-95506,148679,4449,1203482,-99955
2020-10-14,Montana,30,20321,639,225,8,414579,4928,20210,599,394369,4329
2020-10-14,Nebraska,31,54467,924,536,3,519411,3918,53543,704,465868,3214
2020-10-14,Nevada,32,87527,557,1694,17,747418,3741,87314,479,660104,3262
2020-10-14,New Hampshire,33,9349,70,458,2,301619,3769,9349,70,292270,3699
2020-10-14,New Jersey,34,217812,939,16191,9,4036867,64282,216023,938,3820844,63344
2020-10-14,New Mexico,35,34290,577,921,3,1019029,7709,34290,577,984739,7132
2020-10-14,New York,36,482671,1235,32916,11,12342180,111744,477940,1232,11864240,110512
2020-10-14,North Carolina,37,236812,1970,3882,33,3467235,22652,236407,1926,3230828,20726
2020-10-14,North Dakota,38,28952,702,370,8,263233,1488,28947,702,234286,786
2020-10-14,Northern Mariana Islands,69,77,0,2,0,15533,335,77,0,15456,335
2020-10-14,Ohio,39,173665,2039,5033,16,3726652,27911,173665,2039,3552987,25872
2020-10-14,Oklahoma,40,102615,1122,1132,13,1385669,11953,102615,1122,1283054,10831
2020-10-14,Oregon,41,38175,387,609,4,761552,10275,38160,380,723392,9895
2020-10-14,Pennsylvania,42,180956,1283,8481,23,2250651,15912,175922,1276,2074729,14636
2020-10-14,Puerto Rico,72,55516,976,742,4,333601,490,27629,490,305972,0
2020-10-14,Rhode Island,44,27164,204,1147,8,383063,2369,27164,204,355899,2165
2020-10-14,South Carolina,45,159809,926,3593,17,1526565,15084,159809,926,1366756,14158
2020-10-14,South Dakota,46,30215,876,291,3,222321,1919,30215,876,192106,1043
2020-10-14,Tennessee,47,217140,1717,2801,33,3243821,18197,220538,1709,3023283,16488
2020-10-14,Texas,48,848168,5852,17276,111,7067676,55653,805082,4667,6262594,50986
2020-10-14,Utah,49,89018,1193,529,5,917021,7897,88963,1144,828058,6753
2020-10-14,Vermont,50,1889,3,58,0,173428,655,1894,3,171534,652
2020-10-14,Virgin Islands,78,1328,0,20,0,22187,125,1328,3,20859,122
2020-10-14,Virginia,51,161610,805,3381,9,2313940,11930,161610,805,2152330,11125
2020-10-14,Washington,53,100068,757,2319,8,2123908,0,94775,0,2029133,0
2020-10-14,West Virginia,54,18818,263,391,4,649465,4799,18818,263,630647,4536
2020-10-14,Wisconsin,55,167441,3304,1549,28,1735471,14758,167082,3323,1568389,11435
2020-10-14,Wyoming,56,8177,213,57,0,111026,-2817,8177,213,102849,-3030
2020-10-15,Alabama,01,169162,1185,2756,50,1254577,8124,169162,1185,1085415,6939
2020-10-15,Alaska,02,11268,165,61,1,519461,2284,10380,166,509081,2118
2020-10-15,Arizona,04,228748,1088,5789,17,1606089,11844,228748,1113,1377341,10731
2020-10-15,Arkansas,05,96524,1278,1645,11,1191223,12870,96524,1278,1094699,11592
2020-10-15,California,06,870380,3286,16839,87,16517812,92325,858401,3329,15659411,88996
2020-10-15,Colorado,08,82443,1238,2187,1,1056107,10840,81918,1141,974189,9699
2020-10-15,Connecticut,09,62028,167,4540,3,1934569,15845,62028,167,1872541,15678
2020-10-15,Delaware,10,22560,95,661,1,318633,1810,22560,95,296073,1715
2020-10-15,District of Columbia,11,16166,34,638,0,450614,2352,16166,34,434448,2318
2020-10-15,Florida,12,744980,3356,15735,141,5634218,28204,735685,3286,4898533,24918
2020-10-15,Georgia,13,344093,1791,7320,22,3229781,25473,336241,1640,2893540,23833
2020-10-15,Guam,66,4396,86,62,0,57465,571,3427,86,54038,485
2020-10-15,Hawaii,15,13922,88,183,1,309025,99,13872,99,295153,0
2020-10-15,Idaho,16,51471,937,521,1,348111,2248,49892,645,298219,1603
2020-10-15,Illinois,17,336211,4087,9392,57,6534047,67086,334658,4015,6199389,63071
2020-10-15,Indiana,18,143617,1947,3864,28,1521402,10342,141212,1943,1380190,8399
2020-10-15,Iowa,19,104232,1327,1516,11,835606,6353,98717,1333,736889,5020
2020-10-15,Kansas,20,70815,150,838,0,579827,0,69155,0,510672,0
2020-10-15,Kentucky,21,86410,1132,1341,16,1645379,31538,84195,1182,1561184,30356
2020-10-15,Louisiana,22,176952,743,5707,12,2546007,26284,176952,743,2369055,25541
2020-10-15,Maine,23,5836,20,144,1,526067,5665,5836,20,520231,5645
2020-10-15,Maryland,24,134042,629,4028,6,1770835,10181,133548,630,1637287,9551
2020-10-15,Massachusetts,25,141579,587,9672,25,2474616,14756,141579,587,2333037,14169
2020-10-15,Michigan,26,156926,2517,7304,34,4171989,42577,156913,2458,4015076,40119
2020-10-15,Minnesota,27,117159,1163,2252,19,1623517,10106,117106,1163,1506411,8943
2020-10-15,Mississippi,28,108139,1322,3152,12,812794,1322,108139,1322,704655,0
2020-10-15,Missouri,29,156142,1929,2531,-67,1359246,7085,150554,1875,1208692,5210
2020-10-15,Montana,30,21043,722,230,5,419832,5253,20933,723,398899,4530
2020-10-15,Nebraska,31,55428,961,546,10,523777,4366,54467,924,469310,3442
2020-10-15,Nevada,32,88081,554,1700,6,745344,-2074,87969,655,657375,-2729
2020-10-15,New Hampshire,33,9426,77,463,5,303576,1957,9426,77,294150,1880
2020-10-15,New Jersey,34,218783,971,16197,6,4070357,33490,216994,971,3853363,32519
2020-10-15,New Mexico,35,34958,668,922,1,1027392,8363,34958,668,992434,7695
2020-10-15,New York,36,484135,1464,32935,19,12475392,133212,479400,1460,11995992,131752
2020-10-15,North Carolina,37,239338,2526,3899,17,3500763,33528,238939,2532,3261824,30996
2020-10-15,North Dakota,38,29658,706,375,5,264761,1528,29653,706,235108,822
2020-10-15,Northern Mariana Islands,69,80,3,2,0,15533,0,77,0,15456,0
2020-10-15,Ohio,39,175843,2178,5038,5,3760979,34327,175843,2178,3585136,32149
2020-10-15,Oklahoma,40,103836,1221,1143,11,1398768,13099,103836,1221,1294932,11878
2020-10-15,Oregon,41,38536,361,613,4,769276,7724,38525,365,730751,7359
2020-10-15,Pennsylvania,42,182502,1546,8496,15,2266717,16066,177520,1598,2089197,14468
2020-10-15,Puerto Rico,72,56085,569,743,1,333919,318,27947,318,305972,0
2020-10-15,Rhode Island,44,27438,274,1149,2,386776,3713,27438,274,359338,3439
2020-10-15,South Carolina,45,161106,1297,3607,14,1546608,20043,161106,1297,1385502,18746
2020-10-15,South Dakota,46,31012,797,304,13,224239,1918,31012,797,193227,1121
2020-10-15,Tennessee,47,219355,2215,2836,35,3268663,24842,222827,2289,3045836,22553
2020-10-15,Texas,48,853977,5809,17362,86,7111890,44214,809808,4726,6302082,39488
2020-10-15,Utah,49,90488,1470,531,2,923932,6911,90461,1498,833471,5413
2020-10-15,Vermont,50,1903,14,58,0,174471,1043,1910,16,172561,1027
2020-10-15,Virgin Islands,78,1329,1,21,1,22365,178,1327,-1,21038,179
2020-10-15,Virginia,51,162941,1331,3388,7,2336626,22686,162941,1331,2173685,21355
2020-10-15,Washington,53,100838,770,2331,12,2146509,22601,95509,734,2051000,21867
2020-10-15,West Virginia,54,19082,264,393,2,656414,6949,19082,264,637332,6685
2020-10-15,Wisconsin,55,171480,4039,1568,19,1750966,15495,171122,4040,1579844,11455
2020-10-15,Wyoming,56,8375,198,57,0,116389,5363,8375,198,108014,5165
2020-10-16,Alabama,01,170374,1212,2786,30,1261832,7255,170374,1212,1091458,6043
2020-10-16,Alaska,02,11496,228,62,1,522664,3203,10601,221,512063,2982
2020-10-16,Arizona,04,229508,760,5806,17,1614467,8378,229486,738,1384981,7640
2020-10-16,Arkansas,05,97539,1015,1665,20,1203320,12097,97539,1015,1105781,11082
2020-10-16,California,06,874101,3721,16901,62,16621956,104144,861476,3075,15760480,101069
2020-10-16,Colorado,08,83712,1269,2196,9,1065484,9377,83230,1312,982254,8065
2020-10-16,Connecticut,09,62830,802,4542,2,1967633,33064,62830,802,1904803,32262
2020-10-16,Delaware,10,22724,164,662,1,321142,2509,22724,164,298418,2345
2020-10-16,District of Columbia,11,16255,89,641,3,455787,5173,16255,89,439532,5084
2020-10-16,Florida,12,748429,3449,15829,94,5664298,30080,739050,3365,4925248,26715
2020-10-16,Georgia,13,345879,1786,7382,62,3254270,24489,337850,1609,2916420,22880
2020-10-16,Guam,66,4507,111,64,2,58122,657,3538,111,54584,546
2020-10-16,Hawaii,15,14007,85,184,1,309115,90,13962,90,295153,0
2020-10-16,Idaho,16,52234,763,529,8,350972,2861,50610,718,300362,2143
2020-10-16,Illinois,17,341219,5008,9447,55,6622355,88308,339761,5103,6282594,83205
2020-10-16,Indiana,18,145915,2298,3887,23,1532949,11547,143495,2283,1389454,9264
2020-10-16,Iowa,19,105746,1514,1524,8,822775,-12831,99946,1229,722829,-14060
2020-10-16,Kansas,20,72509,1694,859,21,589189,9362,70855,1700,518334,7662
2020-10-16,Kentucky,21,87764,1354,1349,8,1666429,21050,85506,1311,1580923,19739
2020-10-16,Louisiana,22,177726,774,5727,20,2565652,19645,177726,774,2387926,18871
2020-10-16,Maine,23,5865,29,145,1,533641,7574,5865,29,527776,7545
2020-10-16,Maryland,24,134822,780,4032,4,1782457,11622,134329,781,1648128,10841
2020-10-16,Massachusetts,25,142346,767,9702,30,2489643,15027,142346,767,2347297,14260
2020-10-16,Michigan,26,159144,2218,7320,16,4225410,53421,159119,2206,4066291,51215
2020-10-16,Minnesota,27,119449,2290,2265,13,1646955,23438,119396,2290,1527559,21148
2020-10-16,Mississippi,28,109255,1116,3160,8,838799,26005,109255,1116,729544,24889
2020-10-16,Missouri,29,158764,2622,2550,19,1361263,2017,152571,2017,1208692,0
2020-10-16,Montana,30,21674,631,235,5,425462,5630,21595,662,403867,4968
2020-10-16,Nebraska,31,56724,1296,556,10,529266,5489,55428,961,473838,4528
2020-10-16,Nevada,32,88832,751,1707,7,747671,2327,88685,716,658986,1611
2020-10-16,New Hampshire,33,9514,88,465,2,305815,2239,9514,88,296301,2151
2020-10-16,New Jersey,34,219593,810,16202,5,4101399,31042,217804,810,3883595,30232
2020-10-16,New Mexico,35,35770,812,928,6,1035851,8459,35770,812,1000081,7647
2020-10-16,New York,36,485838,1703,32944,9,12611431,136039,481107,1707,12130324,134332
2020-10-16,North Carolina,37,242032,2694,3938,39,3539731,38968,241623,2684,3298108,36284
2020-10-16,North Dakota,38,30522,864,393,18,266863,2102,30517,864,236346,1238
2020-10-16,Northern Mariana Islands,69,80,0,2,0,15536,3,80,3,15456,0
2020-10-16,Ohio,39,177991,2148,5054,16,3803487,42508,177991,2148,3625496,40360
2020-10-16,Oklahoma,40,105308,1472,1154,11,1418148,19380,105308,1472,1312840,17908
2020-10-16,Oregon,41,38947,411,620,7,775189,5913,38935,410,736254,5503
2020-10-16,Pennsylvania,42,184185,1683,8524,28,2282130,15413,179086,1566,2103044,13847
2020-10-16,Puerto Rico,72,56412,327,758,15,334146,227,28174,227,305972,0
2020-10-16,Rhode Island,44,27691,253,1152,3,390177,3401,27691,253,362486,3148
2020-10-16,South Carolina,45,162253,1147,3615,8,1566317,19709,162253,1147,1404064,18562
2020-10-16,South Dakota,46,31805,793,307,3,226990,2751,31805,793,195185,1958
2020-10-16,Tennessee,47,220099,744,2847,11,3274513,5850,223493,666,3051020,5184
2020-10-16,Texas,48,859567,5590,17454,92,7211046,99156,815678,5870,6395368,93286
2020-10-16,Utah,49,91966,1478,539,8,925428,1496,91957,1496,833471,0
2020-10-16,Vermont,50,1915,12,58,0,175304,833,1923,13,173381,820
2020-10-16,Virgin Islands,78,1329,0,21,0,22504,139,1329,2,21175,137
2020-10-16,Virginia,51,164124,1183,3408,20,2356897,20271,164124,1183,2192773,19088
2020-10-16,Washington,53,101533,695,2338,7,2169192,22683,96185,676,2073007,22007
2020-10-16,West Virginia,54,19580,498,396,3,667579,11165,19580,498,647999,10667
2020-10-16,Wisconsin,55,175652,4172,1588,20,1765796,14830,175227,4105,1590569,10725
2020-10-16,Wyoming,56,8665,290,57,0,117419,1030,8665,290,108754,740
2020-10-17,Alabama,01,171662,1288,2788,2,1269761,7929,171662,1288,1098099,6641
2020-10-17,Alaska,02,11710,214,63,1,530500,7836,10811,210,519689,7626
2020-10-17,Arizona,04,230412,904,5824,18,1625846,11379,230407,921,1395439,10458
2020-10-17,Arkansas,05,98422,883,1684,19,1213237,9917,98422,883,1114815,9034
2020-10-17,California,06,876257,2156,16940,39,16756711,134755,864455,2979,15892256,131776
2020-10-17,Colorado,08,84804,1092,2199,3,1075777,10293,84369,1139,991408,9154
2020-10-17,Connecticut,09,62830,0,4542,0,1967633,0,62830,0,1904803,0
2020-10-17,Delaware,10,22942,218,664,2,324469,3327,22942,218,301527,3109
2020-10-17,District of Columbia,11,16334,79,641,0,462968,7181,16334,79,446634,7102
2020-10-17,Florida,12,752473,4044,15916,87,5694637,30339,743018,3968,4951619,26371
2020-10-17,Georgia,13,347468,1589,7429,47,3280668,26398,339384,1534,2941284,24864
2020-10-17,Guam,66,4507,0,64,0,58680,558,3617,79,55063,479
2020-10-17,Hawaii,15,14101,94,185,1,309200,85,14047,85,295153,0
2020-10-17,Idaho,16,52582,348,532,3,354136,3164,51704,1094,302432,2070
2020-10-17,Illinois,17,344787,3568,9474,27,6699844,77489,343390,3629,6356454,73860
2020-10-17,Indiana,18,148400,2485,3918,31,1545927,12978,145977,2482,1399950,10496
2020-10-17,Iowa,19,106698,952,1528,4,827884,5109,101103,1157,726781,3952
2020-10-17,Kansas,20,72616,107,859,0,589189,0,70855,0,518334,0
2020-10-17,Kentucky,21,88823,1059,1363,14,1687530,21101,86797,1291,1600733,19810
2020-10-17,Louisiana,22,177726,0,5727,0,2565652,0,177726,0,2387926,0
2020-10-17,Maine,23,5913,48,146,1,533689,48,5913,48,527776,0
2020-10-17,Maryland,24,135463,641,4036,4,1794904,12447,135127,798,1659777,11649
2020-10-17,Massachusetts,25,142930,584,9723,21,2502072,12429,142930,584,2359142,11845
2020-10-17,Michigan,26,159259,115,7323,3,4270757,45347,159119,0,4111638,45347
2020-10-17,Minnesota,27,121143,1694,2270,5,1661623,14668,121090,1694,1540533,12974
2020-10-17,Mississippi,28,110006,751,3171,11,839550,751,110006,751,729544,0
2020-10-17,Missouri,29,160654,1890,2645,95,1378663,17400,154928,2357,1223735,15043
2020-10-17,Montana,30,22284,610,240,5,428128,2666,22233,638,405895,2028
2020-10-17,Nebraska,31,57334,610,557,1,535347,6081,56714,1286,478633,4795
2020-10-17,Nevada,32,89848,1016,1709,2,755234,7563,89652,967,665582,6596
2020-10-17,New Hampshire,33,9625,111,466,1,311615,5800,9625,111,301990,5689
2020-10-17,New Jersey,34,220527,934,16204,2,4135796,34397,218738,934,3917058,33463
2020-10-17,New Mexico,35,36343,573,929,1,1046727,10876,36343,573,1010384,10303
2020-10-17,New York,36,487626,1788,32959,15,12771403,159972,482891,1784,12288512,158188
2020-10-17,North Carolina,37,244020,1988,3955,17,3582572,42841,243725,2102,3338847,40739
2020-10-17,North Dakota,38,31266,744,404,11,268672,1809,31261,744,237411,1065
2020-10-17,Northern Mariana Islands,69,86,6,2,0,15542,6,86,6,15456,0
2020-10-17,Ohio,39,180225,2234,5067,13,3854399,50912,180225,2234,3674174,48678
2020-10-17,Oklahoma,40,106503,1195,1168,14,1434035,15887,106503,1195,1327532,14692
2020-10-17,Oregon,41,39316,369,622,2,781643,6454,39316,381,742327,6073
2020-10-17,Pennsylvania,42,185670,1485,8535,11,2300793,18663,180943,1857,2119850,16806
2020-10-17,Puerto Rico,72,56650,238,761,3,334265,119,28293,119,305972,0
2020-10-17,Rhode Island,44,27691,0,1152,0,394774,4597,27978,287,366796,4310
2020-10-17,South Carolina,45,163214,961,3637,22,1585051,18734,163214,961,1421837,17773
2020-10-17,South Dakota,46,32611,806,315,8,229204,2214,32611,806,196593,1408
2020-10-17,Tennessee,47,222608,2509,2875,28,3305133,30620,226139,2646,3078994,27974
2020-10-17,Texas,48,863993,4426,17518,64,7274236,63190,820563,4885,6453673,58305
2020-10-17,Utah,49,93297,1331,541,2,941244,15816,93297,1340,847947,14476
2020-10-17,Vermont,50,1926,11,58,0,175990,686,1932,9,174058,677
2020-10-17,Virgin Islands,78,1335,6,21,0,22504,0,1329,0,21175,0
2020-10-17,Virginia,51,165238,1114,3422,14,2376550,19653,165238,1114,2211312,18539
2020-10-17,Washington,53,102054,521,2339,1,2194254,25062,96894,709,2097360,24353
2020-10-17,West Virginia,54,19801,221,399,3,672361,4782,19801,221,652560,4561
2020-10-17,Wisconsin,55,175652,0,1588,0,1765796,0,175227,0,1590569,0
2020-10-17,Wyoming,56,8816,151,57,0,117570,151,8816,151,108754,0
2020-10-18,Alabama,01,172626,964,2788,0,1274995,5234,172626,964,1102369,4270
2020-10-18,Alaska,02,11934,224,63,0,532711,2211,11021,210,521690,2001
2020-10-18,Arizona,04,231149,737,5827,3,1636210,10364,231149,742,1405061,9622
2020-10-18,Arkansas,05,99066,644,1704,20,1221654,8417,99066,644,1122588,7773
2020-10-18,California,06,878394,2137,16979,39,16892062,135351,867317,2862,16024745,132489
2020-10-18,Colorado,08,85803,999,2199,0,1085968,10191,85302,933,1000666,9258
2020-10-18,Connecticut,09,62830,0,4542,0,1967633,0,62830,0,1904803,0
2020-10-18,Delaware,10,23093,151,665,1,327296,2827,23093,151,304203,2676
2020-10-18,District of Columbia,11,16370,36,641,0,466805,3837,16370,36,450435,3801
2020-10-18,Florida,12,755012,2539,15966,50,5712864,18227,745492,2474,4967372,15753
2020-10-18,Georgia,13,348773,1305,7460,31,3298458,17790,340558,1174,2957900,16616
2020-10-18,Guam,66,4507,0,64,0,58968,288,3675,58,55293,230
2020-10-18,Hawaii,15,14183,82,186,1,309296,96,14143,96,295153,0
2020-10-18,Idaho,16,53092,510,532,0,356140,2004,52582,878,303558,1126
2020-10-18,Illinois,17,348870,4083,9491,17,6779140,79296,347635,4245,6431505,75051
2020-10-18,Indiana,18,150005,1605,3937,19,1555437,9510,147582,1605,1407855,7905
2020-10-18,Iowa,19,107334,636,1532,4,832536,4652,101960,857,730576,3795
2020-10-18,Kansas,20,72722,106,859,0,589189,0,70855,0,518334,0
2020-10-18,Kentucky,21,89538,715,1372,9,1688340,810,87607,810,1600733,0
2020-10-18,Louisiana,22,178869,1143,5750,23,2592598,26946,178869,1143,2413729,25803
2020-10-18,Maine,23,5939,26,146,0,533715,26,5939,26,527776,0
2020-10-18,Maryland,24,136149,686,4037,1,1806662,11758,135657,530,1671005,11228
2020-10-18,Massachusetts,25,143660,730,9737,14,2517646,15574,143660,730,2373986,14844
2020-10-18,Michigan,26,159337,78,7323,0,4270757,0,159119,0,4111638,0
2020-10-18,Minnesota,27,122865,1722,2287,17,1681318,19695,122812,1722,1558506,17973
2020-10-18,Mississippi,28,110239,233,3171,0,839550,0,110006,0,729544,0
2020-10-18,Missouri,29,162156,1502,2648,3,1386536,7873,156696,1768,1229840,6105
2020-10-18,Montana,30,22821,537,241,1,431134,3006,22821,588,408313,2418
2020-10-18,Nebraska,31,58068,734,557,0,539127,3780,57334,620,481793,3160
2020-10-18,Nevada,32,90374,526,1711,2,759508,4274,90261,609,669247,3665
2020-10-18,New Hampshire,33,9694,69,467,1,313364,1749,9694,69,303670,1680
2020-10-18,New Jersey,34,221802,1275,16211,7,4137071,1275,220013,1275,3917058,0
2020-10-18,New Mexico,35,36788,445,934,5,1054891,8164,36788,445,1018103,7719
2020-10-18,New York,36,489016,1390,32972,13,12900166,128763,484281,1390,12415885,127373
2020-10-18,North Carolina,37,246116,2096,3961,6,3617258,34686,246028,2303,3371230,32383
2020-10-18,North Dakota,38,31983,717,409,5,270555,1883,31978,717,238577,1166
2020-10-18,Northern Mariana Islands,69,86,0,2,0,15542,0,86,0,15456,0
2020-10-18,Ohio,39,181787,1562,5067,0,3900649,46250,181787,1562,3718862,44688
2020-10-18,Oklahoma,40,107299,796,1171,3,1434831,796,107299,796,1327532,0
2020-10-18,Oregon,41,39532,216,622,0,785104,3461,39532,216,745572,3245
2020-10-18,Pennsylvania,42,186772,1102,8555,20,2314863,14070,182212,1269,2132651,12801
2020-10-18,Puerto Rico,72,57293,643,766,5,334683,418,28711,418,305972,0
2020-10-18,Rhode Island,44,27691,0,1152,0,398224,3450,28262,284,369962,3166
2020-10-18,South Carolina,45,163990,776,3650,13,1601263,16212,163990,776,1437273,15436
2020-10-18,South Dakota,46,33269,658,323,8,231047,1843,33269,658,197778,1185
2020-10-18,Tennessee,47,225126,2518,2884,9,3340819,35686,228744,2605,3112075,33081
2020-10-18,Texas,48,869376,5383,17541,23,7326919,52683,823779,3216,6503140,49467
2020-10-18,Utah,49,94394,1097,544,3,948245,7001,94394,1097,853851,5904
2020-10-18,Vermont,50,1937,11,58,0,177029,1039,1943,11,175086,1028
2020-10-18,Virgin Islands,78,1335,0,21,0,22852,348,1335,6,21517,342
2020-10-18,Virginia,51,166138,900,3433,11,2397078,20528,166138,900,2230940,19628
2020-10-18,Washington,53,102403,349,2339,0,2215090,20836,98201,1307,2116889,19529
2020-10-18,West Virginia,54,20081,280,399,0,680872,8511,20081,280,660791,8231
2020-10-18,Wisconsin,55,175652,0,1588,0,1765796,0,175227,0,1590569,0
2020-10-18,Wyoming,56,9025,209,57,0,117779,209,9025,209,108754,0
2020-10-19,Alabama,01,173485,859,2789,1,1281313,6318,173485,859,1107828,5459
2020-10-19,Alaska,02,12138,204,63,0,536223,3512,11225,204,524998,3308
2020-10-19,Arizona,04,231933,784,5830,3,1645001,8791,231897,748,1413104,8043
2020-10-19,Arkansas,05,99597,531,1714,10,1229721,8067,99597,531,1130124,7536
2020-10-19,California,06,882665,4271,16987,8,17042408,150346,870791,3474,16171617,146872
2020-10-19,Colorado,08,86727,924,2207,8,1095280,9312,86374,1072,1008906,8240
2020-10-19,Connecticut,09,64021,1191,4554,12,2039597,71964,64021,1191,1975576,70773
2020-10-19,Delaware,10,23196,103,666,1,329018,1722,23196,103,305822,1619
2020-10-19,District of Columbia,11,16395,25,641,0,469040,2235,16395,25,452645,2210
2020-10-19,Florida,12,756719,1707,16020,54,5729739,16875,747183,1691,4982556,15184
2020-10-19,Georgia,13,350654,1881,7479,19,3314279,15821,341310,752,2972969,15069
2020-10-19,Guam,66,4725,218,67,3,59549,581,3756,81,55793,500
2020-10-19,Hawaii,15,14218,35,186,0,309378,82,14225,82,295153,0
2020-10-19,Idaho,16,54123,1031,535,3,359107,2967,53092,510,306015,2457
2020-10-19,Illinois,17,352449,3579,9520,29,6827824,48684,350748,3113,6477076,45571
2020-10-19,Indiana,18,151588,1583,3960,23,1564722,9285,149166,1584,1415556,7701
2020-10-19,Iowa,19,108114,780,1548,16,835573,3037,102517,557,733056,2480
2020-10-19,Kansas,20,74616,1894,872,13,598394,9205,72968,2113,525426,7092
2020-10-19,Kentucky,21,90443,905,1381,9,1711919,23579,88247,640,1623672,22939
2020-10-19,Louisiana,22,179070,201,5766,16,2597464,4866,179070,201,2418394,4665
2020-10-19,Maine,23,5962,23,146,0,549477,15762,5962,23,543515,15739
2020-10-19,Maryland,24,136643,494,4041,4,1816722,10060,136154,497,1680568,9563
2020-10-19,Massachusetts,25,144488,828,9753,16,2535301,17655,144488,828,2390813,16827
2020-10-19,Michigan,26,164055,4718,7364,41,4335624,64867,164123,5004,4171501,59863
2020-10-19,Minnesota,27,124492,1627,2292,5,1694569,13251,124439,1627,1570130,11624
2020-10-19,Mississippi,28,110592,353,3171,0,840136,586,110592,586,729544,0
2020-10-19,Missouri,29,164249,2093,2660,12,1393100,6564,158101,1405,1234999,5159
2020-10-19,Montana,30,23503,682,242,1,442366,11232,23390,569,418976,10663
2020-10-19,Nebraska,31,58817,749,568,11,543213,4086,58068,734,485145,3352
2020-10-19,Nevada,32,90978,604,1714,3,763202,3694,90843,582,672359,3112
2020-10-19,New Hampshire,33,9746,52,468,1,314806,1442,9746,52,305060,1390
2020-10-19,New Jersey,34,222994,1192,16214,3,4217705,80634,221205,1192,3996500,79442
2020-10-19,New Mexico,35,37302,514,935,1,1061268,6377,37302,514,1023966,5863
2020-10-19,New York,36,490015,999,32990,18,12982175,82009,485279,998,12496896,81011
2020-10-19,North Carolina,37,247551,1435,3969,8,3648364,31106,247172,1144,3401192,29962
2020-10-19,North Dakota,38,32642,659,413,4,272737,2182,32637,659,240100,1523
2020-10-19,Northern Mariana Islands,69,86,0,2,0,15542,0,86,0,15456,0
2020-10-19,Ohio,39,183624,1837,5075,8,3941567,40918,183624,1837,3757943,39081
2020-10-19,Oklahoma,40,108073,774,1173,2,1435605,774,108073,774,1327532,0
2020-10-19,Oregon,41,39799,267,630,8,788509,3405,39794,262,748715,3143
2020-10-19,Pennsylvania,42,188442,1670,8562,7,2327281,12418,183315,1103,2143966,11315
2020-10-19,Puerto Rico,72,57950,657,768,2,335110,427,29138,427,305972,0
2020-10-19,Rhode Island,44,28347,656,1159,7,399326,1102,28347,85,370979,1017
2020-10-19,South Carolina,45,164609,619,3661,11,1610200,8937,164609,619,1445591,8318
2020-10-19,South Dakota,46,33836,567,323,0,232450,1403,33836,567,198614,836
2020-10-19,Tennessee,47,228267,3141,2896,12,3383392,42573,232061,3317,3151331,39256
2020-10-19,Texas,48,874080,4704,17564,23,7384043,57124,825673,1894,6558370,55230
2020-10-19,Utah,49,95572,1178,547,3,954879,6634,95562,1168,859317,5466
2020-10-19,Vermont,50,1946,9,58,0,178084,1055,1951,8,176133,1047
2020-10-19,Virgin Islands,78,1335,0,21,0,22852,0,1335,0,21517,0
2020-10-19,Virginia,51,166828,690,3457,24,2408500,11422,166828,690,2241672,10732
2020-10-19,Washington,53,103323,920,2357,18,2230785,15695,98201,0,2132584,15695
2020-10-19,West Virginia,54,20293,212,399,0,687990,7118,20293,212,667697,6906
2020-10-19,Wisconsin,55,183177,7525,1624,36,1886955,121159,183142,7915,1703813,113244
2020-10-19,Wyoming,56,9311,286,57,0,118065,286,9311,286,108754,0
2020-10-20,Alabama,01,174528,1043,2805,16,1287087,5774,174528,1043,1112559,4731
2020-10-20,Alaska,02,12349,211,63,0,546525,10302,11456,231,535069,10071
2020-10-20,Arizona,04,232939,1006,5837,7,1652612,7611,232937,1040,1419675,6571
2020-10-20,Arkansas,05,100441,844,1728,14,1237675,7954,100441,844,1137234,7110
2020-10-20,California,06,887093,4428,17067,80,17189070,146662,874077,3286,16314993,143376
2020-10-20,Colorado,08,87966,1239,2212,5,1101775,6495,87582,1208,1014193,5287
2020-10-20,Connecticut,09,64455,434,4559,5,2054262,14665,64455,434,1989807,14231
2020-10-20,Delaware,10,23325,129,668,2,330726,1708,23325,129,307401,1579
2020-10-20,District of Columbia,11,16445,50,642,1,473807,4767,16445,50,457362,4717
2020-10-20,Florida,12,760381,3662,16104,84,5758297,28558,750739,3556,5007558,25002
2020-10-20,Georgia,13,351990,1336,7494,15,3327836,13557,342438,1128,2985398,12429
2020-10-20,Guam,66,4855,130,67,0,60506,957,3886,130,56620,827
2020-10-20,Hawaii,15,14302,84,188,2,309415,37,14262,37,295153,0
2020-10-20,Idaho,16,55153,1030,541,6,361402,2295,53790,698,307612,1597
2020-10-20,Illinois,17,356151,3702,9562,42,6886901,59077,354462,3714,6532439,55363
2020-10-20,Indiana,18,153088,1500,4008,48,1572350,7628,150664,1498,1421686,6130
2020-10-20,Iowa,19,109210,1096,1576,28,837718,2145,103011,494,734707,1651
2020-10-20,Kansas,20,74883,267,902,30,598394,0,72968,0,525426,0
2020-10-20,Kentucky,21,91731,1288,1403,22,1720328,8409,89544,1297,1630784,7112
2020-10-20,Louisiana,22,179769,699,5772,6,2616457,18993,179769,699,2436688,18294
2020-10-20,Maine,23,5989,27,146,0,554094,4617,5989,27,548105,4590
2020-10-20,Maryland,24,137229,586,4050,9,1824905,8183,136744,590,1688161,7593
2020-10-20,Massachusetts,25,145464,976,9758,5,2552694,17393,145464,976,2407230,16417
2020-10-20,Michigan,26,165949,1894,7386,22,4385791,50167,165994,1871,4219797,48296
2020-10-20,Minnesota,27,125584,1092,2299,7,1700265,5696,125531,1092,1574734,4604
2020-10-20,Mississippi,28,111322,730,3202,31,840866,730,111322,730,729544,0
2020-10-20,Missouri,29,164891,642,2668,8,1394624,1524,159625,1524,1234999,0
2020-10-20,Montana,30,24201,698,252,10,445021,2655,24093,703,420928,1952
2020-10-20,Nebraska,31,59409,592,575,7,546669,3456,58817,749,487852,2707
2020-10-20,Nevada,32,91679,701,1728,14,766312,3110,91499,656,674813,2454
2020-10-20,New Hampshire,33,9828,82,468,0,316091,1285,9828,82,306263,1203
2020-10-20,New Jersey,34,223982,988,16227,13,4235300,17595,222193,988,4013107,16607
2020-10-20,New Mexico,35,37896,594,942,7,1070481,9213,37896,594,1032585,8619
2020-10-20,New York,36,491216,1201,32998,8,13072715,90540,486480,1201,12586235,89339
2020-10-20,North Carolina,37,249158,1607,4018,49,3671793,23429,248750,1578,3423043,21851
2020-10-20,North Dakota,38,33671,1029,417,4,274572,1835,33666,1029,240906,806
2020-10-20,Northern Mariana Islands,69,88,2,2,0,15811,269,88,2,15723,267
2020-10-20,Ohio,39,185639,2015,5083,8,3979414,37847,185639,2015,3793775,35832
2020-10-20,Oklahoma,40,109548,1475,1191,18,1467010,31405,109548,1475,1357462,29930
2020-10-20,Oregon,41,40149,350,636,6,795317,6808,40136,342,755181,6466
2020-10-20,Pennsylvania,42,189988,1546,8591,29,2340511,13230,184872,1557,2155639,11673
2020-10-20,Puerto Rico,72,58643,693,769,1,335557,447,29585,447,305972,0
2020-10-20,Rhode Island,44,28649,302,1164,5,401055,1729,28649,302,372406,1427
2020-10-20,South Carolina,45,165493,884,3696,35,1619922,9722,165493,884,1454429,8838
2020-10-20,South Dakota,46,34457,621,330,7,234726,2276,34457,621,200269,1655
2020-10-20,Tennessee,47,229794,1527,2924,28,3396736,13344,233569,1508,3163167,11836
2020-10-20,Texas,48,879949,5869,17644,80,7444326,60283,833557,7884,6610769,52399
2020-10-20,Utah,49,96643,1071,552,5,959942,5063,96643,1081,863299,3982
2020-10-20,Vermont,50,1956,10,58,0,178444,360,1963,12,176481,348
2020-10-20,Virgin Islands,78,1337,2,21,0,22852,0,1335,0,21517,0
2020-10-20,Virginia,51,167754,926,3485,28,2422481,13981,167754,926,2254727,13055
2020-10-20,Washington,53,103845,522,2380,23,2244336,13551,98661,460,2145675,13091
2020-10-20,West Virginia,54,20519,226,408,9,691809,3819,20519,226,671290,3593
2020-10-20,Wisconsin,55,187898,4721,1660,36,1900711,13756,187828,4686,1712883,9070
2020-10-20,Wyoming,56,9526,215,61,4,118280,215,9526,215,108754,0
2020-10-21,Alabama,01,175674,1146,2828,23,1295035,7948,174528,0,1120507,7948
2020-10-21,Alaska,02,12559,210,64,1,547140,615,11680,224,535460,391
2020-10-21,Arizona,04,233948,1009,5854,17,1662704,10092,233912,975,1428792,9117
2020-10-21,Arkansas,05,101596,1155,1751,23,1248949,11274,101596,1155,1147353,10119
2020-10-21,California,06,890153,3060,17189,122,17293139,104069,877784,3707,16415355,100362
2020-10-21,Colorado,08,89245,1279,2220,8,1110243,8468,88849,1267,1021394,7201
2020-10-21,Connecticut,09,64871,416,4567,8,2070126,15864,64871,416,2005255,15448
2020-10-21,Delaware,10,23375,50,670,2,331480,754,23375,50,308105,704
2020-10-21,District of Columbia,11,16498,53,642,0,476443,2636,16498,53,459945,2583
2020-10-21,Florida,12,762525,2144,16209,105,5760403,2106,752845,2106,5007558,0
2020-10-21,Georgia,13,353449,1459,7523,29,3338315,10479,343750,1312,2994565,9167
2020-10-21,Guam,66,4937,82,69,2,61243,737,3968,82,57275,655
2020-10-21,Hawaii,15,14379,77,202,14,309503,88,14350,88,295153,0
2020-10-21,Idaho,16,55922,769,551,10,363972,2570,54663,873,309309,1697
2020-10-21,Illinois,17,360160,4009,9622,60,6953692,66791,358804,4342,6594888,62449
2020-10-21,Indiana,18,154822,1734,4023,15,1581109,8759,152396,1732,1428713,7027
2020-10-21,Iowa,19,110444,1234,1594,18,842542,4824,104190,1179,738352,3645
2020-10-21,Kansas,20,76299,1416,952,50,605509,7115,74456,1488,531053,5627
2020-10-21,Kentucky,21,93110,1379,1424,21,1728638,8310,90996,1452,1637642,6858
2020-10-21,Louisiana,22,181132,1363,5790,18,2631404,14947,181132,1363,2450272,13584
2020-10-21,Maine,23,6027,38,146,0,560810,6716,6027,38,554783,6678
2020-10-21,Maryland,24,137720,491,4058,8,1832007,7102,137236,492,1694771,6610
2020-10-21,Massachusetts,25,146166,702,9780,22,2565472,12778,146166,702,2419306,12076
2020-10-21,Michigan,26,167857,1908,7420,34,4420831,35040,167872,1878,4252959,33162
2020-10-21,Minnesota,27,126644,1060,2334,35,1708514,8249,126591,1060,1581923,7189
2020-10-21,Mississippi,28,112123,801,3223,21,841667,801,112123,801,729544,0
2020-10-21,Missouri,29,167435,2544,2716,48,1407874,13250,160869,1244,1247005,12006
2020-10-21,Montana,30,24818,617,276,24,447994,2973,24712,619,423282,2354
2020-10-21,Nebraska,31,60308,899,586,11,549922,3253,59409,592,490513,2661
2020-10-21,Nevada,32,92193,514,1735,7,769613,3301,92064,565,677549,2736
2020-10-21,New Hampshire,33,9917,89,469,1,318292,2201,9917,89,308375,2112
2020-10-21,New Jersey,34,225012,1030,16245,18,4264123,28823,223223,1030,4040900,27793
2020-10-21,New Mexico,35,38715,819,950,8,1078087,7606,38715,819,1039372,6787
2020-10-21,New York,36,493245,2029,33005,7,13197504,124789,488506,2026,12708998,122763
2020-10-21,North Carolina,37,251010,1852,4063,45,3692043,20250,250592,1842,3441451,18408
2020-10-21,North Dakota,38,34170,499,427,10,275596,1024,34165,499,241431,525
2020-10-21,Northern Mariana Islands,69,88,0,2,0,15811,0,88,0,15723,0
2020-10-21,Ohio,39,188005,2366,5149,66,4011513,32099,188005,2366,3823508,29733
2020-10-21,Oklahoma,40,110855,1307,1210,19,1478225,11215,110855,1307,1367370,9908
2020-10-21,Oregon,41,40458,309,638,2,799935,4618,40443,307,759492,4311
2020-10-21,Pennsylvania,42,191347,1359,8629,38,2353833,13322,186297,1425,2167536,11897
2020-10-21,Puerto Rico,72,58830,187,774,5,335689,132,29717,132,305972,0
2020-10-21,Rhode Island,44,29123,474,1169,5,404680,3625,29123,474,375557,3151
2020-10-21,South Carolina,45,166357,864,3708,12,1633549,13627,166357,864,1467192,12763
2020-10-21,South Dakota,46,35044,587,333,3,236250,1524,35044,587,201206,937
2020-10-21,Tennessee,47,232100,2306,2946,22,3416255,19519,235861,2292,3180394,17227
2020-10-21,Texas,48,886421,6472,17743,99,7474874,30548,838809,5252,6636065,25296
2020-10-21,Utah,49,98037,1394,558,6,966892,6950,98006,1363,868886,5587
2020-10-21,Vermont,50,1971,15,58,0,179235,791,1983,20,177252,771
2020-10-21,Virgin Islands,78,1337,0,21,0,23105,253,1337,2,21768,251
2020-10-21,Virginia,51,168772,1018,3515,30,2442510,20029,168772,1018,2273738,19011
2020-10-21,Washington,53,104624,779,2384,4,2252788,8452,99150,489,2153638,7963
2020-10-21,West Virginia,54,20734,215,413,5,696597,4788,20734,215,675863,4573
2020-10-21,Wisconsin,55,192225,4327,1707,47,1910755,10044,192191,4363,1718564,5681
2020-10-21,Wyoming,56,9848,322,61,0,121670,3390,9848,322,111822,3068
2020-10-22,Alabama,01,177064,1390,2843,15,1302817,7782,177064,2536,1125753,5246
2020-10-22,Alaska,02,12790,231,64,0,548709,1569,11919,239,536790,1330
2020-10-22,Arizona,04,234914,966,5859,5,1673903,11199,234906,994,1438997,10205
2020-10-22,Arkansas,05,102798,1202,1772,21,1262040,13091,102798,1202,1159242,11889
2020-10-22,California,06,896424,6271,17266,77,17358770,65631,880724,2940,16478046,62691
2020-10-22,Colorado,08,90639,1394,2224,4,1120200,9957,90222,1373,1029978,8584
2020-10-22,Connecticut,09,65373,502,4569,2,2092263,22137,65373,502,2026890,21635
2020-10-22,Delaware,10,23528,153,670,0,333059,1579,23528,153,309531,1426
2020-10-22,District of Columbia,11,16537,39,642,0,479435,2992,16537,39,462898,2953
2020-10-22,Florida,12,768083,5558,16266,57,5812154,51751,758306,5461,5053848,46290
2020-10-22,Georgia,13,355156,1707,7547,24,3367534,29219,345535,1785,3021999,27434
2020-10-22,Guam,66,5025,88,70,1,62287,1044,4056,88,58231,956
2020-10-22,Hawaii,15,14478,99,205,3,309580,77,14427,77,295153,0
2020-10-22,Idaho,16,56944,1022,560,9,366607,2635,55650,987,310957,1648
2020-10-22,Illinois,17,365120,4960,9663,41,7034669,80977,363746,4942,6670923,76035
2020-10-22,Indiana,18,157678,2856,4065,42,1594365,13256,155246,2850,1439119,10406
2020-10-22,Iowa,19,112242,1798,1617,23,848270,5728,105625,1435,742645,4293
2020-10-22,Kansas,20,76546,247,952,0,605509,0,74456,0,531053,0
2020-10-22,Kentucky,21,94582,1472,1439,15,1758052,29414,92299,1303,1665753,28111
2020-10-22,Louisiana,22,181904,772,5799,9,2651160,19756,181904,772,2469256,18984
2020-10-22,Maine,23,6064,37,146,0,567382,6572,6064,37,561318,6535
2020-10-22,Maryland,24,138473,753,4070,12,1843355,11348,137979,743,1705376,10605
2020-10-22,Massachusetts,25,147215,1049,9810,30,2583501,18029,147215,1049,2436286,16980
2020-10-22,Michigan,26,170102,2245,7465,45,4468863,48032,170076,2204,4298787,45828
2020-10-22,Minnesota,27,128205,1561,2354,20,1722897,14383,128152,1561,1594745,12822
2020-10-22,Mississippi,28,113081,958,3231,8,842625,958,113081,958,729544,0
2020-10-22,Missouri,29,169311,1876,2734,18,1432472,24598,162723,1854,1269749,22744
2020-10-22,Montana,30,25736,918,279,3,452846,4852,25640,928,427206,3924
2020-10-22,Nebraska,31,61285,977,589,3,554539,4617,60308,899,494231,3718
2020-10-22,Nevada,32,93028,835,1736,1,774095,4482,92853,789,681242,3693
2020-10-22,New Hampshire,33,9994,77,470,1,323173,4881,9994,77,313179,4804
2020-10-22,New Jersey,34,226174,1162,16263,18,4297612,33489,224385,1162,4073227,32327
2020-10-22,New Mexico,35,39377,662,953,3,1089150,11063,39377,662,1049773,10401
2020-10-22,New York,36,494874,1629,33022,17,13332845,135341,490134,1628,12842711,133713
2020-10-22,North Carolina,37,253418,2408,4110,47,3727675,35632,252992,2400,3474683,33232
2020-10-22,North Dakota,38,35057,887,436,9,277692,2096,35052,887,242640,1209
2020-10-22,Northern Mariana Islands,69,88,0,2,0,15811,0,88,0,15723,0
2020-10-22,Ohio,39,190430,2425,5161,12,4055125,43612,190430,2425,3864695,41187
2020-10-22,Oklahoma,40,112483,1628,1221,11,1491088,12863,112483,1628,1378605,11235
2020-10-22,Oregon,41,40825,367,647,9,806001,6066,40810,367,765191,5699
2020-10-22,Pennsylvania,42,193401,2054,8660,31,2373439,19606,188360,2063,2185079,17543
2020-10-22,Puerto Rico,72,59037,207,783,9,335776,87,29804,87,305972,0
2020-10-22,Rhode Island,44,29594,471,1173,4,408302,3622,29594,471,378708,3151
2020-10-22,South Carolina,45,167485,1128,3755,47,1649351,15802,167485,1128,1481866,14674
2020-10-22,South Dakota,46,36017,973,347,14,238446,2196,36017,973,202429,1223
2020-10-22,Tennessee,47,234079,1979,2983,37,3436334,20079,237907,2046,3198427,18033
2020-10-22,Texas,48,891714,5293,17760,17,7532717,57843,845100,6291,6687617,51552
2020-10-22,Utah,49,99563,1526,563,5,976126,9234,99549,1543,876577,7691
2020-10-22,Vermont,50,1987,16,58,0,180122,887,1999,16,178123,871
2020-10-22,Virgin Islands,78,1343,6,21,0,23254,149,1343,6,21911,143
2020-10-22,Virginia,51,170104,1332,3524,9,2462742,20232,170104,1332,2292638,18900
2020-10-22,Washington,53,105364,740,2389,5,2276453,23665,99874,724,2176579,22941
2020-10-22,West Virginia,54,21057,323,418,5,705151,8554,21057,323,684094,8231
2020-10-22,Wisconsin,55,195853,3628,1730,23,1926469,15714,195823,3632,1730646,12082
2020-10-22,Wyoming,56,10119,271,68,7,121941,271,10119,271,111822,0
2020-10-23,Alabama,01,180916,3852,2859,16,1314774,11957,180916,3852,1133858,8105
2020-10-23,Alaska,02,13067,277,64,0,552746,4037,12167,248,540579,3789
2020-10-23,Arizona,04,235910,996,5865,6,1686863,12960,235882,976,1450981,11984
2020-10-23,Arkansas,05,104135,1337,1782,10,1274297,12257,104135,1337,1170162,10920
2020-10-23,California,06,902325,5901,17316,50,17483293,124523,886865,6141,16596428,118382
2020-10-23,Colorado,08,92067,1428,2233,9,1130901,10701,91572,1350,1039329,9351
2020-10-23,Connecticut,09,66052,679,4577,8,2115744,23481,66052,679,2049692,22802
2020-10-23,Delaware,10,23687,159,678,8,335112,2053,23687,159,311425,1894
2020-10-23,District of Columbia,11,16609,72,642,0,485753,6318,16609,72,469144,6246
2020-10-23,Florida,12,771772,3689,16339,73,5855896,43742,761924,3618,5093972,40124
2020-10-23,Georgia,13,357319,2163,7584,37,3407623,40089,347759,2224,3059864,37865
2020-10-23,Guam,66,5110,85,70,0,62906,619,4141,85,58765,534
2020-10-23,Hawaii,15,14617,139,208,3,309682,102,14529,102,295153,0
2020-10-23,Idaho,16,58083,1139,568,8,369667,3060,56600,950,313067,2110
2020-10-23,Illinois,17,370134,5014,9704,41,7118051,83382,368746,5000,6749305,78382
2020-10-23,Indiana,18,160145,2467,4092,27,1605596,11231,157713,2467,1447883,8764
2020-10-23,Iowa,19,113596,1354,1629,12,852949,4679,106874,1249,746075,3430
2020-10-23,Kansas,20,78122,1576,975,23,616262,10753,76230,1774,540032,8979
2020-10-23,Kentucky,21,96043,1461,1462,23,1777204,19152,93748,1449,1683456,17703
2020-10-23,Louisiana,22,182603,699,5820,21,2671238,20078,182603,699,2488635,19379
2020-10-23,Maine,23,6095,31,146,0,574283,6901,6095,31,568188,6870
2020-10-23,Maryland,24,139185,712,4078,8,1855294,11939,138691,712,1716603,11227
2020-10-23,Massachusetts,25,148285,1070,9830,20,2599364,15863,148285,1070,2451079,14793
2020-10-23,Michigan,26,172128,2026,7485,20,4525886,57023,172122,2046,4353764,54977
2020-10-23,Minnesota,27,129916,1711,2367,13,1734245,11348,129863,1711,1604382,9637
2020-10-23,Mississippi,28,113876,795,3238,7,843420,795,113876,795,729544,0
2020-10-23,Missouri,29,171871,2560,2764,30,1439316,6844,164534,1811,1274782,5033
2020-10-23,Montana,30,26600,864,283,4,461000,8154,26503,863,434497,7291
2020-10-23,Nebraska,31,62511,1226,594,5,559308,4769,61285,977,498023,3792
2020-10-23,Nevada,32,94044,1016,1739,3,780647,6552,93666,813,686981,5739
2020-10-23,New Hampshire,33,10112,118,471,1,326151,2978,10112,118,316039,2860
2020-10-23,New Jersey,34,227219,1045,16273,10,4337985,40373,225430,1045,4112555,39328
2020-10-23,New Mexico,35,40168,791,960,7,1099484,10334,40168,791,1059316,9543
2020-10-23,New York,36,496510,1636,33038,16,13474353,141508,491771,1637,12982582,139871
2020-10-23,North Carolina,37,255534,2116,4140,30,3763315,35640,255708,2716,3507607,32924
2020-10-23,North Dakota,38,35944,887,445,9,279702,2010,35939,887,243763,1123
2020-10-23,Northern Mariana Islands,69,88,0,2,0,15811,0,88,0,15723,0
2020-10-23,Ohio,39,192948,2518,5184,23,4101393,46268,192948,2518,3908445,43750
2020-10-23,Oklahoma,40,113856,1373,1234,13,1511552,20464,113856,1373,1397696,19091
2020-10-23,Oregon,41,41357,532,651,4,815201,9200,41348,538,773853,8662
2020-10-23,Pennsylvania,42,195659,2258,8695,35,2391447,18008,190579,2219,2200868,15789
2020-10-23,Puerto Rico,72,60984,1947,791,8,336928,1152,30956,1152,305972,0
2020-10-23,Rhode Island,44,30118,524,1177,4,412850,4548,30118,524,382732,4024
2020-10-23,South Carolina,45,168549,1064,3777,22,1667501,18150,168549,1064,1498952,17086
2020-10-23,South Dakota,46,37202,1185,356,9,241002,2556,37202,1185,203800,1371
2020-10-23,Tennessee,47,237607,3528,3043,60,3478495,42161,241513,3606,3236982,38555
2020-10-23,Texas,48,899390,7676,17874,114,7611586,78869,851572,6472,6760014,72397
2020-10-23,Utah,49,101574,2011,567,4,984137,8011,101509,1960,882628,6051
2020-10-23,Vermont,50,2016,29,58,0,181287,1165,2029,30,179258,1135
2020-10-23,Virgin Islands,78,1346,3,21,0,23435,181,1346,3,22089,178
2020-10-23,Virginia,51,171284,1180,3539,15,2483341,20599,171284,1180,2312057,19419
2020-10-23,Washington,53,106189,825,2396,7,2296275,19822,100525,651,2195750,19171
2020-10-23,West Virginia,54,21392,335,422,4,710357,5206,21392,335,688965,4871
2020-10-23,Wisconsin,55,200479,4626,1776,46,1944538,18069,200466,4643,1744072,13426
2020-10-23,Wyoming,56,10545,426,68,0,124231,2290,10545,426,113686,1864
2020-10-24,Alabama,01,183276,2360,2866,7,1322198,7424,183276,2360,1138922,5064
2020-10-24,Alaska,02,13439,372,64,0,552746,0,12523,356,540223,-356
2020-10-24,Arizona,04,236898,988,5870,5,1698966,12103,236772,890,1462194,11213
2020-10-24,Arkansas,05,105318,1183,1797,15,1287123,12826,105318,1183,1181805,11643
2020-10-24,California,06,906644,4319,17345,29,17609179,125886,892810,5945,16716369,119941
2020-10-24,Colorado,08,93989,1922,2241,8,1144155,13254,93400,1828,1050755,11426
2020-10-24,Connecticut,09,66052,0,4577,0,2115744,0,66052,0,2049692,0
2020-10-24,Delaware,10,23847,160,680,2,337276,2164,23847,160,313429,2004
2020-10-24,District of Columbia,11,16706,97,642,0,491553,5800,16706,97,474847,5703
2020-10-24,Florida,12,776243,4471,16416,77,5928115,72219,766305,4381,5161810,67838
2020-10-24,Georgia,13,359001,1682,7625,41,3426110,18487,349605,1846,3076505,16641
2020-10-24,Guam,66,5144,34,72,2,63240,334,4175,34,59065,300
2020-10-24,Hawaii,15,14706,89,211,3,309822,140,14669,140,295153,0
2020-10-24,Idaho,16,58964,881,573,5,372818,3151,57673,1073,315145,2078
2020-10-24,Illinois,17,376034,5900,9765,61,7201568,83517,374907,6161,6826661,77356
2020-10-24,Indiana,18,162886,2741,4118,26,1618331,12735,160454,2741,1457877,9994
2020-10-24,Iowa,19,114952,1356,1634,5,859419,6470,108514,1640,750905,4830
2020-10-24,Kansas,20,78177,55,975,0,616262,0,76230,0,540032,0
2020-10-24,Kentucky,21,97501,1458,1469,7,1799931,22727,95480,1732,1704451,20995
2020-10-24,Louisiana,22,182603,0,5820,0,2671238,0,182603,0,2488635,0
2020-10-24,Maine,23,6137,42,146,0,574325,42,6137,42,568188,0
2020-10-24,Maryland,24,139859,674,4091,13,1866927,11633,139487,796,1727440,10837
2020-10-24,Massachusetts,25,149488,1203,9839,9,2618607,19243,149488,1203,2469119,18040
2020-10-24,Michigan,26,175385,3257,7522,37,4579991,54105,175612,3490,4404379,50615
2020-10-24,Minnesota,27,132175,2259,2381,14,1744115,9870,132122,2259,1611993,7611
2020-10-24,Mississippi,28,115088,1212,3255,17,844632,1212,115088,1212,729544,0
2020-10-24,Missouri,29,173746,1875,2854,90,1450015,10699,167452,2918,1282563,7781
2020-10-24,Montana,30,27149,549,295,12,464032,3032,27142,639,436890,2393
2020-10-24,Nebraska,31,63215,704,603,9,564275,4967,62510,1225,501765,3742
2020-10-24,Nevada,32,94935,891,1746,7,783707,3060,94812,1146,688895,1914
2020-10-24,New Hampshire,33,10238,126,473,2,329057,2906,10238,126,318819,2780
2020-10-24,New Jersey,34,229128,1909,16281,8,4339894,1909,227339,1909,4112555,0
2020-10-24,New Mexico,35,41040,872,965,5,1109095,9611,41040,872,1068055,8739
2020-10-24,New York,36,498568,2058,33049,11,13631293,156940,493832,2061,13137461,154879
2020-10-24,North Carolina,37,258439,2905,4170,30,3809077,45762,258292,2584,3550785,43178
2020-10-24,North Dakota,38,36879,935,453,8,281668,1966,36874,935,244794,1031
2020-10-24,Northern Mariana Islands,69,88,0,2,0,15811,0,88,0,15723,0
2020-10-24,Ohio,39,195806,2858,5206,22,4149769,48376,195806,2858,3953963,45518
2020-10-24,Oklahoma,40,115685,1829,1245,11,1532709,21157,115685,1829,1417024,19328
2020-10-24,Oregon,41,41739,382,654,3,821142,5941,41739,391,779403,5550
2020-10-24,Pennsylvania,42,197370,1711,8721,26,2407679,16232,192622,2043,2215057,14189
2020-10-24,Puerto Rico,72,61280,296,794,3,337044,116,31072,116,305972,0
2020-10-24,Rhode Island,44,30118,0,1177,0,416075,3225,30583,465,385492,2760
2020-10-24,South Carolina,45,169341,792,3793,16,1679084,11583,169341,792,1509743,10791
2020-10-24,South Dakota,46,38141,939,366,10,243680,2678,38141,939,205539,1739
2020-10-24,Tennessee,47,240191,2584,3067,24,3505140,26645,244087,2574,3261053,24071
2020-10-24,Texas,48,906657,7267,17998,124,7710195,98609,858071,6499,6852124,92110
2020-10-24,Utah,49,103137,1563,568,1,992734,8597,103117,1608,889617,6989
2020-10-24,Vermont,50,2043,27,58,0,182928,1641,2057,28,180871,1613
2020-10-24,Virgin Islands,78,1346,0,21,0,23435,0,1346,0,22089,0
2020-10-24,Virginia,51,172372,1088,3578,39,2500546,17205,172372,1088,2328174,16117
2020-10-24,Washington,53,106772,583,2396,0,2318931,22656,101345,820,2217586,21836
2020-10-24,West Virginia,54,21712,320,422,0,715690,5333,21712,320,693978,5013
2020-10-24,Wisconsin,55,205139,4660,1804,28,1962769,18231,205139,4673,1757630,13558
2020-10-24,Wyoming,56,10805,260,68,0,124491,260,10805,260,113686,0
2020-10-25,Alabama,01,184355,1079,2866,0,1329140,6942,184355,1079,1144785,5863
2020-10-25,Alaska,02,13968,529,64,0,559969,7223,13041,518,546928,6705
2020-10-25,Arizona,04,238200,1302,5874,4,1711869,12903,238163,1391,1473706,11512
2020-10-25,Arkansas,05,106115,797,1812,15,1295235,8112,106115,797,1189120,7315
2020-10-25,California,06,909344,2700,17358,13,17787885,178706,898029,5219,16889856,173487
2020-10-25,Colorado,08,95742,1753,2244,3,1156234,12079,95089,1689,1061145,10390
2020-10-25,Connecticut,09,66052,0,4577,0,2115744,0,66052,0,2049692,0
2020-10-25,Delaware,10,23961,114,681,1,339341,2065,23961,114,315380,1951
2020-10-25,District of Columbia,11,16767,61,642,0,496232,4679,16767,61,479465,4618
2020-10-25,Florida,12,778628,2385,16428,12,5942740,14625,768653,2348,5174087,12277
2020-10-25,Georgia,13,360344,1343,7626,1,3445032,18922,350923,1318,3094109,17604
2020-10-25,Guam,66,5185,41,72,0,63494,254,4216,41,59278,213
2020-10-25,Hawaii,15,14823,117,211,0,309911,89,14758,89,295153,0
2020-10-25,Idaho,16,59344,380,574,1,375527,2709,58694,1021,316833,1688
2020-10-25,Illinois,17,380065,4031,9788,23,7273665,72097,378969,4062,6894696,68035
2020-10-25,Indiana,18,165038,2152,4130,12,1629468,11137,162607,2153,1466861,8984
2020-10-25,Iowa,19,116238,1286,1635,1,863361,3942,109657,1143,753704,2799
2020-10-25,Kansas,20,78241,64,975,0,616262,0,76230,0,540032,0
2020-10-25,Kentucky,21,98730,1229,1472,3,1801393,1462,96942,1462,1704451,0
2020-10-25,Louisiana,22,183575,972,5837,17,2697507,26269,183575,972,2513932,25297
2020-10-25,Maine,23,6201,64,146,0,574389,64,6201,64,568188,0
2020-10-25,Maryland,24,140770,911,4096,5,1878929,12002,140279,792,1738650,11210
2020-10-25,Massachusetts,25,150565,1077,9864,25,2635607,17000,150565,1077,2485042,15923
2020-10-25,Michigan,26,175515,130,7522,0,4579991,0,175612,0,4404379,0
2020-10-25,Minnesota,27,133855,1680,2402,21,1770733,26618,133802,1680,1636931,24938
2020-10-25,Mississippi,28,115088,0,3255,0,844632,0,115088,0,729544,0
2020-10-25,Missouri,29,175243,1497,2857,3,1458840,8825,169495,2043,1289345,6782
2020-10-25,Montana,30,27880,731,298,3,465607,1575,27880,738,437727,837
2020-10-25,Nebraska,31,63797,582,604,1,567426,3151,63215,705,504211,2446
2020-10-25,Nevada,32,95798,863,1748,2,787869,4162,95703,891,692166,3271
2020-10-25,New Hampshire,33,10328,90,473,0,331561,2504,10328,90,321233,2414
2020-10-25,New Jersey,34,230257,1129,16285,4,4385882,45988,228468,1129,4157414,44859
2020-10-25,New Mexico,35,41863,823,967,2,1118844,9749,41863,823,1076981,8926
2020-10-25,New York,36,500201,1633,33059,10,13752123,120830,495464,1632,13256659,119198
2020-10-25,North Carolina,37,260128,1689,4183,13,3844453,35376,260099,1807,3584354,33569
2020-10-25,North Dakota,38,37724,845,461,8,283410,1742,37719,845,245691,897
2020-10-25,Northern Mariana Islands,69,88,0,2,0,15811,0,88,0,15723,0
2020-10-25,Ohio,39,198115,2309,5206,0,4199457,49688,198115,2309,4001342,47379
2020-10-25,Oklahoma,40,116736,1051,1249,4,1533760,1051,116736,1051,1417024,0
2020-10-25,Oregon,41,42101,362,654,0,825250,4108,42101,362,783149,3746
2020-10-25,Pennsylvania,42,198756,1386,8730,9,2424265,16586,194288,1666,2229977,14920
2020-10-25,Puerto Rico,72,62503,1223,801,7,337709,665,31737,665,305972,0
2020-10-25,Rhode Island,44,30118,0,1177,0,418420,2345,30857,274,387563,2071
2020-10-25,South Carolina,45,170678,1337,3802,9,1706414,27330,170678,1337,1535736,25993
2020-10-25,South Dakota,46,39203,1062,375,9,245930,2250,39203,1062,206727,1188
2020-10-25,Tennessee,47,243508,3317,3105,38,3546736,41596,247587,3500,3299149,38096
2020-10-25,Texas,48,910592,3935,18042,44,7762242,52047,862375,4304,6899867,47743
2020-10-25,Utah,49,105053,1916,572,4,1001239,8505,104882,1765,896357,6740
2020-10-25,Vermont,50,2073,30,58,0,183729,801,2087,30,181642,771
2020-10-25,Virgin Islands,78,1346,0,21,0,23435,0,1346,0,22089,0
2020-10-25,Virginia,51,173371,999,3579,1,2521816,21270,173371,999,2348445,20271
2020-10-25,Washington,53,107270,498,2396,0,2360387,41456,102913,1568,2257474,39888
2020-10-25,West Virginia,54,21906,194,423,1,723207,7517,21906,194,701301,7323
2020-10-25,Wisconsin,55,208917,3778,1814,10,1976943,14174,208917,3778,1768026,10396
2020-10-25,Wyoming,56,11041,236,68,0,124727,236,11041,236,113686,0
2020-10-26,Alabama,01,185322,967,2866,0,1334315,5175,185322,967,1148993,4208
2020-10-26,Alaska,02,14316,348,64,0,570844,10875,13391,350,557453,10525
2020-10-26,Arizona,04,239193,993,5875,1,1720285,8416,238964,801,1481321,7615
2020-10-26,Arkansas,05,106727,612,1833,21,1302162,6927,106727,612,1195435,6315
2020-10-26,California,06,913699,4355,17398,40,17982829,194944,901010,2981,17081819,191963
2020-10-26,Colorado,08,97686,1944,2255,11,1175350,19116,97300,2211,1078050,16905
2020-10-26,Connecticut,09,68099,2047,4589,12,2207937,92193,68099,2047,2139838,90146
2020-10-26,Delaware,10,24168,207,685,4,342071,2730,24168,207,317903,2523
2020-10-26,District of Columbia,11,16812,45,642,0,498190,1958,16812,45,481378,1913
2020-10-26,Florida,12,782005,3377,16448,20,5974725,31985,771989,3336,5202736,28649
2020-10-26,Georgia,13,364275,3931,7644,18,3461388,16356,351881,958,3109507,15398
2020-10-26,Guam,66,5305,120,76,4,64454,960,4336,120,60118,840
2020-10-26,Hawaii,15,14858,35,211,0,310030,119,14877,119,295153,0
2020-10-26,Idaho,16,60400,1056,582,8,377823,2296,59344,650,318479,1646
2020-10-26,Illinois,17,385084,5019,9811,23,7330929,57264,383698,4729,6947231,52535
2020-10-26,Indiana,18,167010,1972,4143,13,1638232,8764,164581,1974,1473651,6790
2020-10-26,Iowa,19,117198,960,1657,22,866323,2962,110404,747,755919,2215
2020-10-26,Kansas,20,80473,2232,976,1,625931,9669,78676,2446,547255,7223
2020-10-26,Kentucky,21,99965,1235,1480,8,1824845,23452,97866,924,1726979,22528
2020-10-26,Louisiana,22,183802,227,5854,17,2702566,5059,183802,227,2518764,4832
2020-10-26,Maine,23,6254,53,146,0,588653,14264,6254,53,582399,14211
2020-10-26,Maryland,24,141334,564,4099,3,1888371,9442,140844,565,1747527,8877
2020-10-26,Massachusetts,25,151777,1212,9881,17,2655689,20082,151777,1212,2503912,18870
2020-10-26,Michigan,26,179624,4109,7551,29,4652388,72397,179669,4057,4472719,68340
2020-10-26,Minnesota,27,135425,1570,2406,4,1784312,13579,135372,1570,1648940,12009
2020-10-26,Mississippi,28,115763,675,3263,8,845307,675,115763,675,729544,0
2020-10-26,Missouri,29,177733,2490,2869,12,1465949,7109,171022,1527,1294927,5582
2020-10-26,Montana,30,28580,700,304,6,476325,10718,28501,621,447824,10097
2020-10-26,Nebraska,31,64506,709,609,5,569834,2408,63797,582,506037,1826
2020-10-26,Nevada,32,96330,532,1751,3,791321,3452,96178,475,695143,2977
2020-10-26,New Hampshire,33,10397,69,475,2,333115,1554,10397,69,322718,1485
2020-10-26,New Jersey,34,231473,1216,16292,7,4455234,69352,229684,1216,4225550,68136
2020-10-26,New Mexico,35,42586,723,976,9,1124922,6078,42586,723,1082336,5355
2020-10-26,New York,36,501393,1192,33073,14,13834240,82117,496655,1191,13337585,80926
2020-10-26,North Carolina,37,262159,2031,4200,17,3872913,28460,261742,1643,3611171,26817
2020-10-26,North Dakota,38,38246,522,466,5,284478,1068,38241,522,246237,546
2020-10-26,Northern Mariana Islands,69,92,4,2,0,15815,4,92,4,15723,0
2020-10-26,Ohio,39,200231,2116,5217,11,4235663,36206,200231,2116,4035432,34090
2020-10-26,Oklahoma,40,117399,663,1251,2,1534423,663,117399,663,1417024,0
2020-10-26,Oregon,41,42454,353,657,3,830284,5034,42436,335,787848,4699
2020-10-26,Pennsylvania,42,201248,2492,8737,7,2437125,12860,195695,1407,2241430,11453
2020-10-26,Puerto Rico,72,63135,632,804,3,338170,461,32198,461,305972,0
2020-10-26,Rhode Island,44,31024,906,1184,7,419892,1472,31024,167,388868,1305
2020-10-26,South Carolina,45,171501,823,3823,21,1733232,26818,171501,823,1561731,25995
2020-10-26,South Dakota,46,39741,538,375,0,247094,1164,39741,538,207353,626
2020-10-26,Tennessee,47,245760,2252,3132,27,3569435,22699,249866,2279,3319569,20420
2020-10-26,Texas,48,917240,6648,18077,35,7809150,46908,867075,4700,6942075,42208
2020-10-26,Utah,49,106083,1030,575,3,1006802,5563,106083,1201,900719,4362
2020-10-26,Vermont,50,2083,10,58,0,184153,424,2096,9,182057,415
2020-10-26,Virgin Islands,78,1348,2,21,0,23617,182,1348,2,22269,180
2020-10-26,Virginia,51,174275,904,3581,2,2537269,15453,174275,904,2362994,14549
2020-10-26,Washington,53,108393,1123,2428,32,2360387,0,102913,0,2257474,0
2020-10-26,West Virginia,54,22223,317,424,1,736376,13169,22223,317,714153,12852
2020-10-26,Wisconsin,55,212116,3199,1825,11,1989820,12877,211928,3011,1777892,9866
2020-10-26,Wyoming,56,11477,436,77,9,125163,436,11477,436,113686,0
2020-10-27,Alabama,01,186437,1115,2892,26,1339885,5570,186437,1115,1153448,4455
2020-10-27,Alaska,02,14699,383,66,2,577429,6585,13779,388,563650,6197
2020-10-27,Arizona,04,240158,965,5891,16,1730162,9877,240122,1158,1490040,8719
2020-10-27,Arkansas,05,107679,952,1857,24,1310854,8692,107679,952,1203175,7740
2020-10-27,California,06,918627,4928,17478,80,18127049,144220,904198,3188,17222851,141032
2020-10-27,Colorado,08,99111,1425,2265,10,1183754,8404,98733,1433,1085021,6971
2020-10-27,Connecticut,09,68637,538,4595,6,2221034,13097,68637,538,2152397,12559
2020-10-27,Delaware,10,24249,81,686,1,343141,1070,24249,81,318892,989
2020-10-27,District of Columbia,11,16906,94,644,2,502538,4348,16906,94,485632,4254
2020-10-27,Florida,12,786303,4298,16504,56,5991638,16913,776215,4226,5215423,12687
2020-10-27,Georgia,13,365498,1223,7661,17,3474891,13503,353372,1491,3121519,12012
2020-10-27,Guam,66,5387,82,76,0,65045,591,4418,82,60627,509
2020-10-27,Hawaii,15,14920,62,214,3,310067,37,14914,37,295153,0
2020-10-27,Idaho,16,61282,882,588,6,380532,2709,60041,697,320491,2012
2020-10-27,Illinois,17,389088,4004,9860,49,7393003,62074,387698,4000,7005305,58074
2020-10-27,Indiana,18,168996,1986,4194,51,1646542,8310,166564,1983,1479978,6327
2020-10-27,Iowa,19,118852,1654,1680,23,869020,2697,111261,857,757759,1840
2020-10-27,Kansas,20,80761,288,979,3,625931,0,78676,0,547255,0
2020-10-27,Kentucky,21,101700,1735,1493,13,1836688,11843,99637,1771,1737051,10072
2020-10-27,Louisiana,22,184724,922,5872,18,2723277,20711,184724,922,2538553,19789
2020-10-27,Maine,23,6311,57,146,0,595786,7133,6311,57,589475,7076
2020-10-27,Maryland,24,142237,903,4108,9,1898094,9723,141741,897,1756353,8826
2020-10-27,Massachusetts,25,153037,1260,9888,7,2669651,13962,153037,1260,2516614,12702
2020-10-27,Michigan,26,182284,2660,7585,34,4693470,41082,182344,2675,4511126,38407
2020-10-27,Minnesota,27,137589,2164,2421,15,1792078,7766,137536,2164,1654542,5602
2020-10-27,Mississippi,28,116617,854,3283,20,846161,854,116617,854,729544,0
2020-10-27,Missouri,29,179457,1724,2912,43,1474405,8456,172717,1695,1301688,6761
2020-10-27,Montana,30,29422,842,309,5,481322,4997,29346,845,451976,4152
2020-10-27,Nebraska,31,65376,870,623,14,572760,2926,64499,702,508261,2224
2020-10-27,Nevada,32,97138,808,1757,6,794921,3600,96908,730,698013,2870
2020-10-27,New Hampshire,33,10530,133,475,0,334409,1294,10531,134,323878,1160
2020-10-27,New Jersey,34,233120,1647,16306,14,4484813,29579,231331,1647,4253482,27932
2020-10-27,New Mexico,35,43169,583,980,4,1129419,4497,43169,583,1086250,3914
2020-10-27,New York,36,503387,1994,33092,19,13945858,111618,498646,1991,13447212,109627
2020-10-27,North Carolina,37,264334,2175,4236,36,3890764,17851,263883,2141,3626881,15710
2020-10-27,North Dakota,38,39135,889,481,15,286196,1718,39130,889,247066,829
2020-10-27,Northern Mariana Islands,69,92,0,2,0,16085,270,92,0,15993,270
2020-10-27,Ohio,39,202740,2509,5239,22,4282604,46941,202740,2509,4079864,44432
2020-10-27,Oklahoma,40,118409,1010,1273,22,1564476,30053,118409,1010,1446067,29043
2020-10-27,Oregon,41,42821,367,665,8,836995,6711,42808,372,794187,6339
2020-10-27,Pennsylvania,42,203520,2272,8760,23,2452969,15844,198446,2751,2254523,13093
2020-10-27,Puerto Rico,72,63497,362,808,4,338433,263,32461,263,305972,0
2020-10-27,Rhode Island,44,31445,421,1188,4,423469,3577,31445,421,392024,3156
2020-10-27,South Carolina,45,172579,1078,3842,19,1745026,11794,172579,1078,1572447,10716
2020-10-27,South Dakota,46,40730,989,375,0,249165,2071,40730,989,208435,1082
2020-10-27,Tennessee,47,247688,1928,3176,44,3586241,16806,251774,1908,3334467,14898
2020-10-27,Texas,48,924475,7235,18155,78,7883440,74290,874367,7292,7009073,66998
2020-10-27,Utah,49,107246,1163,579,4,1013395,6593,107228,1145,906167,5448
2020-10-27,Vermont,50,2113,30,58,0,185042,889,2127,31,182915,858
2020-10-27,Virgin Islands,78,1351,3,21,0,23659,42,1351,3,22308,39
2020-10-27,Virginia,51,175409,1134,3600,19,2555585,18316,175409,1134,2380176,17182
2020-10-27,Washington,53,108966,573,2438,10,2372596,12209,103500,587,2269096,11622
2020-10-27,West Virginia,54,22706,483,432,8,743737,7361,22706,483,721031,6878
2020-10-27,Wisconsin,55,217447,5331,1896,71,2006587,16767,217429,5501,1789158,11266
2020-10-27,Wyoming,56,11806,329,77,0,125492,329,11806,329,113686,0
2020-10-28,Alabama,01,187706,1269,2911,19,1347632,7747,187706,1269,1159926,6478
2020-10-28,Alaska,02,15053,354,67,1,580599,3170,14131,352,566468,2818
2020-10-28,Arizona,04,241259,1101,5906,15,1736979,6817,241165,1043,1495814,5774
2020-10-28,Arkansas,05,108640,961,1875,18,1320831,9977,108640,961,1212191,9016
2020-10-28,California,06,922680,4053,17541,63,18223596,96547,908713,4515,17314883,92032
2020-10-28,Colorado,08,100614,1503,2277,12,1191858,8104,100208,1475,1091650,6629
2020-10-28,Connecticut,09,69127,490,4604,9,2235373,14339,69127,490,2166246,13849
2020-10-28,Delaware,10,24392,143,688,2,344939,1798,24392,143,320547,1655
2020-10-28,District of Columbia,11,16973,67,644,0,505407,2869,16973,67,488434,2802
2020-10-28,Florida,12,790418,4115,16570,66,6030177,38539,780220,4005,5249957,34534
2020-10-28,Georgia,13,367126,1628,7692,31,3495407,20516,355025,1653,3140382,18863
2020-10-28,Guam,66,5435,48,77,1,65664,619,4466,48,61198,571
2020-10-28,Hawaii,15,14975,55,212,-2,310131,64,14978,64,295153,0
2020-10-28,Idaho,16,62197,915,600,12,382784,2252,60923,882,321861,1370
2020-10-28,Illinois,17,395204,6116,9912,52,7463755,70752,393808,6110,7069947,64642
2020-10-28,Indiana,18,171566,2570,4227,33,1657090,10548,169112,2548,1487978,8000
2020-10-28,Iowa,19,120911,2059,1691,11,873362,4342,113042,1781,760320,2561
2020-10-28,Kansas,20,83485,2724,1007,28,633033,7102,82045,3369,550988,3733
2020-10-28,Kentucky,21,103685,1985,1509,16,1847286,10598,101494,1857,1745792,8741
2020-10-28,Louisiana,22,185822,1098,5890,18,2738401,15124,185822,1098,2552579,14026
2020-10-28,Maine,23,6387,76,146,0,603303,7517,6387,76,596916,7441
2020-10-28,Maryland,24,142918,681,4115,7,1905952,7858,142425,684,1763527,7174
2020-10-28,Massachusetts,25,154218,1181,9924,36,2688340,18689,154218,1181,2534122,17508
2020-10-28,Michigan,26,185818,3534,7606,21,4748002,54532,185934,3590,4562068,50942
2020-10-28,Minnesota,27,139497,1908,2440,19,1801504,9426,139444,1908,1662060,7518
2020-10-28,Mississippi,28,117617,1000,3302,19,881604,35443,117617,1000,763987,34443
2020-10-28,Missouri,29,181877,2420,2940,28,1481236,6831,174632,1915,1306604,4916
2020-10-28,Montana,30,30051,629,326,17,484470,3148,29966,620,454504,2528
2020-10-28,Nebraska,31,66545,1169,629,6,577023,4263,65376,877,511647,3386
2020-10-28,Nevada,32,97824,686,1767,10,798250,3329,97479,571,700771,2758
2020-10-28,New Hampshire,33,10641,111,478,3,336063,1654,10641,110,325422,1544
2020-10-28,New Jersey,34,234790,1670,16324,18,4523611,38798,232997,1666,4290614,37132
2020-10-28,New Mexico,35,43826,657,991,11,1141186,11767,43826,657,1097360,11110
2020-10-28,New York,36,505416,2029,33107,15,14075518,129660,500677,2031,13574841,127629
2020-10-28,North Carolina,37,266566,2232,4275,39,3923042,32278,266136,2253,3656906,30025
2020-10-28,North Dakota,38,39912,777,493,12,287524,1328,39907,777,247617,551
2020-10-28,Northern Mariana Islands,69,92,0,2,0,16085,0,92,0,15993,0
2020-10-28,Ohio,39,205347,2607,5256,17,4314037,31433,205347,2607,4108690,28826
2020-10-28,Oklahoma,40,119152,743,1286,13,1575866,11390,119152,743,1456714,10647
2020-10-28,Oregon,41,43228,407,673,8,841049,4054,43228,420,797821,3634
2020-10-28,Pennsylvania,42,205852,2332,8789,29,2469920,16951,200674,2228,2269246,14723
2020-10-28,Puerto Rico,72,63587,90,813,5,338499,66,32527,66,305972,0
2020-10-28,Rhode Island,44,31944,499,1192,4,426355,2886,31944,499,394411,2387
2020-10-28,South Carolina,45,173491,912,3876,34,1753781,8755,173491,912,1580290,7843
2020-10-28,South Dakota,46,42000,1270,384,9,251296,2131,42000,1270,209296,861
2020-10-28,Tennessee,47,250269,2581,3209,33,3608613,22372,254220,2446,3354393,19926
2020-10-28,Texas,48,932245,7770,18251,96,7933477,50037,879994,5627,7053483,44410
2020-10-28,Utah,49,108863,1617,588,9,1019962,6567,108803,1575,911159,4992
2020-10-28,Vermont,50,2120,7,58,0,185577,535,2138,11,183439,524
2020-10-28,Virgin Islands,78,1353,2,21,0,23945,286,1353,2,22592,284
2020-10-28,Virginia,51,176754,1345,3616,16,2575759,20174,176754,1345,2399005,18829
2020-10-28,Washington,53,109865,899,2454,16,2362595,-10001,104027,527,2258568,-10528
2020-10-28,West Virginia,54,23064,358,436,4,748959,5222,23064,358,725895,4864
2020-10-28,Wisconsin,55,221578,4131,1953,57,2016720,10133,221559,4130,1795161,6003
2020-10-28,Wyoming,56,12146,340,77,0,125832,340,12146,340,113686,0
2020-10-29,Alabama,01,189149,1443,2914,3,1355047,7415,189149,1443,1165898,5972
2020-10-29,Alaska,02,15417,364,72,5,584268,3669,14481,350,569787,3319
2020-10-29,Arizona,04,242510,1251,5920,14,1751307,14328,242480,1315,1508827,13013
2020-10-29,Arkansas,05,109712,1072,1894,19,1333414,12583,109712,1072,1223702,11511
2020-10-29,California,06,926893,4213,17567,26,18323771,100175,912904,4191,17410867,95984
2020-10-29,Colorado,08,102665,2051,2295,18,1203209,11351,102014,1806,1101195,9545
2020-10-29,Connecticut,09,70446,1319,4609,5,2257892,22519,70446,1319,2187446,21200
2020-10-29,Delaware,10,24553,161,689,1,346423,1484,24553,161,321870,1323
2020-10-29,District of Columbia,11,17074,101,645,1,509864,4457,17074,101,492790,4356
2020-10-29,Florida,12,794616,4198,16647,77,6068498,38321,784331,4111,5284167,34210
2020-10-29,Georgia,13,368840,1714,7737,45,3516162,20755,356848,1823,3159314,18932
2020-10-29,Guam,66,5518,83,79,2,66385,721,4549,83,61836,638
2020-10-29,Hawaii,15,15046,71,214,2,310192,61,15039,61,295153,0
2020-10-29,Idaho,16,63195,998,618,18,385806,3022,61785,862,324021,2160
2020-10-29,Illinois,17,401622,6418,9963,51,7546811,83056,400171,6363,7146640,76693
2020-10-29,Indiana,18,175190,3624,4260,33,1671093,14003,172730,3618,1498363,10385
2020-10-29,Iowa,19,123232,2321,1705,14,878864,5502,114982,1940,763882,3562
2020-10-29,Kansas,20,83838,353,1008,1,633033,0,82045,0,550988,0
2020-10-29,Kentucky,21,105517,1832,1524,15,1857453,10167,103305,1811,1754148,8356
2020-10-29,Louisiana,22,186216,394,5908,18,2751797,13396,186216,394,2565581,13002
2020-10-29,Maine,23,6467,80,146,0,611912,8609,6467,80,605445,8529
2020-10-29,Maryland,24,143875,957,4127,12,1916848,10896,143387,962,1773461,9934
2020-10-29,Massachusetts,25,155564,1346,9951,27,2706776,18436,155564,1346,2551212,17090
2020-10-29,Michigan,26,189926,4108,7651,45,4800717,52715,190043,4109,4610674,48606
2020-10-29,Minnesota,27,142364,2867,2472,32,1820395,18891,142311,2867,1678084,16024
2020-10-29,Mississippi,28,118587,970,3310,8,922851,41247,118587,970,804264,40277
2020-10-29,Missouri,29,184847,2970,2978,38,1490617,9381,177693,3061,1312924,6320
2020-10-29,Montana,30,30932,881,339,13,487607,3137,30853,887,456754,2250
2020-10-29,Nebraska,31,68150,1605,641,12,580729,3706,66545,1169,514184,2537
2020-10-29,Nevada,32,98814,990,1770,3,798618,368,98554,1075,700064,-707
2020-10-29,New Hampshire,33,10768,127,482,4,338508,2445,10768,127,327740,2318
2020-10-29,New Jersey,34,236340,1550,16332,8,4572531,48920,234547,1550,4337984,47370
2020-10-29,New Mexico,35,44904,1078,994,3,1153185,11999,44904,1078,1108281,10921
2020-10-29,New York,36,507913,2497,33128,21,14243871,168353,503176,2499,13740695,165854
2020-10-29,North Carolina,37,269419,2853,4307,32,3961343,38301,269021,2885,3692322,35416
2020-10-29,North Dakota,38,41135,1223,504,11,289520,1996,41130,1223,248390,773
2020-10-29,Northern Mariana Islands,69,92,0,2,0,16085,0,92,0,15993,0
2020-10-29,Ohio,39,208937,3590,5275,19,4365090,51053,208937,3590,4156153,47463
2020-10-29,Oklahoma,40,120193,1041,1306,20,1586185,10319,120193,1041,1465992,9278
2020-10-29,Oregon,41,43793,565,674,1,848795,7746,43793,565,805002,7181
2020-10-29,Pennsylvania,42,208087,2235,8828,39,2485704,15784,202876,2202,2282828,13582
2020-10-29,Puerto Rico,72,64798,1211,814,1,339251,752,33279,752,305972,0
2020-10-29,Rhode Island,44,32312,368,1195,3,429340,2985,32312,368,397028,2617
2020-10-29,South Carolina,45,174591,1100,3889,13,1773742,19961,174591,1100,1599151,18861
2020-10-29,South Dakota,46,43000,1000,403,19,253514,2218,43000,1000,210514,1218
2020-10-29,Tennessee,47,252727,2458,3229,20,3637643,29030,256880,2660,3380763,26370
2020-10-29,Texas,48,939355,7110,18372,121,8005112,71635,886820,6826,7118292,64809
2020-10-29,Utah,49,110666,1803,598,10,1029872,9910,110640,1837,919232,8073
2020-10-29,Vermont,50,2141,21,58,0,186570,993,2154,16,184416,977
2020-10-29,Virgin Islands,78,1353,0,21,0,23945,0,1353,0,22592,0
2020-10-29,Virginia,51,178183,1429,3636,20,2596604,20845,178183,1429,2418421,19416
2020-10-29,Washington,53,110748,883,2463,9,2383332,20737,104743,716,2278589,20021
2020-10-29,West Virginia,54,23466,402,443,7,759646,10687,23466,402,736180,10285
2020-10-29,Wisconsin,55,226712,5134,2008,55,2030170,13450,226705,5146,1803465,8304
2020-10-29,Wyoming,56,12507,361,87,10,129462,3630,12507,361,116955,3269
2020-10-30,Alabama,01,190496,1347,2932,18,1363465,8418,190496,1347,1172969,7071
2020-10-30,Alaska,02,15803,386,76,4,586323,2055,14858,377,571465,1678
2020-10-30,Arizona,04,244099,1589,5934,14,1764784,13477,244045,1565,1520739,11912
2020-10-30,Arkansas,05,110874,1162,1900,6,1345040,11626,110874,1162,1234166,10464
2020-10-30,California,06,931826,4933,17627,60,18444523,120752,916918,4014,17527605,116738
2020-10-30,Colorado,08,104927,2262,2302,7,1214467,11258,104426,2412,1110041,8846
2020-10-30,Connecticut,09,71207,761,4616,7,2288584,30692,71207,761,2217377,29931
2020-10-30,Delaware,10,24751,198,704,15,348527,2104,24751,198,323776,1906
2020-10-30,District of Columbia,11,17144,70,646,1,514130,4266,17144,70,496986,4196
2020-10-30,Florida,12,800208,5592,16719,72,6073881,5383,789714,5383,5284167,0
2020-10-30,Georgia,13,370157,1317,7768,31,3559307,43145,358225,1377,3201082,41768
2020-10-30,Guam,66,5597,79,80,1,67029,644,4628,79,62401,565
2020-10-30,Hawaii,15,15145,99,215,1,310269,77,15116,77,295153,0
2020-10-30,Idaho,16,64175,980,627,9,388785,2979,62746,961,326039,2018
2020-10-30,Illinois,17,410141,8519,10012,49,7643468,96657,408660,8489,7234808,88168
2020-10-30,Indiana,18,178372,3182,4286,26,1684783,13690,175893,3163,1508890,10527
2020-10-30,Iowa,19,125973,2741,1714,9,884252,5388,117185,2203,767067,3185
2020-10-30,Kansas,20,86768,2930,1029,21,642782,9749,85181,3136,557601,6613
2020-10-30,Kentucky,21,107620,2103,1543,19,1892860,35407,105242,1937,1787618,33470
2020-10-30,Louisiana,22,186649,433,5919,11,2763671,11874,186649,433,2577022,11441
2020-10-30,Maine,23,6570,103,146,0,623413,11501,6570,103,616843,11398
2020-10-30,Maryland,24,144800,925,4137,10,1926518,9670,144314,927,1782204,8743
2020-10-30,Massachusetts,25,157146,1582,9975,24,2727118,20342,157146,1582,2569972,18760
2020-10-30,Michigan,26,193360,3434,7664,13,4862083,61366,193388,3345,4668695,58021
2020-10-30,Minnesota,27,145519,3155,2491,19,1836799,16404,145465,3154,1691334,13250
2020-10-30,Mississippi,28,119336,749,3328,18,923600,749,119336,749,804264,0
2020-10-30,Missouri,29,187830,2983,3014,36,1499282,8665,180200,2507,1319082,6158
2020-10-30,Montana,30,31995,1063,368,29,492629,5022,31916,1063,460713,3959
2020-10-30,Nebraska,31,69645,1495,646,5,586098,5369,68150,1605,517948,3764
2020-10-30,Nevada,32,100038,1224,1777,7,803585,4967,99786,1232,703799,3735
2020-10-30,New Hampshire,33,10884,116,482,0,338696,188,10884,116,327812,72
2020-10-30,New Jersey,34,238316,1976,16339,7,4574507,1976,236523,1976,4337984,0
2020-10-30,New Mexico,35,45909,1005,1007,13,1161887,8702,45909,1005,1115978,7697
2020-10-30,New York,36,510171,2258,33143,15,14390756,146885,505431,2255,13885325,144630
2020-10-30,North Carolina,37,272231,2812,4354,47,4005791,44448,271830,2809,3733961,41639
2020-10-30,North Dakota,38,42488,1353,517,13,291938,2418,42483,1353,249455,1065
2020-10-30,Northern Mariana Islands,69,92,0,2,0,16085,0,92,0,15993,0
2020-10-30,Ohio,39,212782,3845,5291,16,4413936,48846,212782,3845,4201154,45001
2020-10-30,Oklahoma,40,121495,1302,1326,20,1601775,15590,121495,1302,1480280,14288
2020-10-30,Oregon,41,44388,595,677,3,854938,6143,44389,596,810549,5547
2020-10-30,Pennsylvania,42,210586,2499,8860,32,2503500,17796,205517,2641,2297983,15155
2020-10-30,Puerto Rico,72,65743,945,820,6,339825,574,33853,574,305972,0
2020-10-30,Rhode Island,44,32874,562,1201,6,432876,3536,32874,562,400002,2974
2020-10-30,South Carolina,45,175594,1003,3896,7,1788360,14618,175594,1003,1612766,13615
2020-10-30,South Dakota,46,44559,1559,415,12,256656,3142,44559,1559,212097,1583
2020-10-30,Tennessee,47,255332,2605,3307,78,3662089,24446,259488,2608,3402601,21838
2020-10-30,Texas,48,946023,6668,18477,105,8080012,74900,893451,6631,7186561,68269
2020-10-30,Utah,49,112932,2266,601,3,1039515,9643,112932,2292,926583,7351
2020-10-30,Vermont,50,2155,14,58,0,187145,575,2173,19,184972,556
2020-10-30,Virgin Islands,78,1362,9,21,0,24219,274,1362,9,22857,265
2020-10-30,Virginia,51,179639,1456,3643,7,2619752,23148,179639,1456,2440113,21692
2020-10-30,Washington,53,111893,1145,2468,5,2405352,22020,105557,814,2299795,21206
2020-10-30,West Virginia,54,23990,524,451,8,769302,9656,23990,524,745312,9132
2020-10-30,Wisconsin,55,232092,5380,2034,26,2049123,18953,232062,5357,1817061,13596
2020-10-30,Wyoming,56,13028,521,87,0,129983,521,13028,521,116955,0
2020-10-31,Alabama,01,192285,1789,2967,35,1374243,10778,192285,1789,1181958,8989
2020-10-31,Alaska,02,16247,444,77,1,604207,17884,15312,454,588895,17430
2020-10-31,Arizona,04,245962,1863,5979,45,1777369,12585,245946,1901,1531423,10684
2020-10-31,Arkansas,05,112190,1316,1925,25,1355680,10640,112190,1316,1243490,9324
2020-10-31,California,06,935248,3422,17661,34,18602317,157794,922005,5087,17680312,152707
2020-10-31,Colorado,08,107844,2917,2309,7,1229406,14939,107350,2924,1122056,12015
2020-10-31,Connecticut,09,71207,0,4616,0,2288584,0,71207,0,2217377,0
2020-10-31,Delaware,10,24951,200,708,4,350728,2201,24951,200,325777,2001
2020-10-31,District of Columbia,11,17266,122,646,0,514252,122,17266,122,496986,0
2020-10-31,Florida,12,802539,2331,16760,41,6126792,52911,791997,2283,5334795,50628
2020-10-31,Georgia,13,372631,2474,7790,22,3586394,27087,360790,2565,3225604,24522
2020-10-31,Guam,66,5650,53,80,0,67452,423,4681,53,62771,370
2020-10-31,Hawaii,15,15207,62,218,3,310369,100,15216,100,295153,0
2020-10-31,Idaho,16,64797,622,630,3,391890,3105,63810,1064,328080,2041
2020-10-31,Illinois,17,416557,6416,10030,18,7736104,92636,416559,7899,7319545,84737
2020-10-31,Indiana,18,181837,3465,4332,46,1699008,14225,179358,3465,1519650,10760
2020-10-31,Iowa,19,128798,2825,1716,2,890432,6180,119755,2570,770677,3610
2020-10-31,Kansas,20,86771,3,1029,0,642782,0,85181,0,557601,0
2020-10-31,Kentucky,21,109244,1624,1551,8,1912810,19950,107219,1977,1805591,17973
2020-10-31,Louisiana,22,186649,0,5919,0,2763671,0,186649,0,2577022,0
2020-10-31,Maine,23,6668,98,147,1,623511,98,6668,98,616843,0
2020-10-31,Maryland,24,145593,793,4147,10,1938672,12154,145281,967,1793391,11187
2020-10-31,Massachusetts,25,158576,1430,9991,16,2745378,18260,158576,1430,2586802,16830
2020-10-31,Michigan,26,197164,3804,7699,35,4911592,49509,197406,4018,4714186,45491
2020-10-31,Minnesota,27,148526,3007,2511,20,1854258,17459,148472,3007,1705786,14452
2020-10-31,Mississippi,28,120160,824,3334,6,924424,824,120160,824,804264,0
2020-10-31,Missouri,29,189925,2095,3090,76,1510155,10873,183186,2986,1326969,7887
2020-10-31,Montana,30,32801,806,377,9,498915,6286,32801,885,466114,5401
2020-10-31,Nebraska,31,70732,1087,652,6,591018,4920,69645,1495,521373,3425
2020-10-31,Nevada,32,100844,806,1779,2,808487,4902,100763,977,707724,3925
2020-10-31,New Hampshire,33,11084,200,483,1,345085,6389,11084,200,334001,6189
2020-10-31,New Jersey,34,239679,1363,16350,11,4656106,81599,237886,1363,4418220,80236
2020-10-31,New Mexico,35,46490,581,1018,11,1172720,10833,46490,581,1126230,10252
2020-10-31,New York,36,512223,2052,33152,9,14527718,136962,507480,2049,14020238,134913
2020-10-31,North Carolina,37,274805,2574,4400,46,4055156,49365,274635,2805,3780521,46560
2020-10-31,North Dakota,38,43921,1433,529,12,294064,2126,43916,1433,250148,693
2020-10-31,Northern Mariana Islands,69,92,0,2,0,16085,0,92,0,15993,0
2020-10-31,Ohio,39,215697,2915,5301,10,4471680,57744,215697,2915,4255983,54829
2020-10-31,Oklahoma,40,122762,1267,1337,11,1617394,15619,122762,1267,1494632,14352
2020-10-31,Oregon,41,44923,535,690,13,861949,7011,44921,532,817028,6479
2020-10-31,Pennsylvania,42,212816,2230,8883,23,2522661,19161,208027,2510,2314634,16651
2020-10-31,Puerto Rico,72,66128,385,822,2,340110,285,34138,285,305972,0
2020-10-31,Rhode Island,44,32874,0,1201,0,436561,3685,33408,534,403153,3151
2020-10-31,South Carolina,45,176612,1018,3935,39,1802050,13690,176612,1018,1625438,12672
2020-10-31,South Dakota,46,45992,1433,425,10,259532,2876,45992,1433,213540,1443
2020-10-31,Tennessee,47,256923,1591,3322,15,3671773,9684,260672,1184,3411101,8500
2020-10-31,Texas,48,953451,7428,18549,72,8154233,74221,900596,7145,7253637,67076
2020-10-31,Utah,49,114670,1738,604,3,1046819,7304,114656,1724,932163,5580
2020-10-31,Vermont,50,2179,24,58,0,188152,1007,2195,22,185957,985
2020-10-31,Virgin Islands,78,1376,14,21,0,24430,211,1376,14,23054,197
2020-10-31,Virginia,51,181190,1551,3654,11,2639539,19787,181190,1551,2458349,18236
2020-10-31,Washington,53,112580,687,2468,0,2426385,21033,106573,1016,2319812,20017
2020-10-31,West Virginia,54,24460,470,457,6,778494,9192,24460,470,754034,8722
2020-10-31,Wisconsin,55,237870,5778,2092,58,2064506,15383,237870,5808,1826636,9575
2020-10-31,Wyoming,56,13298,270,87,0,130560,577,13298,270,117262,307
2020-11-01,Alabama,01,193985,1700,2973,6,1381326,7083,193985,1700,1187341,5383
2020-11-01,Alaska,02,16597,350,78,1,604207,0,15663,351,588544,-351
2020-11-01,Arizona,04,247484,1522,5981,2,1791644,14275,247473,1527,1544171,12748
2020-11-01,Arkansas,05,113057,867,1958,33,1355680,0,112190,0,1243490,0
2020-11-01,California,06,938883,3635,17671,10,18743315,140998,926534,4529,17816781,136469
2020-11-01,Colorado,08,110640,2796,2312,3,1243467,14061,109910,2560,1133557,11501
2020-11-01,Connecticut,09,71207,0,4616,0,2288584,0,71207,0,2217377,0
2020-11-01,Delaware,10,25126,175,710,2,352348,1620,25126,175,327222,1445
2020-11-01,District of Columbia,11,17369,103,646,0,525246,10994,17369,103,507877,10891
2020-11-01,Florida,12,807404,4865,16788,28,6175891,49099,796802,4805,5379089,44294
2020-11-01,Georgia,13,373700,1069,7792,2,3587586,1192,361982,1192,3225604,0
2020-11-01,Guam,66,5659,9,80,0,67563,111,4690,9,62873,102
2020-11-01,Hawaii,15,15287,80,218,0,310437,68,15284,68,295153,0
2020-11-01,Idaho,16,65272,475,631,1,394191,2301,64608,798,329583,1503
2020-11-01,Illinois,17,424860,8303,10091,61,7814562,78458,423539,6980,7391023,71478
2020-11-01,Indiana,18,184589,2752,4364,32,1709944,10936,182108,2750,1527836,8186
2020-11-01,Iowa,19,131097,2299,1733,17,897175,6743,121967,2212,775208,4531
2020-11-01,Kansas,20,86809,38,1029,0,642782,0,85181,0,557601,0
2020-11-01,Kentucky,21,110600,1356,1554,3,1914233,1423,108642,1423,1805591,0
2020-11-01,Louisiana,22,187720,1071,5926,7,2783118,19447,187720,1071,2595398,18376
2020-11-01,Maine,23,6715,47,147,0,623558,47,6715,47,616843,0
2020-11-01,Maryland,24,146627,1034,4152,5,1949180,10508,146145,864,1803035,9644
2020-11-01,Massachusetts,25,159707,1131,10013,22,2762094,16716,159707,1131,2602387,15585
2020-11-01,Michigan,26,197501,337,7700,1,4911592,0,197406,0,4714186,0
2020-11-01,Minnesota,27,150726,2200,2529,18,1869845,15587,150672,2200,1719173,13387
2020-11-01,Mississippi,28,120500,340,3348,14,924764,340,120500,340,804264,0
2020-11-01,Missouri,29,192141,2216,3091,1,1518716,8561,185535,2349,1333181,6212
2020-11-01,Montana,30,33495,694,378,1,501704,2789,33495,694,468209,2095
2020-11-01,Nebraska,31,71666,934,658,6,594432,3414,70732,1087,523700,2327
2020-11-01,Nevada,32,101594,750,1783,4,813190,4703,101479,716,711711,3987
2020-11-01,New Hampshire,33,11214,130,483,0,347135,2050,11214,130,335921,1920
2020-11-01,New Jersey,34,241422,1743,16354,4,4657849,1743,239629,1743,4418220,0
2020-11-01,New Mexico,35,47232,742,1026,8,1182514,9794,47232,742,1135282,9052
2020-11-01,New York,36,514482,2259,33174,22,14676653,148935,509735,2255,14166918,146680
2020-11-01,North Carolina,37,276706,1901,4405,5,4095365,40209,276692,2057,3818673,38152
2020-11-01,North Dakota,38,45048,1127,536,7,295793,1729,45043,1127,250750,602
2020-11-01,Northern Mariana Islands,69,96,4,2,0,16089,4,96,4,15993,0
2020-11-01,Ohio,39,219000,3303,5303,2,4524758,53078,219000,3303,4305758,49775
2020-11-01,Oklahoma,40,124111,1349,1345,8,1618743,1349,124111,1349,1494632,0
2020-11-01,Oregon,41,45419,496,691,1,867792,5843,45429,508,822363,5335
2020-11-01,Pennsylvania,42,214500,1684,8888,5,2537746,15085,209936,1909,2327810,13176
2020-11-01,Puerto Rico,72,66661,533,832,10,340513,403,34541,403,305972,0
2020-11-01,Rhode Island,44,32874,0,1201,0,439334,2773,33888,480,405446,2293
2020-11-01,South Carolina,45,178023,1411,3936,1,1827352,25302,178023,1411,1649329,23891
2020-11-01,South Dakota,46,47324,1332,437,12,262165,2633,47324,1332,214841,1301
2020-11-01,Tennessee,47,257658,735,3322,0,3683173,11400,261426,754,3421747,10646
2020-11-01,Texas,48,957789,4338,18582,33,8218245,64012,904855,4259,7313390,59753
2020-11-01,Utah,49,116510,1840,614,10,1053391,6572,116510,1854,936881,4718
2020-11-01,Vermont,50,2196,17,58,0,188584,432,2212,17,186372,415
2020-11-01,Virgin Islands,78,1376,0,21,0,24430,0,1376,0,23054,0
2020-11-01,Virginia,51,182392,1202,3655,1,2661376,21837,182392,1202,2478984,20635
2020-11-01,Washington,53,113109,529,2468,0,2450122,23737,107501,928,2342621,22809
2020-11-01,West Virginia,54,24883,423,457,0,787586,9092,24883,423,762703,8669
2020-11-01,Wisconsin,55,241423,3553,2110,18,2082628,18122,241423,3553,1841205,14569
2020-11-01,Wyoming,56,13723,425,87,0,130985,425,13723,425,117262,0
2020-11-02,Alabama,01,194892,907,2973,0,1385328,4002,194892,907,1190436,3095
2020-11-02,Alaska,02,16948,351,79,1,620170,15963,16007,344,604163,15619
2020-11-02,Arizona,04,248293,809,5982,1,1798521,6877,248139,666,1550382,6211
2020-11-02,Arkansas,05,113641,584,1985,27,1372367,16687,113641,1451,1258726,15236
2020-11-02,California,06,944141,5258,17700,29,18912501,169186,930628,4094,17981873,165092
2020-11-02,Colorado,08,112821,2181,2320,8,1256328,12861,112147,2237,1144181,10624
2020-11-02,Connecticut,09,73858,2651,4627,11,2367994,79410,73858,2651,2294136,76759
2020-11-02,Delaware,10,25311,185,710,0,354670,2322,25311,185,329359,2137
2020-11-02,District of Columbia,11,17438,69,647,1,528174,2928,17438,69,510736,2859
2020-11-02,Florida,12,812055,4651,16833,45,6200385,24494,801371,4569,5399014,19925
2020-11-02,Georgia,13,377261,3561,7810,18,3596700,9114,362921,939,3233779,8175
2020-11-02,Guam,66,5662,3,80,0,67664,101,4693,3,62971,98
2020-11-02,Hawaii,15,15359,72,218,0,310520,83,15367,83,295153,0
2020-11-02,Idaho,16,66249,977,641,10,396267,2076,65088,480,331179,1596
2020-11-02,Illinois,17,431281,6421,10115,24,7882680,68118,429761,6222,7452919,61896
2020-11-02,Indiana,18,187665,3076,4390,26,1722842,12898,185185,3077,1537657,9821
2020-11-02,Iowa,19,132697,1600,1755,22,900994,3819,123372,1405,777622,2414
2020-11-02,Kansas,20,90613,3804,1046,17,655267,12485,89227,4046,566040,8439
2020-11-02,Kentucky,21,111816,1216,1565,11,1943582,29349,109670,1028,1833912,28321
2020-11-02,Louisiana,22,187995,275,5934,8,2788484,5366,187995,275,2600489,5091
2020-11-02,Maine,23,6799,84,148,1,644435,20877,6799,84,637636,20793
2020-11-02,Maryland,24,147477,850,4155,3,1960445,11265,146995,850,1813450,10415
2020-11-02,Massachusetts,25,160549,842,10023,10,2776247,14153,160549,842,2615698,13311
2020-11-02,Michigan,26,204135,6634,7716,16,5008299,96707,204326,6920,4803973,89787
2020-11-02,Minnesota,27,153674,2948,2538,9,1892909,23064,153620,2948,1739289,20116
2020-11-02,Mississippi,28,120865,365,3348,0,958073,33309,120865,365,837208,32944
2020-11-02,Missouri,29,195938,3797,3101,10,1528098,9382,188186,2651,1339912,6731
2020-11-02,Montana,30,34317,822,387,9,508931,7227,34252,757,474679,6470
2020-11-02,Nebraska,31,72631,965,659,1,597204,2772,71666,934,525538,1838
2020-11-02,Nevada,32,102243,649,1785,2,816433,3243,102114,635,714319,2608
2020-11-02,New Hampshire,33,11320,106,483,0,348198,1063,11320,106,336878,957
2020-11-02,New Jersey,34,242790,1368,16357,3,4721797,63948,240997,1368,4480800,62580
2020-11-02,New Mexico,35,48104,872,1036,10,1191327,8813,48104,872,1143223,7941
2020-11-02,New York,36,516114,1632,33187,13,14772754,96101,511368,1633,14261386,94468
2020-11-02,North Carolina,37,278477,1771,4413,8,4127596,32231,278028,1336,3849568,30895
2020-11-02,North Dakota,38,46020,972,545,9,297447,1654,46015,972,251432,682
2020-11-02,Northern Mariana Islands,69,96,0,2,0,16089,0,96,0,15993,0
2020-11-02,Ohio,39,221909,2909,5340,37,4564903,40145,221909,2909,4342994,37236
2020-11-02,Oklahoma,40,125195,1084,1354,9,1619827,1084,125195,1084,1494632,0
2020-11-02,Oregon,41,45978,559,694,3,871900,4108,45978,549,825922,3559
2020-11-02,Pennsylvania,42,217243,2743,8893,5,2550660,12914,211996,2060,2338664,10854
2020-11-02,Puerto Rico,72,68172,1511,839,7,341377,864,35405,864,305972,0
2020-11-02,Rhode Island,44,34120,1246,1210,9,440626,1292,34120,232,406506,1060
2020-11-02,South Carolina,45,178917,894,3946,10,1842038,14686,178917,894,1663121,13792
2020-11-02,South Dakota,46,47850,526,438,1,263137,972,47850,526,215287,446
2020-11-02,Tennessee,47,260275,2617,3347,25,3720657,37484,264587,3161,3456070,34323
2020-11-02,Texas,48,965780,7991,18626,44,8291703,73458,909257,4402,7382446,69056
2020-11-02,Utah,49,117767,1257,614,0,1061170,7779,117706,1196,943464,6583
2020-11-02,Vermont,50,2219,23,58,0,188852,268,2235,23,186617,245
2020-11-02,Virgin Islands,78,1376,0,21,0,24519,89,1378,2,23141,87
2020-11-02,Virginia,51,183418,1026,3658,3,2677061,15685,183418,1026,2493643,14659
2020-11-02,Washington,53,114787,1678,2484,16,2469146,19024,108315,814,2360831,18210
2020-11-02,West Virginia,54,25235,352,458,1,794491,6905,25235,352,769256,6553
2020-11-02,Wisconsin,55,244974,3551,2117,7,2091546,8918,244928,3505,1846618,5413
2020-11-02,Wyoming,56,14167,444,87,0,134018,3033,14167,444,119851,2589
2020-11-03,Alabama,01,195929,1037,2987,14,1392351,7023,195929,1037,1196422,5986
2020-11-03,Alaska,02,17339,391,79,0,624755,4585,16390,383,608365,4202
2020-11-03,Arizona,04,249841,1548,6022,40,1809271,10750,249818,1679,1559453,9071
2020-11-03,Arkansas,05,114519,878,2003,18,1378181,5814,114519,878,1263662,4936
2020-11-03,California,06,949383,5242,17751,51,19074921,162420,934672,4044,18140249,158376
2020-11-03,Colorado,08,115364,2543,2337,17,1267145,10817,114709,2562,1152436,8255
2020-11-03,Connecticut,09,74843,985,4635,8,2367994,0,73858,0,2294136,0
2020-11-03,Delaware,10,25426,115,712,2,355667,997,25426,115,330241,882
2020-11-03,District of Columbia,11,17524,86,647,0,533419,5245,17524,86,515895,5159
2020-11-03,Florida,12,816692,4637,16889,56,6225760,25375,805924,4553,5419836,20822
2020-11-03,Georgia,13,378894,1633,7837,27,3618830,22130,364589,1668,3254241,20462
2020-11-03,Guam,66,5781,119,81,1,69028,1364,4812,119,64216,1245
2020-11-03,Hawaii,15,15441,82,218,0,310597,77,15444,77,295153,0
2020-11-03,Idaho,16,67504,1255,649,8,398739,2472,65845,757,332894,1715
2020-11-03,Illinois,17,437879,6598,10177,62,7965115,82435,436277,6516,7528838,75919
2020-11-03,Indiana,18,190555,2890,4439,49,1733575,10733,188066,2881,1545509,7852
2020-11-03,Iowa,19,134576,1879,1780,25,903136,2142,124464,1092,778672,1050
2020-11-03,Kansas,20,91072,459,1051,5,655267,0,89227,0,566040,0
2020-11-03,Kentucky,21,113457,1641,1578,13,1951791,8209,111379,1709,1840412,6500
2020-11-03,Louisiana,22,189148,1153,5951,17,2817860,29376,189148,1153,2628712,28223
2020-11-03,Maine,23,6926,127,148,0,647961,3526,6926,127,641035,3399
2020-11-03,Maryland,24,148249,772,4162,7,1967900,7455,147766,771,1820134,6684
2020-11-03,Massachusetts,25,161585,1036,10035,12,2790437,14190,161585,1036,2628852,13154
2020-11-03,Michigan,26,207799,3664,7758,42,5050490,42191,207763,3437,4842727,38754
2020-11-03,Minnesota,27,157150,3476,2553,15,1900013,7104,157096,3476,1742917,3628
2020-11-03,Mississippi,28,121509,644,3384,36,958717,644,121509,644,837208,0
2020-11-03,Missouri,29,198312,2374,3136,35,1539263,11165,190424,2238,1348839,8927
2020-11-03,Montana,30,35222,905,400,13,512524,3593,35159,907,477365,2686
2020-11-03,Nebraska,31,74060,1429,662,3,600064,2860,72620,954,527444,1906
2020-11-03,Nevada,32,103305,1062,1807,22,819896,3463,103025,911,716871,2552
2020-11-03,New Hampshire,33,11448,128,483,0,350194,1996,11448,128,338746,1868
2020-11-03,New Jersey,34,244614,1824,16371,14,4766659,44862,242825,1828,4523834,43034
2020-11-03,New Mexico,35,49240,1136,1045,9,1202347,11020,49240,1136,1153107,9884
2020-11-03,New York,36,518431,2317,33198,11,14900623,127869,513689,2321,14386934,125548
2020-11-03,North Carolina,37,280657,2180,4481,68,4157478,29882,280377,2349,3877101,27533
2020-11-03,North Dakota,38,47192,1172,561,16,299490,2043,47187,1172,252303,871
2020-11-03,Northern Mariana Islands,69,96,0,2,0,16089,0,96,0,15993,0
2020-11-03,Ohio,39,226138,4229,5373,33,4604715,39812,226138,4229,4378577,35583
2020-11-03,Oklahoma,40,126526,1331,1375,21,1647339,27512,126526,1331,1520813,26181
2020-11-03,Oregon,41,46460,482,701,7,877404,5504,46460,482,830944,5022
2020-11-03,Pennsylvania,42,220111,2868,8926,33,2569217,18557,214871,2875,2354346,15682
2020-11-03,Puerto Rico,72,68943,771,842,3,341722,345,35750,345,305972,0
2020-11-03,Rhode Island,44,34543,423,1212,2,443524,2898,34543,423,408981,2475
2020-11-03,South Carolina,45,179952,1035,3968,22,1855123,13085,179952,1035,1675171,12050
2020-11-03,South Dakota,46,48854,1004,446,8,265210,2073,48854,1004,216356,1069
2020-11-03,Tennessee,47,262053,1778,3419,72,3734564,13907,266357,1770,3468207,12137
2020-11-03,Texas,48,974292,8512,18722,96,8328869,37166,916773,7516,7412096,29650
2020-11-03,Utah,49,119375,1608,620,6,1068439,7269,119375,1669,949064,5600
2020-11-03,Vermont,50,2237,18,58,0,189137,285,2257,22,186880,263
2020-11-03,Virgin Islands,78,1385,9,22,1,24565,46,1385,7,23180,39
2020-11-03,Virginia,51,184679,1261,3666,8,2699771,22710,184679,1261,2515092,21449
2020-11-03,Washington,53,115608,821,2507,23,2470185,1039,109354,1039,2360831,0
2020-11-03,West Virginia,54,25593,358,469,11,800408,5917,25593,358,774815,5559
2020-11-03,Wisconsin,55,251227,6253,2179,62,2112994,21448,251032,6104,1861962,15344
2020-11-03,Wyoming,56,14619,452,93,6,135336,1318,14619,452,120717,866
2020-11-04,Alabama,01,197777,1848,3006,19,1401274,8923,197777,1848,1203497,7075
2020-11-04,Alaska,02,17750,411,79,0,627758,3003,16798,408,610960,2595
2020-11-04,Arizona,04,250853,1012,6059,37,1818497,9226,250633,815,1567864,8411
2020-11-04,Arkansas,05,115812,1293,2026,23,1389797,11616,115812,1293,1273985,10323
2020-11-04,California,06,954624,5241,17818,67,19181012,106091,940010,5338,18241002,100753
2020-11-04,Colorado,08,118356,2992,2366,29,1279847,12702,117637,2928,1162210,9774
2020-11-04,Connecticut,09,75373,530,4645,10,2401877,33883,75373,1515,2326504,32368
2020-11-04,Delaware,10,25534,108,712,0,356664,997,25534,108,331130,889
2020-11-04,District of Columbia,11,17601,77,647,0,537091,3672,17601,77,519490,3595
2020-11-04,Florida,12,821115,4423,16921,32,6247167,21407,810256,4332,5436911,17075
2020-11-04,Georgia,13,382113,3219,8303,466,3647278,28448,366452,1863,3280826,26585
2020-11-04,Guam,66,5872,91,84,3,69756,728,4903,91,64853,637
2020-11-04,Hawaii,15,15591,150,218,0,310684,87,15531,87,295153,0
2020-11-04,Idaho,16,68791,1287,665,16,401774,3035,67024,1179,334750,1856
2020-11-04,Illinois,17,445537,7658,10239,62,8036972,71857,443815,7538,7593157,64319
2020-11-04,Indiana,18,194261,3706,4464,25,1748496,14921,191764,3698,1556732,11223
2020-11-04,Iowa,19,137315,2739,1801,21,908054,4918,126740,2276,781314,2642
2020-11-04,Kansas,20,93967,2895,1087,36,663680,8413,92215,2988,571465,5425
2020-11-04,Kentucky,21,115426,1969,1593,15,1999654,47863,113009,1630,1886645,46233
2020-11-04,Louisiana,22,190164,1016,5975,24,2825919,8059,190164,1016,2635755,7043
2020-11-04,Maine,23,7077,151,150,2,657250,9289,7077,151,650173,9138
2020-11-04,Maryland,24,149232,983,4172,10,1979067,11167,148766,1000,1830301,10167
2020-11-04,Massachusetts,25,163299,1714,10062,27,2812539,22102,163299,1714,2649240,20388
2020-11-04,Michigan,26,212126,4327,7783,25,5093676,43186,212160,4397,4881516,38789
2020-11-04,Minnesota,27,160977,3827,2584,31,1920465,20452,160923,3827,1759542,16625
2020-11-04,Mississippi,28,122275,766,3397,13,959483,766,122275,766,837208,0
2020-11-04,Missouri,29,201515,3203,3166,30,1546955,7692,193023,2599,1353932,5093
2020-11-04,Montana,30,36012,790,404,4,517288,4764,35955,796,481333,3968
2020-11-04,Nebraska,31,75888,1828,673,11,603890,3826,74060,1440,529830,2386
2020-11-04,Nevada,32,104514,1209,1816,9,823543,3647,104093,1068,719450,2579
2020-11-04,New Hampshire,33,11563,115,484,1,351136,942,11563,115,339573,827
2020-11-04,New Jersey,34,247057,2443,16391,20,4769091,2432,245257,2432,4523834,0
2020-11-04,New Mexico,35,50251,1011,1059,14,1218805,16458,50251,1011,1168554,15447
2020-11-04,New York,36,520557,2126,33222,24,15034157,133534,515815,2126,14518342,131408
2020-11-04,North Carolina,37,283280,2623,4535,54,4184258,26780,282802,2425,3901456,24355
2020-11-04,North Dakota,38,48306,1114,573,12,301089,1599,48301,1114,252788,485
2020-11-04,Northern Mariana Islands,69,96,0,2,0,16089,0,96,0,15993,0
2020-11-04,Ohio,39,230209,4071,5428,55,4644416,39701,230209,4071,4414207,35630
2020-11-04,Oklahoma,40,127772,1246,1392,17,1657117,9778,127772,1246,1529345,8532
2020-11-04,Oregon,41,47049,589,707,6,882954,5550,47049,589,835905,4961
2020-11-04,Pennsylvania,42,222883,2772,8967,41,2591931,22714,217666,2795,2374265,19919
2020-11-04,Puerto Rico,72,69020,77,850,8,341779,57,35807,57,305972,0
2020-11-04,Rhode Island,44,35122,579,1214,2,447021,3497,35122,579,411899,2918
2020-11-04,South Carolina,45,180870,918,3985,17,1865888,10765,180870,918,1685018,9847
2020-11-04,South Dakota,46,49791,937,460,14,266796,1586,49791,937,217005,649
2020-11-04,Tennessee,47,265407,3354,3446,27,3760384,25820,269802,3445,3490582,22375
2020-11-04,Texas,48,984919,10627,18870,148,8404187,75318,926400,9627,7477787,65691
2020-11-04,Utah,49,121563,2188,625,5,1073952,5513,121485,2110,952467,3403
2020-11-04,Vermont,50,2267,30,58,0,190095,958,2288,31,187807,927
2020-11-04,Virgin Islands,78,1388,3,23,1,24746,181,1388,3,23358,178
2020-11-04,Virginia,51,185836,1157,3677,11,2715175,15404,185836,1157,2529339,14247
2020-11-04,Washington,53,117091,1483,2526,19,2495151,24966,110011,657,2385140,24309
2020-11-04,West Virginia,54,25987,394,472,3,806208,5800,25987,394,780221,5406
2020-11-04,Wisconsin,55,257365,6138,2237,58,2129582,16588,257287,6255,1872295,10333
2020-11-04,Wyoming,56,15044,425,105,12,135761,425,15044,425,120717,0
2020-11-05,Alabama,01,199158,1381,3026,20,1408999,7725,199158,1381,1209841,6344
2020-11-05,Alaska,02,18064,314,79,0,781826,154068,17111,313,764715,153755
2020-11-05,Arizona,04,252843,1990,6087,28,1832929,14432,252768,2135,1580161,12297
2020-11-05,Arkansas,05,117360,1548,2037,11,1402973,13176,117360,1548,1285613,11628
2020-11-05,California,06,960884,6260,17866,48,19266363,85351,944576,4566,18321787,80785
2020-11-05,Colorado,08,122170,3814,2383,17,1294480,14633,121006,3369,1173474,11264
2020-11-05,Connecticut,09,77060,1687,4656,11,2459921,58044,77060,1687,2382861,56357
2020-11-05,Delaware,10,25753,219,716,4,358386,1722,25753,219,332633,1503
2020-11-05,District of Columbia,11,17682,81,650,3,540502,3411,17682,81,522820,3330
2020-11-05,Florida,12,827372,6257,16960,39,6291105,43938,816376,6120,5474729,37818
2020-11-05,Georgia,13,384531,2418,8359,56,3672160,24882,368368,1916,3303792,22966
2020-11-05,Guam,66,5973,101,84,0,70467,711,5004,101,65463,610
2020-11-05,Hawaii,15,15683,92,218,0,310839,155,15686,155,295153,0
2020-11-05,Idaho,16,70005,1214,673,8,404810,3036,68314,1290,336496,1746
2020-11-05,Illinois,17,455528,9991,10334,95,8122987,86015,453750,9935,7669237,76080
2020-11-05,Indiana,18,198684,4423,4511,47,1761947,13451,196176,4412,1565771,9039
2020-11-05,Iowa,19,142795,5480,1814,13,916404,8350,130732,3992,785672,4358
2020-11-05,Kansas,20,94427,460,1087,0,663680,0,92215,0,571465,0
2020-11-05,Kentucky,21,117654,2228,1611,18,2028170,28516,115277,2268,1912893,26248
2020-11-05,Louisiana,22,190845,681,5995,20,2847666,21747,190845,681,2656821,21066
2020-11-05,Maine,23,7260,183,150,0,667850,10600,7260,183,660590,10417
2020-11-05,Maryland,24,150424,1192,4182,10,1990023,10956,149964,1198,1840059,9758
2020-11-05,Massachusetts,25,165161,1862,10085,23,2837094,24555,165161,1862,2671933,22693
2020-11-05,Michigan,26,218136,6010,7833,50,5154882,61206,218263,6103,4936619,55103
2020-11-05,Minnesota,27,164919,3942,2609,25,1941496,21031,164865,3942,1776631,17089
2020-11-05,Mississippi,28,123887,1612,3405,8,961095,1612,123887,1612,837208,0
2020-11-05,Missouri,29,205036,3521,3197,31,1557001,10046,196576,3553,1360425,6493
2020-11-05,Montana,30,37024,1012,409,5,520024,2736,36968,1013,483056,1723
2020-11-05,Nebraska,31,78012,2124,678,5,608304,4414,75888,1828,532416,2586
2020-11-05,Nevada,32,105706,1192,1825,9,829573,6030,105360,1267,724213,4763
2020-11-05,New Hampshire,33,11808,245,486,2,356358,5222,11808,245,344550,4977
2020-11-05,New Jersey,34,249019,1962,16403,12,4818052,48961,247219,1962,4570833,46999
2020-11-05,New Mexico,35,51110,859,1082,23,1230205,11400,51110,859,1179095,10541
2020-11-05,New York,36,523559,3002,33247,25,15195176,161019,518812,2997,14676364,158022
2020-11-05,North Carolina,37,286210,2930,4572,37,4226942,42684,285661,2859,3941281,39825
2020-11-05,North Dakota,38,49842,1536,601,28,302970,1881,49837,1536,253133,345
2020-11-05,Northern Mariana Islands,69,96,0,2,0,16089,0,96,0,15993,0
2020-11-05,Ohio,39,235170,4961,5461,33,4695806,51390,235170,4961,4460636,46429
2020-11-05,Oklahoma,40,129873,2101,1413,21,1673557,16440,129873,2101,1543684,14339
2020-11-05,Oregon,41,47839,790,710,3,889027,6073,47839,790,841188,5283
2020-11-05,Pennsylvania,42,225698,2815,9009,42,2611902,19971,220566,2900,2391336,17071
2020-11-05,Puerto Rico,72,69416,396,855,5,342073,294,36101,294,305972,0
2020-11-05,Rhode Island,44,35750,628,1222,8,450428,3407,35750,628,414678,2779
2020-11-05,South Carolina,45,181639,769,3992,7,1873285,7397,181639,769,1691646,6628
2020-11-05,South Dakota,46,51151,1360,482,22,269136,2340,51151,1360,217985,980
2020-11-05,Tennessee,47,267557,2150,3474,28,3780132,19748,271771,1969,3508361,17779
2020-11-05,Texas,48,993894,8975,19000,130,8483728,79541,934994,8594,7548734,70947
2020-11-05,Utah,49,124366,2803,632,7,1086344,12392,124292,2807,962052,9585
2020-11-05,Vermont,50,2303,36,58,0,191033,938,2326,38,188707,900
2020-11-05,Virgin Islands,78,1388,0,23,0,24904,158,1388,0,23516,158
2020-11-05,Virginia,51,187202,1366,3688,11,2733990,18815,187202,1366,2546788,17449
2020-11-05,Washington,53,118459,1368,2542,16,2519494,24343,111480,1469,2408014,22874
2020-11-05,West Virginia,54,26547,560,480,8,817092,10884,26547,560,790545,10324
2020-11-05,Wisconsin,55,263640,6275,2273,36,2145384,15802,263571,6284,1881813,9518
2020-11-05,Wyoming,56,15409,365,105,0,138213,2452,15409,365,122804,2087
2020-11-06,Alabama,01,200714,1556,3049,23,1417716,8717,200714,1556,1217002,7161
2020-11-06,Alaska,02,18589,525,79,0,781301,-525,17618,507,763683,-1032
2020-11-06,Arizona,04,254961,2118,6111,24,1848745,15816,254764,1996,1593981,13820
2020-11-06,Arkansas,05,119230,1870,2056,19,1417494,14521,119230,1870,1298264,12651
2020-11-06,California,06,967597,6713,17939,73,19396349,129986,951094,6518,18445255,123468
2020-11-06,Colorado,08,125397,3227,2404,21,1310846,16366,124469,3463,1186377,12903
2020-11-06,Connecticut,09,78125,1065,4671,15,2489604,29683,78125,1065,2411479,28618
2020-11-06,Delaware,10,26035,282,716,0,360881,2495,26035,282,334846,2213
2020-11-06,District of Columbia,11,17792,110,652,2,546323,5821,17792,110,528531,5711
2020-11-06,Florida,12,832617,5245,17013,53,6325976,34871,821526,5150,5504450,29721
2020-11-06,Georgia,13,387202,2671,8389,30,3691733,19573,370106,1738,3321627,17835
2020-11-06,Guam,66,6046,73,89,5,71104,637,5077,73,66027,564
2020-11-06,Hawaii,15,15816,133,218,0,310938,99,15785,99,295153,0
2020-11-06,Idaho,16,71496,1491,685,12,408235,3425,69579,1265,338656,2160
2020-11-06,Illinois,17,466884,11356,10412,78,8215129,92142,465540,11790,7749589,80352
2020-11-06,Indiana,18,203332,4648,4547,36,1777105,15158,200823,4647,1576282,10511
2020-11-06,Iowa,19,146267,3472,1828,14,922017,5613,133510,2778,788507,2835
2020-11-06,Kansas,20,99605,5178,1172,85,676320,12640,97633,5418,578687,7222
2020-11-06,Kentucky,21,119952,2298,1621,10,2196876,168706,117505,2228,2079371,166478
2020-11-06,Louisiana,22,191715,870,6016,21,2866476,18810,191715,870,2674761,17940
2020-11-06,Maine,23,7444,184,150,0,676065,8215,7444,184,668621,8031
2020-11-06,Maryland,24,151964,1540,4194,12,2003170,13147,151505,1541,1851665,11606
2020-11-06,Massachusetts,25,167274,2113,10123,38,2857859,20765,167274,2113,2690585,18652
2020-11-06,Michigan,26,222423,4287,7883,50,5207467,52585,222509,4246,4984958,48339
2020-11-06,Minnesota,27,170361,5442,2645,36,1963849,22353,170307,5442,1793542,16911
2020-11-06,Mississippi,28,124854,967,3419,14,962062,967,124854,967,837208,0
2020-11-06,Missouri,29,210054,5018,3217,20,1567231,10230,200507,3931,1366724,6299
2020-11-06,Montana,30,38012,988,420,11,523596,3572,37947,979,485649,2593
2020-11-06,Nebraska,31,80693,2681,705,27,614043,5739,78012,2124,536031,3615
2020-11-06,Nevada,32,107258,1552,1846,21,835414,5841,106922,1562,728492,4279
2020-11-06,New Hampshire,33,12012,204,488,2,358730,2372,12012,204,346718,2168
2020-11-06,New Jersey,34,251180,2161,16416,13,4863436,45384,249380,2161,4614056,43223
2020-11-06,New Mexico,35,52394,1284,1088,6,1238575,8370,52394,1284,1186181,7086
2020-11-06,New York,36,526767,3208,33267,20,15355881,160705,522021,3209,14833860,157496
2020-11-06,North Carolina,37,289124,2914,4608,36,4277376,50434,288569,2908,3988807,47526
2020-11-06,North Dakota,38,51607,1765,618,17,305665,2695,51602,1765,254063,930
2020-11-06,Northern Mariana Islands,69,98,2,2,0,16091,2,98,2,15993,0
2020-11-06,Ohio,39,240178,5008,5494,33,4700814,5008,240178,5008,4460636,0
2020-11-06,Oklahoma,40,131751,1878,1429,16,1689601,16044,131751,1878,1557850,14166
2020-11-06,Oregon,41,48608,769,716,6,897602,8575,48608,769,848994,7806
2020-11-06,Pennsylvania,42,229346,3648,9052,43,2632316,20414,223950,3384,2408366,17030
2020-11-06,Puerto Rico,72,70519,1103,862,7,342876,803,36904,803,305972,0
2020-11-06,Rhode Island,44,36380,630,1224,2,453647,3219,36380,630,417267,2589
2020-11-06,South Carolina,45,182872,1233,4005,13,1897097,23812,182872,1233,1714225,22579
2020-11-06,South Dakota,46,52639,1488,510,28,272190,3054,52639,1488,219551,1566
2020-11-06,Tennessee,47,269292,1735,3508,34,3791407,11275,273144,1373,3518263,9902
2020-11-06,Texas,48,1003908,10014,19125,125,8553766,70038,942539,7545,7611227,62493
2020-11-06,Utah,49,127294,2928,649,17,1096628,10284,127279,2987,969349,7297
2020-11-06,Vermont,50,2326,23,58,0,191728,695,2354,28,189374,667
2020-11-06,Virgin Islands,78,1390,2,23,0,25118,214,1390,2,23728,212
2020-11-06,Virginia,51,188770,1568,3682,-6,2758354,24364,188770,1568,2569584,22796
2020-11-06,Washington,53,120123,1664,2552,10,2541074,21580,112550,1070,2428524,20510
2020-11-06,West Virginia,54,27087,540,487,7,827059,9967,27087,540,799972,9427
2020-11-06,Wisconsin,55,270074,6434,2340,67,2166439,21055,269982,6411,1896457,14644
2020-11-06,Wyoming,56,16405,996,105,0,140174,1961,16405,996,123769,965
2020-11-07,Alabama,01,202482,1768,3082,33,1427077,9361,202482,1768,1224595,7593
2020-11-07,Alaska,02,19194,605,79,0,780694,-607,18221,603,762473,-1210
2020-11-07,Arizona,04,257384,2423,6147,36,1865425,16680,257384,2620,1608041,14060
2020-11-07,Arkansas,05,120828,1598,2068,12,1429305,11811,120828,1598,1308477,10213
2020-11-07,California,06,972801,5204,17964,25,19565151,168802,956957,5863,18608194,162939
2020-11-07,Colorado,08,128611,3214,2417,13,1327974,17128,127967,3498,1200007,13630
2020-11-07,Connecticut,09,78125,0,4671,0,2489604,0,78125,0,2411479,0
2020-11-07,Delaware,10,26258,223,716,0,362931,2050,26258,223,336673,1827
2020-11-07,District of Columbia,11,17891,99,654,2,550585,4262,17891,99,532694,4163
2020-11-07,Florida,12,837069,4452,17099,86,6345029,19053,825906,4380,5519123,14673
2020-11-07,Georgia,13,389257,2055,8427,38,3715270,23537,371825,1719,3343445,21818
2020-11-07,Guam,66,6046,0,89,0,71507,403,5113,36,66394,367
2020-11-07,Hawaii,15,15939,123,219,1,311076,138,15923,138,295153,0
2020-11-07,Idaho,16,72528,1032,685,0,412887,4652,70909,1330,341978,3322
2020-11-07,Illinois,17,479061,12177,10498,86,8313547,98418,477978,12438,7835569,85980
2020-11-07,Indiana,18,208243,4911,4592,45,1794398,17293,205722,4899,1588676,12394
2020-11-07,Iowa,19,150639,4372,1842,14,928259,6242,137228,3718,791031,2524
2020-11-07,Kansas,20,99671,66,1166,-6,676320,0,97633,0,578687,0
2020-11-07,Kentucky,21,122021,2069,1640,19,2066810,-130066,119661,2156,1947149,-132222
2020-11-07,Louisiana,22,191715,0,6016,0,2866476,0,191715,0,2674761,0
2020-11-07,Maine,23,7603,159,152,2,676224,159,7603,159,668621,0
2020-11-07,Maryland,24,153198,1234,4201,7,2015314,12144,152915,1410,1862399,10734
2020-11-07,Massachusetts,25,169576,2302,10146,23,2881767,23908,169576,2302,2712191,21606
2020-11-07,Michigan,26,228706,6283,7943,60,5213961,6494,229003,6494,4984958,0
2020-11-07,Minnesota,27,175008,4647,2679,34,1983443,19594,174954,4647,1808489,14947
2020-11-07,Mississippi,28,125885,1031,3433,14,963093,1031,125885,1031,837208,0
2020-11-07,Missouri,29,213645,3591,3235,18,1578411,11180,205066,4559,1373345,6621
2020-11-07,Montana,30,38948,936,445,25,525176,1580,38948,1001,486228,579
2020-11-07,Nebraska,31,82395,1702,710,5,621532,7489,80693,2681,540839,4808
2020-11-07,Nevada,32,109326,2068,1851,5,842004,6590,108746,1824,733258,4766
2020-11-07,New Hampshire,33,12241,229,489,1,361706,2976,12241,229,349465,2747
2020-11-07,New Jersey,34,254382,3202,16425,9,4963630,100194,252582,3202,4711048,96992
2020-11-07,New Mexico,35,53671,1277,1104,16,1250724,12149,53671,1277,1197053,10872
2020-11-07,New York,36,530354,3587,33287,20,15519172,163291,525608,3587,14993564,159704
2020-11-07,North Carolina,37,291563,2439,4629,21,4324156,46780,291245,2676,4032911,44104
2020-11-07,North Dakota,38,53209,1602,633,15,307971,2306,53204,1602,254767,704
2020-11-07,Northern Mariana Islands,69,98,0,2,0,16091,0,98,0,15993,0
2020-11-07,Ohio,39,245727,5549,5506,12,4808908,108094,245727,5549,4563181,102545
2020-11-07,Oklahoma,40,136258,4507,1438,9,1703072,13471,131751,0,1571321,13471
2020-11-07,Oregon,41,49587,979,729,13,903099,5497,49587,979,853512,4518
2020-11-07,Pennsylvania,42,232582,3236,9089,37,2654106,21790,227985,4035,2426121,17755
2020-11-07,Puerto Rico,72,71532,1013,862,0,343539,663,37567,663,305972,0
2020-11-07,Rhode Island,44,36380,0,1224,0,460515,6868,37175,795,423340,6073
2020-11-07,South Carolina,45,184742,1870,4015,10,1944928,47831,184742,1870,1760186,45961
2020-11-07,South Dakota,46,53976,1337,523,13,274683,2493,53976,1337,220707,1156
2020-11-07,Tennessee,47,273603,4311,3556,48,3836617,45210,278215,5071,3558402,40139
2020-11-07,Texas,48,1009837,5929,19219,94,8634990,81224,950549,8010,7684441,73214
2020-11-07,Utah,49,130238,2944,658,9,1107994,11366,130235,2956,977759,8410
2020-11-07,Vermont,50,2347,21,59,1,192522,794,2382,28,190140,766
2020-11-07,Virgin Islands,78,1405,15,23,0,25118,0,1390,0,23728,0
2020-11-07,Virginia,51,190873,2103,3704,22,2782039,23685,190873,2103,2591166,21582
2020-11-07,Washington,53,121220,1097,2552,0,2568257,27183,114241,1691,2454016,25492
2020-11-07,West Virginia,54,27742,655,502,15,837704,10645,27742,655,809962,9990
2020-11-07,Wisconsin,55,277568,7494,2385,45,2185823,19384,277503,7521,1908320,11863
2020-11-07,Wyoming,56,16597,192,105,0,140366,192,16597,192,123769,0
2020-11-08,Alabama,01,203687,1205,3084,2,1433504,6427,203687,1205,1229817,5222
2020-11-08,Alaska,02,19712,518,79,0,780174,-520,18732,511,761442,-1031
2020-11-08,Arizona,04,259299,1915,6164,17,1879328,13903,259264,1880,1620064,12023
2020-11-08,Arkansas,05,121866,1038,2085,17,1438805,9500,121866,1038,1316939,8462
2020-11-08,California,06,978844,6043,17975,11,19724628,159477,964639,7682,18759989,151795
2020-11-08,Colorado,08,131870,3259,2421,4,1341956,13982,130984,3017,1210972,10965
2020-11-08,Connecticut,09,78125,0,4671,0,2489604,0,78125,0,2411479,0
2020-11-08,Delaware,10,26603,345,718,2,365279,2348,26603,345,338676,2003
2020-11-08,District of Columbia,11,18001,110,654,0,555449,4864,18001,110,537448,4754
2020-11-08,Florida,12,843889,6820,17120,21,6389831,44802,832525,6619,5557306,38183
2020-11-08,Georgia,13,390617,1360,8428,1,3733960,18690,373078,1253,3360882,17437
2020-11-08,Guam,66,6046,0,89,0,71996,489,5233,120,66763,369
2020-11-08,Hawaii,15,16066,127,220,1,311204,128,16051,128,295153,0
2020-11-08,Idaho,16,73212,684,691,6,415721,2834,72312,1403,343409,1431
2020-11-08,Illinois,17,488980,9919,10548,50,8404304,90757,487987,10009,7916317,80748
2020-11-08,Indiana,18,212895,4652,4629,37,1809940,15542,210374,4652,1599566,10890
2020-11-08,Iowa,19,155583,4944,1845,3,935839,7580,140541,3313,795298,4267
2020-11-08,Kansas,20,99805,134,1166,0,676320,0,97633,0,578687,0
2020-11-08,Kentucky,21,123195,1174,1641,1,2067987,1177,120838,1177,1947149,0
2020-11-08,Louisiana,22,192981,1266,6036,20,2892957,26481,192981,1266,2699976,25215
2020-11-08,Maine,23,7693,90,152,0,676314,90,7693,90,668621,0
2020-11-08,Maryland,24,154451,1253,4212,11,2026292,10978,153996,1081,1872296,9897
2020-11-08,Massachusetts,25,171399,1823,10166,20,2901920,20153,171399,1823,2730521,18330
2020-11-08,Michigan,26,229085,379,7944,1,5213961,0,229003,0,4984958,0
2020-11-08,Minnesota,27,180916,5908,2710,31,2004582,21139,180862,5908,1823720,15231
2020-11-08,Mississippi,28,126689,804,3443,10,963897,804,126689,804,837208,0
2020-11-08,Missouri,29,216654,3009,3238,3,1599615,21204,209197,4131,1390418,17073
2020-11-08,Montana,30,39679,731,456,11,526591,1415,39679,731,486912,684
2020-11-08,Nebraska,31,83969,1574,710,0,626287,4755,82395,1702,543892,3053
2020-11-08,Nevada,32,110308,982,1852,1,846248,4244,110022,1276,736226,2968
2020-11-08,New Hampshire,33,12488,247,489,0,362828,1122,12488,247,350340,875
2020-11-08,New Jersey,34,256395,2013,16429,4,4965643,2013,254595,2013,4711048,0
2020-11-08,New Mexico,35,54881,1210,1118,14,1262482,11758,54881,1210,1207601,10548
2020-11-08,New York,36,533784,3430,33314,27,15664814,145642,529036,3428,15135778,142214
2020-11-08,North Carolina,37,293431,1868,4630,1,4365061,40905,293339,2094,4071722,38811
2020-11-08,North Dakota,38,54310,1101,644,11,309498,1527,54305,1101,255193,426
2020-11-08,Northern Mariana Islands,69,98,0,2,0,16091,0,98,0,15993,0
2020-11-08,Ohio,39,250268,4541,5517,11,4868460,59552,250268,4541,4618192,55011
2020-11-08,Oklahoma,40,136258,0,1438,0,1707579,4507,136258,4507,1571321,0
2020-11-08,Oregon,41,50448,861,730,1,909301,6202,50448,861,858853,5341
2020-11-08,Pennsylvania,42,235162,2580,9093,4,2672529,18423,230894,2909,2441635,15514
2020-11-08,Puerto Rico,72,71715,183,872,10,344072,533,38100,533,305972,0
2020-11-08,Rhode Island,44,36380,0,1224,0,463584,3069,37743,568,425841,2501
2020-11-08,South Carolina,45,185688,946,4036,21,1959102,14174,185688,946,1773414,13228
2020-11-08,South Dakota,46,55404,1428,536,13,277035,2352,55404,1428,221631,924
2020-11-08,Tennessee,47,277073,3470,3561,5,3873139,36522,281851,3636,3591288,32886
2020-11-08,Texas,48,1016772,6935,19256,37,8734857,99867,956234,5685,7778623,94182
2020-11-08,Utah,49,132621,2383,659,1,1116732,8738,132621,2386,984111,6352
2020-11-08,Vermont,50,2392,45,59,0,193404,882,2436,54,190968,828
2020-11-08,Virgin Islands,78,1405,0,23,0,25417,299,1405,15,24012,284
2020-11-08,Virginia,51,192175,1302,3707,3,2803062,21023,192175,1302,2610887,19721
2020-11-08,Washington,53,122310,1090,2552,0,2592766,24509,116011,1770,2476755,22739
2020-11-08,West Virginia,54,28404,662,502,0,849461,11757,28404,662,821057,11095
2020-11-08,Wisconsin,55,281910,4342,2396,11,2198711,12888,281910,4407,1916801,8481
2020-11-08,Wyoming,56,17310,713,114,9,141079,713,17310,713,123769,0
2020-11-09,Alabama,01,204857,1170,3084,0,1437832,4328,204857,1170,1232975,3158
2020-11-09,Alaska,02,20185,473,79,0,767997,-12177,19196,464,748801,-12641
2020-11-09,Arizona,04,260646,1347,6164,0,1889905,10577,259699,435,1630206,10142
2020-11-09,Arkansas,05,122811,945,2108,23,1447466,8661,122811,945,1324655,7716
2020-11-09,California,06,985598,6754,18035,60,19918479,193851,971851,7212,18946628,186639
2020-11-09,Colorado,08,135747,3877,2438,17,1359195,17239,134537,3553,1224658,13686
2020-11-09,Connecticut,09,81463,3338,4698,27,2579578,89974,81463,3338,2498115,86636
2020-11-09,Delaware,10,26908,305,719,1,367580,2301,26908,305,340672,1996
2020-11-09,District of Columbia,11,18087,86,655,1,558814,3365,18087,86,540727,3279
2020-11-09,Florida,12,847813,3924,17178,58,6410130,20299,836370,3845,5573760,16454
2020-11-09,Georgia,13,392246,1629,8457,29,3749894,15934,374181,1103,3375713,14831
2020-11-09,Guam,66,6442,396,91,2,72954,958,5473,240,67481,718
2020-11-09,Hawaii,15,16124,58,220,0,311332,128,16179,128,295153,0
2020-11-09,Idaho,16,74713,1501,704,13,418504,2783,72961,649,345543,2134
2020-11-09,Illinois,17,500015,11035,10577,29,8469064,64760,498560,10573,7970504,54187
2020-11-09,Indiana,18,217028,4133,4664,35,1823029,13089,214509,4135,1608520,8954
2020-11-09,Iowa,19,159910,4327,1872,27,945621,9782,144922,4381,800699,5401
2020-11-09,Kansas,20,105298,5493,1181,15,689982,13662,103553,5920,586429,7742
2020-11-09,Kentucky,21,125332,2137,1655,14,2106069,38082,122567,1729,1983502,36353
2020-11-09,Louisiana,22,193372,391,6048,12,2898463,5506,193372,391,2705091,5115
2020-11-09,Maine,23,7888,195,153,1,698403,22089,7888,195,690515,21894
2020-11-09,Maryland,24,155824,1373,4221,9,2037645,11353,155371,1375,1882274,9978
2020-11-09,Massachusetts,25,172727,1328,10180,14,2916246,14326,172727,1328,2743519,12998
2020-11-09,Michigan,26,238136,9051,8008,64,5368310,154349,238308,9305,5130002,145044
2020-11-09,Minnesota,27,184842,3926,2729,19,2018855,14273,184788,3926,1834067,10347
2020-11-09,Mississippi,28,127205,516,3443,0,1001068,37171,127205,516,873863,36655
2020-11-09,Missouri,29,221874,5220,3241,3,1607875,8260,212441,3244,1395434,5016
2020-11-09,Montana,30,40118,439,463,7,540913,14322,40053,374,500860,13948
2020-11-09,Nebraska,31,85551,1582,714,4,630137,3850,83969,1574,546168,2276
2020-11-09,Nevada,32,111323,1015,1853,1,850941,4693,110982,960,739959,3733
2020-11-09,New Hampshire,33,12699,211,489,0,363544,716,12699,211,350845,505
2020-11-09,New Jersey,34,258453,2058,16440,11,5037287,71644,256653,2058,4780634,69586
2020-11-09,New Mexico,35,56289,1408,1130,12,1269523,7041,56289,1408,1213234,5633
2020-11-09,New York,36,536933,3149,33343,29,15776230,111416,532180,3144,15244050,108272
2020-11-09,North Carolina,37,295105,1674,4638,8,4399616,34555,294860,1521,4104756,33034
2020-11-09,North Dakota,38,55463,1153,649,5,310998,1500,55458,1153,255540,347
2020-11-09,Northern Mariana Islands,69,100,2,2,0,16093,2,100,2,15993,0
2020-11-09,Ohio,39,254974,4706,5524,7,4918126,49666,254974,4706,4663152,44960
2020-11-09,Oklahoma,40,138455,2197,1444,6,1709776,2197,138455,2197,1571321,0
2020-11-09,Oregon,41,51155,707,738,8,914677,5376,51155,707,863522,4669
2020-11-09,Pennsylvania,42,239724,4562,9098,5,2690152,17623,234296,3402,2455856,14221
2020-11-09,Puerto Rico,72,72196,481,882,10,344553,481,38581,481,305972,0
2020-11-09,Rhode Island,44,38009,1629,1233,9,465031,1447,38009,266,427022,1181
2020-11-09,South Carolina,45,186391,703,4041,5,1967225,8123,186391,703,1780834,7420
2020-11-09,South Dakota,46,56311,907,537,1,278803,1768,56311,907,222492,861
2020-11-09,Tennessee,47,282746,5673,3577,16,3928231,55092,287770,5919,3640461,49173
2020-11-09,Texas,48,1026570,9798,19298,42,8849942,115085,963019,6785,7886923,108300
2020-11-09,Utah,49,134868,2247,661,2,1125403,8671,134868,2247,990535,6424
2020-11-09,Vermont,50,2415,23,59,0,193838,434,2461,25,191377,409
2020-11-09,Virgin Islands,78,1405,0,23,0,25417,0,1405,0,24012,0
2020-11-09,Virginia,51,193477,1302,3713,6,2819087,16025,193477,1302,2625610,14723
2020-11-09,Washington,53,124560,2250,2577,25,2612198,19432,117331,1320,2494867,18112
2020-11-09,West Virginia,54,28805,401,530,28,857085,7624,28805,401,828280,7223
2020-11-09,Wisconsin,55,286446,4536,2421,25,2212898,14187,286380,4470,1926518,9717
2020-11-09,Wyoming,56,18010,700,114,0,145158,4079,18010,700,127148,3379
2020-11-10,Alabama,01,206567,1710,3120,36,1437719,-113,206567,1710,1231152,-1823
2020-11-10,Alaska,02,20715,530,87,8,828140,60143,19734,538,808406,59605
2020-11-10,Arizona,04,263445,2799,6198,34,1905430,15525,263133,3434,1642297,12091
2020-11-10,Arkansas,05,124235,1424,2112,4,1456243,8777,124235,1424,1332008,7353
2020-11-10,California,06,994341,8743,18073,38,20094641,176162,977218,5367,19117423,170795
2020-11-10,Colorado,08,139246,3499,2469,31,1374786,15591,138427,3890,1236359,11701
2020-11-10,Connecticut,09,82987,1524,4707,9,2602262,22684,82987,1524,2519275,21160
2020-11-10,Delaware,10,27112,204,722,3,369131,1551,27112,204,342019,1347
2020-11-10,District of Columbia,11,18173,86,657,2,561833,3019,18173,86,543660,2933
2020-11-10,Florida,12,852166,4353,17247,69,6434241,24111,840652,4282,5593589,19829
2020-11-10,Georgia,13,396498,4252,8507,50,3772524,22630,376054,1873,3396470,20757
2020-11-10,Guam,66,6623,181,92,1,73859,905,5654,181,68205,724
2020-11-10,Hawaii,15,16193,69,221,1,311395,63,16242,63,295153,0
2020-11-10,Idaho,16,76010,1297,720,16,420811,2307,74227,1266,346584,1041
2020-11-10,Illinois,17,512688,12673,10658,81,8571019,101955,511183,12623,8059836,89332
2020-11-10,Indiana,18,221894,4866,4731,67,1837630,14601,219338,4829,1618292,9772
2020-11-10,Iowa,19,163827,3917,1898,26,950191,4570,147656,2734,802535,1836
2020-11-10,Kansas,20,105760,462,1181,0,689982,0,103553,0,586429,0
2020-11-10,Kentucky,21,127472,2140,1674,19,2126356,20287,124646,2079,2001710,18208
2020-11-10,Louisiana,22,194702,1330,6058,10,2924923,26460,194702,1330,2730221,25130
2020-11-10,Maine,23,8060,172,156,3,704431,6028,8060,172,696371,5856
2020-11-10,Maryland,24,157149,1325,4233,12,2047847,10202,156709,1338,1891138,8864
2020-11-10,Massachusetts,25,174881,2154,10201,21,2932097,15851,174881,2154,2757216,13697
2020-11-10,Michigan,26,245005,6869,8095,87,5427625,59315,245252,6944,5182373,52371
2020-11-10,Minnesota,27,189735,4893,2752,23,2033885,15030,189681,4893,1844204,10137
2020-11-10,Mississippi,28,128138,933,3480,37,1002001,933,128138,933,873863,0
2020-11-10,Missouri,29,226372,4498,3375,134,1599170,-8705,216697,4256,1382473,-12961
2020-11-10,Montana,30,41219,1101,468,5,544566,3653,41151,1098,503415,2555
2020-11-10,Nebraska,31,87733,2182,741,27,633716,3579,85551,1582,548165,1997
2020-11-10,Nevada,32,112602,1279,1863,10,854534,3593,112304,1322,742230,2271
2020-11-10,New Hampshire,33,12919,220,489,0,368085,4541,12919,220,355166,4321
2020-11-10,New Jersey,34,262230,3777,16461,21,5041064,3777,260430,3777,4780634,0
2020-11-10,New Mexico,35,57547,1258,1144,14,1281951,12428,57547,1258,1224404,11170
2020-11-10,New York,36,540897,3964,33373,30,15904266,128036,536145,3965,15368121,124071
2020-11-10,North Carolina,37,298089,2984,4685,47,4429912,30296,297442,2582,4132470,27714
2020-11-10,North Dakota,38,56357,894,679,30,311882,884,56342,884,255540,0
2020-11-10,Northern Mariana Islands,69,100,0,2,0,16567,474,100,0,16467,474
2020-11-10,Ohio,39,261482,6508,5547,23,4964229,46103,261482,6508,4702747,39595
2020-11-10,Oklahoma,40,140157,1702,1451,7,1733198,23422,140157,1702,1593041,21720
2020-11-10,Oregon,41,51909,754,741,3,921216,6539,51909,754,869307,5785
2020-11-10,Pennsylvania,42,244046,4322,9156,58,2709442,19290,238657,4361,2470785,14929
2020-11-10,Puerto Rico,72,72471,275,889,7,344828,275,38856,275,305972,0
2020-11-10,Rhode Island,44,38798,789,1237,4,467877,2846,38798,789,429079,2057
2020-11-10,South Carolina,45,187738,1347,4062,21,1988512,21287,187738,1347,1800774,19940
2020-11-10,South Dakota,46,57334,1023,540,3,280699,1896,57334,1023,223365,873
2020-11-10,Tennessee,47,284725,1979,3639,62,3943804,15573,289749,1979,3654055,13594
2020-11-10,Texas,48,1038214,11644,19423,125,8901839,51897,974230,11211,7927609,40686
2020-11-10,Utah,49,137523,2655,672,11,1135628,10225,137385,2517,998243,7708
2020-11-10,Vermont,50,2462,47,59,0,194531,693,2513,52,192018,641
2020-11-10,Virgin Islands,78,1413,8,23,0,25487,70,1410,5,24077,65
2020-11-10,Virginia,51,194912,1435,3726,13,2837139,18052,194912,1435,2642227,16617
2020-11-10,Washington,53,126091,1531,2594,17,2627515,15317,118570,1239,2508945,14078
2020-11-10,West Virginia,54,29316,511,546,16,864043,6958,29316,511,834727,6447
2020-11-10,Wisconsin,55,293862,7416,2497,76,2233256,20358,293812,7432,1939444,12926
2020-11-10,Wyoming,56,19242,1232,127,13,146390,1232,19242,1232,127148,0
2020-11-11,Alabama,01,208637,2070,3201,81,1453872,16153,208637,2070,1245235,14083
2020-11-11,Alaska,02,21211,496,90,3,834590,6450,20221,487,814369,5963
2020-11-11,Arizona,04,265195,1750,6228,30,1915235,9805,265163,2030,1650072,7775
2020-11-11,Arkansas,05,126197,1962,2126,14,1469248,13005,126197,1962,1343051,11043
2020-11-11,California,06,999498,5157,18109,36,20222093,127452,984682,7464,19237411,119988
2020-11-11,Colorado,08,143553,4307,2481,12,1395052,20266,142402,3975,1252650,16291
2020-11-11,Connecticut,09,84741,1754,4716,9,2639205,36943,84741,1754,2554464,35189
2020-11-11,Delaware,10,27342,230,724,2,370625,1494,27342,230,343283,1264
2020-11-11,District of Columbia,11,18379,206,657,0,567072,5239,18379,206,548693,5033
2020-11-11,Florida,12,858004,5838,17299,52,6466981,32740,846321,5669,5620660,27071
2020-11-11,Georgia,13,398769,2271,8582,75,3786046,13522,377694,1640,3408352,11882
2020-11-11,Guam,66,6724,101,92,0,74549,690,5755,101,68794,589
2020-11-11,Hawaii,15,16309,116,221,0,311473,78,16320,78,295153,0
2020-11-11,Idaho,16,77536,1526,738,18,424391,3580,75428,1201,348963,2379
2020-11-11,Illinois,17,525072,12384,10805,147,8664483,93464,523840,12657,8140643,80807
2020-11-11,Indiana,18,226935,5041,4762,31,1853700,16070,224374,5036,1629326,11034
2020-11-11,Iowa,19,168457,4630,1927,29,958353,8162,151953,4297,806400,3865
2020-11-11,Kansas,20,110977,5217,1215,34,703647,13665,109225,5672,594422,7993
2020-11-11,Kentucky,21,130308,2836,1689,15,2129054,2698,127344,2698,2001710,0
2020-11-11,Louisiana,22,194702,0,6058,0,2924923,0,194702,0,2730221,0
2020-11-11,Maine,23,8202,142,158,2,704573,142,8202,142,696371,0
2020-11-11,Maryland,24,158836,1687,4249,16,2060836,12989,158423,1714,1902413,11275
2020-11-11,Massachusetts,25,177541,2660,10222,21,2952714,20617,177541,2660,2775173,17957
2020-11-11,Michigan,26,251499,6494,8137,42,5482476,54851,251872,6620,5230604,48231
2020-11-11,Minnesota,27,194626,4891,2810,58,2045316,11431,194570,4889,1850746,6542
2020-11-11,Mississippi,28,129394,1256,3497,17,1003257,1256,129394,1256,873863,0
2020-11-11,Missouri,29,230003,3631,3411,36,1627919,28749,220768,4071,1407151,24678
2020-11-11,Montana,30,42132,913,475,7,547728,3162,42070,919,505658,2243
2020-11-11,Nebraska,31,89942,2209,741,0,639462,5746,87733,2182,551729,3564
2020-11-11,Nevada,32,113856,1254,1877,14,859319,4785,113411,1107,745908,3678
2020-11-11,New Hampshire,33,13148,229,492,3,370830,2745,13148,229,357682,2516
2020-11-11,New Jersey,34,265295,3065,16476,15,5084793,43729,263495,3065,4821298,40664
2020-11-11,New Mexico,35,59034,1487,1158,14,1317248,35297,59034,1487,1258214,33810
2020-11-11,New York,36,545718,4821,33398,25,16068566,164300,540965,4820,15527601,159480
2020-11-11,North Carolina,37,300725,2636,4723,38,4460288,30376,300561,3119,4159727,27257
2020-11-11,North Dakota,38,57378,1021,691,12,313607,1725,57373,1031,256234,694
2020-11-11,Northern Mariana Islands,69,100,0,2,0,16567,0,100,0,16467,0
2020-11-11,Ohio,39,267356,5874,5623,76,5009783,45554,267356,5874,4742427,39680
2020-11-11,Oklahoma,40,142334,2177,1470,19,1748137,14939,142334,2177,1605803,12762
2020-11-11,Oregon,41,52770,861,746,5,928343,7127,52770,861,875573,6266
2020-11-11,Pennsylvania,42,248144,4098,9217,61,2732129,22687,243368,4711,2488761,17976
2020-11-11,Puerto Rico,72,72735,264,901,12,345092,264,39120,264,305972,0
2020-11-11,Rhode Island,44,39776,978,1243,6,471284,3407,39776,978,431508,2429
2020-11-11,South Carolina,45,188995,1257,4076,14,2000709,12197,188995,1257,1811714,10940
2020-11-11,South Dakota,46,58696,1362,567,27,283120,2421,58696,1362,224424,1059
2020-11-11,Tennessee,47,288311,3586,3727,88,3974023,30219,293381,3632,3680642,26587
2020-11-11,Texas,48,1051071,12857,19544,121,9007171,105332,985380,11150,8021791,94182
2020-11-11,Utah,49,139815,2292,678,6,1144013,8385,139720,2335,1004293,6050
2020-11-11,Vermont,50,2535,73,59,0,195392,861,2602,89,192790,772
2020-11-11,Virgin Islands,78,1413,0,23,0,25487,0,1410,0,24077,0
2020-11-11,Virginia,51,196506,1594,3741,15,2858627,21488,196506,1594,2662121,19894
2020-11-11,Washington,53,126886,795,2595,1,2644425,16910,120011,1441,2524414,15469
2020-11-11,West Virginia,54,30201,885,553,7,875117,11074,30201,885,844916,10189
2020-11-11,Wisconsin,55,301349,7487,2562,65,2251217,17961,301349,7537,1949868,10424
2020-11-11,Wyoming,56,19374,132,127,0,146613,223,19374,132,127239,91
2020-11-12,Alabama,01,210637,2000,3213,12,1455872,2000,210637,2000,1245235,0
2020-11-12,Alaska,02,21689,478,90,0,844666,10076,20702,481,823964,9595
2020-11-12,Arizona,04,266644,1449,6240,12,1930540,15305,266562,1399,1663978,13906
2020-11-12,Arkansas,05,128006,1809,2144,18,1482925,13677,128006,1809,1354919,11868
2020-11-12,California,06,1009187,9689,18141,32,20342072,119979,991609,6927,19350463,113052
2020-11-12,Colorado,08,149262,5709,2512,31,1400249,5197,147599,5197,1252650,0
2020-11-12,Connecticut,09,85899,1158,4726,10,2663481,24276,85899,1158,2577582,23118
2020-11-12,Delaware,10,27546,204,732,8,372234,1609,27546,204,344688,1405
2020-11-12,District of Columbia,11,18507,128,657,0,571530,4458,18507,128,553023,4330
2020-11-12,Florida,12,863611,5607,17371,72,6493713,26732,851825,5504,5641888,21228
2020-11-12,Georgia,13,401750,2981,8655,73,3807413,21367,380190,2496,3427223,18871
2020-11-12,Guam,66,6819,95,92,0,75449,900,5850,95,69599,805
2020-11-12,Hawaii,15,16403,94,221,0,311590,117,16437,117,295153,0
2020-11-12,Idaho,16,78877,1341,753,15,428367,3976,77121,1693,351246,2283
2020-11-12,Illinois,17,537860,12788,10855,50,8765100,100617,536542,12702,8228558,87915
2020-11-12,Indiana,18,233540,6605,4813,51,1876317,22617,230965,6591,1645352,16026
2020-11-12,Iowa,19,173401,4944,1947,20,964756,6403,155603,3650,809153,2753
2020-11-12,Kansas,20,111503,526,1215,0,700505,-3142,109225,0,591280,-3142
2020-11-12,Kentucky,21,132686,2378,1702,13,2167395,38341,129680,2336,2037715,36005
2020-11-12,Louisiana,22,198531,3829,6097,39,2958488,33565,198531,3829,2759957,29736
2020-11-12,Maine,23,8395,193,159,1,725560,20987,8395,193,717165,20794
2020-11-12,Maryland,24,160311,1475,4261,12,2071985,11149,159900,1477,1912085,9672
2020-11-12,Massachusetts,25,180189,2648,10242,20,2974611,21897,180189,2648,2794422,19249
2020-11-12,Michigan,26,258973,7474,8187,50,5549792,67316,259183,7311,5290609,60005
2020-11-12,Minnesota,27,201851,7225,2849,39,2070714,25398,201795,7225,1868919,18173
2020-11-12,Mississippi,28,130665,1271,3514,17,1004528,1271,130665,1271,873863,0
2020-11-12,Missouri,29,235341,5338,3441,30,1639564,11645,225371,4603,1414193,7042
2020-11-12,Montana,30,43084,952,478,3,557951,10223,43031,961,514920,9262
2020-11-12,Nebraska,31,92553,2611,768,27,644851,5389,89942,2209,554909,3180
2020-11-12,Nevada,32,115360,1504,1880,3,865363,6044,114880,1469,750483,4575
2020-11-12,New Hampshire,33,13470,322,495,3,375048,4218,13470,322,361578,3896
2020-11-12,New Jersey,34,268787,3492,16495,19,5124598,39805,266986,3491,4857612,36314
2020-11-12,New Mexico,35,60776,1742,1176,18,1330403,13155,60776,1742,1269627,11413
2020-11-12,New York,36,550516,4798,33424,26,16231193,162627,545762,4797,15685431,157830
2020-11-12,North Carolina,37,303931,3206,4730,7,4500774,40486,303454,2893,4197320,37593
2020-11-12,North Dakota,38,59179,1801,703,12,316394,2787,59173,1800,257221,987
2020-11-12,Northern Mariana Islands,69,100,0,2,0,16567,0,100,0,16467,0
2020-11-12,Ohio,39,274457,7101,5658,35,5066497,56714,274457,7101,4792040,49613
2020-11-12,Oklahoma,40,144691,2357,1481,11,1750494,2357,144691,2357,1605803,0
2020-11-12,Oregon,41,53879,1109,748,2,935877,7534,53879,1109,881998,6425
2020-11-12,Pennsylvania,42,254167,6023,9272,55,2755505,23376,248856,5488,2506649,17888
2020-11-12,Puerto Rico,72,74067,1332,909,8,346424,1332,40452,1332,305972,0
2020-11-12,Rhode Island,44,40764,988,1250,7,474414,3130,40764,988,433650,2142
2020-11-12,South Carolina,45,190490,1495,4084,8,2020945,20236,190490,1495,1830455,18741
2020-11-12,South Dakota,46,60716,2020,567,0,286088,2968,60716,2020,225372,948
2020-11-12,Tennessee,47,291482,3171,3751,24,3995978,21955,296725,3344,3699253,18611
2020-11-12,Texas,48,1060798,9727,19705,161,9033217,26046,993841,8461,8039376,17585
2020-11-12,Utah,49,143639,3824,689,11,1155716,11703,143639,3919,1012077,7784
2020-11-12,Vermont,50,2651,116,59,0,196748,1356,2727,125,194021,1231
2020-11-12,Virgin Islands,78,1413,0,23,0,25487,0,1410,0,24077,0
2020-11-12,Virginia,51,198027,1521,3758,17,2871201,12574,198027,1521,2673174,11053
2020-11-12,Washington,53,129672,2786,2619,24,2644425,0,120011,0,2524414,0
2020-11-12,West Virginia,54,30897,696,555,2,888299,13182,30897,696,857402,12486
2020-11-12,Wisconsin,55,309605,8256,2626,64,2274371,23154,309572,8223,1964799,14931
2020-11-12,Wyoming,56,20479,1105,127,0,149287,2674,20479,1105,128808,1569
2020-11-13,Alabama,01,213617,2980,3231,18,1474217,18345,213617,2980,1260600,15365
2020-11-13,Alaska,02,22282,593,91,1,844666,0,21286,584,823380,-584
2020-11-13,Arizona,04,270596,3952,6257,17,1949839,19299,269577,3015,1680262,16284
2020-11-13,Arkansas,05,130318,2312,2148,4,1497395,14470,130318,2312,1367077,12158
2020-11-13,California,06,1019052,9865,18218,77,20478500,136428,998502,6893,19479998,129535
2020-11-13,Colorado,08,155761,6499,2541,29,1423901,23652,154038,6439,1269863,17213
2020-11-13,Connecticut,09,88645,2746,4737,11,2706667,43186,88645,2746,2618022,40440
2020-11-13,Delaware,10,28016,470,734,2,375223,2989,28016,470,347207,2519
2020-11-13,District of Columbia,11,18666,159,657,0,577601,6071,18666,159,558935,5912
2020-11-13,Florida,12,870544,6933,17444,73,6522985,29272,858585,6760,5664400,22512
2020-11-13,Georgia,13,404577,2827,8678,23,3838550,31137,382505,2315,3456045,28822
2020-11-13,Guam,66,6893,74,93,1,76292,843,5924,74,70368,769
2020-11-13,Hawaii,15,16514,111,221,0,311687,97,16534,97,295153,0
2020-11-13,Idaho,16,80440,1563,756,3,431982,3615,78279,1158,353703,2457
2020-11-13,Illinois,17,553083,15223,10907,52,8871640,106540,551957,15415,8319683,91125
2020-11-13,Indiana,18,239139,5599,4863,50,1893070,16753,236565,5600,1656505,11153
2020-11-13,Iowa,19,178890,5489,1972,25,971644,6888,159635,4032,812009,2856
2020-11-13,Kansas,20,117282,5779,1256,41,706787,6282,115507,6282,591280,0
2020-11-13,Kentucky,21,135855,3169,1729,27,2196131,28736,132844,3164,2063287,25572
2020-11-13,Louisiana,22,201981,3450,6121,24,2992468,33980,201981,3450,2790487,30530
2020-11-13,Maine,23,8639,244,162,3,734410,8850,8639,244,725771,8606
2020-11-13,Maryland,24,162181,1870,4273,12,2084302,12317,161769,1869,1922533,10448
2020-11-13,Massachusetts,25,183095,2906,10265,23,2996729,22118,183095,2906,2813634,19212
2020-11-13,Michigan,26,268072,9099,8312,125,5623152,73360,268362,9179,5354790,64181
2020-11-13,Minnesota,27,207395,5544,2895,46,2095513,24799,207339,5544,1888174,19255
2020-11-13,Mississippi,28,131970,1305,3519,5,1005833,1305,131970,1305,873863,0
2020-11-13,Missouri,29,241236,5895,3452,11,1647747,8183,229376,4005,1418371,4178
2020-11-13,Montana,30,44297,1213,483,5,566544,8593,44244,1213,522300,7380
2020-11-13,Nebraska,31,94922,2369,789,21,650659,5808,92553,2611,558106,3197
2020-11-13,Nevada,32,117322,1962,1896,16,871005,5642,116737,1857,754268,3785
2020-11-13,New Hampshire,33,13929,459,498,3,378305,3257,13929,459,364376,2798
2020-11-13,New Jersey,34,272184,3397,16522,27,5169231,44633,270383,3397,4898848,41236
2020-11-13,New Mexico,35,62006,1230,1198,22,1348194,17791,62006,1230,1286188,16561
2020-11-13,New York,36,555917,5401,33452,28,16434914,203721,551163,5401,15883751,198320
2020-11-13,North Carolina,37,306498,2567,4749,19,4536767,35993,305233,1779,4231534,34214
2020-11-13,North Dakota,38,60608,1429,713,10,318738,2344,60602,1429,258136,915
2020-11-13,Northern Mariana Islands,69,100,0,2,0,16567,0,100,0,16467,0
2020-11-13,Ohio,39,282528,8071,5700,42,5132781,66284,282528,8071,4850253,58213
2020-11-13,Oklahoma,40,147358,2667,1493,12,1791023,40529,147358,2667,1643665,37862
2020-11-13,Oregon,41,54937,1058,759,11,943147,7270,54937,1058,888210,6212
2020-11-13,Pennsylvania,42,260001,5834,9306,34,2778371,22866,254387,5531,2523984,17335
2020-11-13,Puerto Rico,72,74734,667,914,5,347091,667,41119,667,305972,0
2020-11-13,Rhode Island,44,41529,765,1254,4,476930,2516,41529,765,435401,1751
2020-11-13,South Carolina,45,192101,1611,4101,17,2030994,10049,192101,1611,1838893,8438
2020-11-13,South Dakota,46,62327,1611,568,1,288661,2573,62327,1611,226334,962
2020-11-13,Tennessee,47,295135,3653,3814,63,4019449,23471,300458,3733,3718991,19738
2020-11-13,Texas,48,1073382,12584,19917,212,9153369,120152,1004983,11142,8148386,109010
2020-11-13,Utah,49,146155,2516,703,14,1164731,9015,145789,2150,1018942,6865
2020-11-13,Vermont,50,2743,92,59,0,197774,1026,2829,102,194945,924
2020-11-13,Virgin Islands,78,1426,13,23,0,25487,0,1410,0,24077,0
2020-11-13,Virginia,51,199262,1235,3785,27,2881795,10594,199262,1235,2682533,9359
2020-11-13,Washington,53,132183,2511,2634,15,2694170,49745,123356,3345,2570814,46400
2020-11-13,West Virginia,54,31639,742,565,10,902293,13994,31639,742,870654,13252
2020-11-13,Wisconsin,55,318023,8418,2694,68,2293535,19164,318023,8451,1975512,10713
2020-11-13,Wyoming,56,21341,862,127,0,151549,2262,21341,862,130208,1400
2020-11-14,Alabama,01,215843,2226,3246,15,1487103,12886,215843,2226,1271260,10660
2020-11-14,Alaska,02,23029,747,92,1,862264,17598,22020,734,840244,16864
2020-11-14,Arizona,04,273400,2804,6300,43,1968659,18820,273053,3476,1695606,15344
2020-11-14,Arkansas,05,132166,1848,2159,11,1497395,0,130318,0,1367077,0
2020-11-14,California,06,1027016,7964,18254,36,20671596,193096,1008377,9875,19663219,183221
2020-11-14,Colorado,08,160459,4698,2554,13,1444324,20423,159234,5196,1285090,15227
2020-11-14,Connecticut,09,88645,0,4737,0,2706667,0,88645,0,2618022,0
2020-11-14,Delaware,10,28395,379,736,2,377364,2141,28395,379,348969,1762
2020-11-14,District of Columbia,11,18814,148,658,1,583319,5718,18814,148,564505,5570
2020-11-14,Florida,12,875088,4544,17488,44,6554952,31967,862990,4405,5691962,27562
2020-11-14,Georgia,13,407596,3019,8729,51,3865939,27389,384997,2492,3480942,24897
2020-11-14,Guam,66,6893,0,93,0,76757,465,5965,41,70792,424
2020-11-14,Hawaii,15,16619,105,221,0,311805,118,16652,118,295153,0
2020-11-14,Idaho,16,81625,1185,763,7,435863,3881,79798,1519,356065,2362
2020-11-14,Illinois,17,564086,11003,11098,191,8986010,114370,562985,11028,8423025,103342
2020-11-14,Indiana,18,247466,8327,4888,25,1917951,24881,244887,8322,1673064,16559
2020-11-14,Iowa,19,183557,4667,1985,13,979886,8242,163728,4093,816158,4149
2020-11-14,Kansas,20,117728,446,1256,0,706787,0,115507,0,591280,0
2020-11-14,Kentucky,21,138854,2999,1739,10,2217321,21190,136137,3293,2081184,17897
2020-11-14,Louisiana,22,201981,0,6121,0,2992468,0,201981,0,2790487,0
2020-11-14,Maine,23,8791,152,163,1,734562,152,8791,152,725771,0
2020-11-14,Maryland,24,164239,2058,4293,20,2098169,13867,164090,2321,1934079,11546
2020-11-14,Massachusetts,25,186142,3047,10293,28,3024727,27998,186142,3047,2838585,24951
2020-11-14,Michigan,26,275393,7321,8375,63,5692584,69432,275792,7430,5416792,62002
2020-11-14,Minnesota,27,216084,8689,2930,35,2119079,23566,216028,8689,1903051,14877
2020-11-14,Mississippi,28,133340,1370,3540,21,1007203,1370,133340,1370,873863,0
2020-11-14,Missouri,29,248400,7164,3463,11,1661030,13283,235722,6346,1425308,6937
2020-11-14,Montana,30,45919,1622,519,36,569694,3150,45886,1642,523808,1508
2020-11-14,Nebraska,31,96834,1912,790,1,655959,5300,94922,2369,561037,2931
2020-11-14,Nevada,32,119228,1906,1908,12,877838,6833,119006,2269,758832,4564
2020-11-14,New Hampshire,33,14311,382,499,1,381412,3107,14311,382,367101,2725
2020-11-14,New Jersey,34,276537,4353,16548,26,5210727,41496,274736,4353,4935991,37143
2020-11-14,New Mexico,35,63171,1165,1208,10,1360452,12258,63171,1165,1297281,11093
2020-11-14,New York,36,561308,5391,33477,25,16619076,184162,556551,5388,16062525,178774
2020-11-14,North Carolina,37,309703,3205,4783,34,4591525,54758,309118,3885,4282407,50873
2020-11-14,North Dakota,38,62878,2270,732,19,322228,3490,62872,2270,259356,1220
2020-11-14,Northern Mariana Islands,69,100,0,2,0,16567,0,100,0,16467,0
2020-11-14,Ohio,39,290243,7715,5714,14,5195015,62234,290243,7715,4904772,54519
2020-11-14,Oklahoma,40,150205,2847,1516,23,1803804,12781,150205,2847,1653599,9934
2020-11-14,Oregon,41,56018,1081,760,1,951565,8418,56018,1081,895547,7337
2020-11-14,Pennsylvania,42,264396,4395,9353,47,2798085,19714,259938,5551,2538147,14163
2020-11-14,Puerto Rico,72,75387,653,921,7,347744,653,41772,653,305972,0
2020-11-14,Rhode Island,44,41529,0,1254,0,480477,3547,42763,1234,437714,2313
2020-11-14,South Carolina,45,194014,1913,4110,9,2072140,41146,194014,1913,1878126,39233
2020-11-14,South Dakota,46,64182,1855,621,53,291823,3162,64182,1855,227641,1307
2020-11-14,Tennessee,47,299597,4462,3839,25,4054301,34852,305120,4662,3749181,30190
2020-11-14,Texas,48,1083132,9750,20035,118,9235382,82013,1014160,9177,8221222,72836
2020-11-14,Utah,49,151141,4986,712,9,1180724,15993,151141,5352,1029583,10641
2020-11-14,Vermont,50,2843,100,59,0,198824,1050,2927,98,195897,952
2020-11-14,Virgin Islands,78,1434,8,23,0,26069,582,1434,24,24635,558
2020-11-14,Virginia,51,200799,1537,3799,14,2905317,23522,200799,1537,2704518,21985
2020-11-14,Washington,53,133612,1429,2638,4,2722087,27917,125498,2142,2596589,25775
2020-11-14,West Virginia,54,32792,1153,574,9,915656,13363,32792,1153,882864,12210
2020-11-14,Wisconsin,55,323604,5581,2748,54,2312924,19389,323604,5581,1989320,13808
2020-11-14,Wyoming,56,21881,540,144,17,152089,540,21881,540,130208,0
2020-11-15,Alabama,01,217822,1979,3248,2,1493737,6634,217822,1979,1275915,4655
2020-11-15,Alaska,02,23688,659,92,0,867382,5118,22662,642,844720,4476
2020-11-15,Arizona,04,275523,2123,6302,2,1981831,13172,275436,2383,1706395,10789
2020-11-15,Arkansas,05,133040,874,2183,24,1519751,22356,133040,2722,1386711,19634
2020-11-15,California,06,1035981,8965,18265,11,20866785,195189,1019345,10968,19847440,184221
2020-11-15,Colorado,08,164408,3949,2574,20,1462983,18659,163417,4183,1299566,14476
2020-11-15,Connecticut,09,88645,0,4737,0,2706667,0,88645,0,2618022,0
2020-11-15,Delaware,10,28803,408,736,0,379815,2451,28803,408,351012,2043
2020-11-15,District of Columbia,11,18977,163,660,2,588620,5301,18977,163,569643,5138
2020-11-15,Florida,12,885193,10105,17517,29,6599305,44353,872810,9820,5726495,34533
2020-11-15,Georgia,13,409504,1908,8730,1,3887286,21347,386949,1952,3500337,19395
2020-11-15,Guam,66,6893,0,93,0,77376,619,6121,156,71255,463
2020-11-15,Hawaii,15,16619,0,221,0,311912,107,16759,107,295153,0
2020-11-15,Idaho,16,82545,920,763,0,439714,3851,81317,1519,358397,2332
2020-11-15,Illinois,17,574722,10636,11170,72,9070841,84831,573616,10631,8497225,74200
2020-11-15,Indiana,18,254172,6706,4910,22,1938289,20338,251597,6710,1686692,13628
2020-11-15,Iowa,19,186314,2757,1989,4,988601,8715,167282,3554,821319,5161
2020-11-15,Kansas,20,117851,123,1256,0,706787,0,115507,0,591280,0
2020-11-15,Kentucky,21,140267,1413,1742,3,2218770,1449,137586,1449,2081184,0
2020-11-15,Louisiana,22,204513,2532,6132,11,3029596,37128,204513,2532,2825083,34596
2020-11-15,Maine,23,8944,153,165,2,734715,153,8944,153,725771,0
2020-11-15,Maryland,24,166317,2078,4302,9,2110466,12297,165930,1840,1944536,10457
2020-11-15,Massachusetts,25,188275,2133,10329,36,3042924,18197,188275,2133,2854649,16064
2020-11-15,Michigan,26,275892,499,8378,3,5692584,0,275792,0,5416792,0
2020-11-15,Minnesota,27,223637,7553,2961,31,2151282,32203,223581,7553,1927701,24650
2020-11-15,Mississippi,28,134309,969,3543,3,1008172,969,134309,969,873863,0
2020-11-15,Missouri,29,249608,1208,3463,0,1669473,8443,239451,3729,1430022,4714
2020-11-15,Montana,30,47158,1239,525,6,572561,2867,47158,1272,525403,1595
2020-11-15,Nebraska,31,98161,1327,791,1,661243,5284,96834,1912,564409,3372
2020-11-15,Nevada,32,120744,1516,1913,5,882523,4685,120183,1177,762340,3508
2020-11-15,New Hampshire,33,14671,360,499,0,384752,3340,14671,360,370081,2980
2020-11-15,New Jersey,34,281075,4538,16566,18,5339070,128343,279274,4538,5059796,123805
2020-11-15,New Mexico,35,64201,1030,1215,7,1372867,12415,64201,1030,1308666,11385
2020-11-15,New York,36,564952,3644,33508,31,16752278,133202,560200,3649,16192078,129553
2020-11-15,North Carolina,37,312406,2703,4830,47,4632609,41084,312235,3117,4320374,37967
2020-11-15,North Dakota,38,63802,924,742,10,323660,1432,63796,924,259864,508
2020-11-15,Northern Mariana Islands,69,100,0,2,0,16567,0,100,0,16467,0
2020-11-15,Ohio,39,298096,7853,5722,8,5262026,67011,298096,7853,4963930,59158
2020-11-15,Oklahoma,40,154128,3923,1528,12,1807727,3923,154128,3923,1653599,0
2020-11-15,Oregon,41,56880,862,762,2,957979,6414,56880,862,901099,5552
2020-11-15,Pennsylvania,42,269043,4647,9385,32,2824633,26548,265137,5199,2559496,21349
2020-11-15,Puerto Rico,72,76094,707,935,14,348451,707,42479,707,305972,0
2020-11-15,Rhode Island,44,41529,0,1254,0,483583,3106,43442,679,440141,2427
2020-11-15,South Carolina,45,195507,1493,4112,2,2090589,18449,195507,1493,1895082,16956
2020-11-15,South Dakota,46,65381,1199,644,23,294114,2291,65381,1199,228733,1092
2020-11-15,Tennessee,47,305211,5614,3856,17,4100329,46028,310937,5817,3789392,40211
2020-11-15,Texas,48,1090500,7368,20110,75,9371443,136061,1020721,6561,8350722,129500
2020-11-15,Utah,49,153808,2667,718,6,1189268,8544,153808,2667,1035460,5877
2020-11-15,Vermont,50,2889,46,59,0,199534,710,2971,44,196563,666
2020-11-15,Virgin Islands,78,1434,0,23,0,26069,0,1434,0,24635,0
2020-11-15,Virginia,51,201960,1161,3800,1,2939243,33926,201960,1161,2737283,32765
2020-11-15,Washington,53,135365,1753,2638,0,2748782,26695,127731,2233,2621051,24462
2020-11-15,West Virginia,54,33659,867,582,8,926879,11223,33659,867,893220,10356
2020-11-15,Wisconsin,55,329924,6320,2759,11,2331163,18239,329924,6320,2001239,11919
2020-11-15,Wyoming,56,22494,613,144,0,152702,613,22494,613,130208,0
2020-11-16,Alabama,01,219232,1410,3249,1,1501190,7453,219232,1410,1281958,6043
2020-11-16,Alaska,02,24268,580,92,0,872347,4965,23240,578,849107,4387
2020-11-16,Arizona,04,277179,1656,6302,0,1995236,13405,276912,1476,1718324,11929
2020-11-16,Arkansas,05,134348,1308,2225,42,1531206,11455,134348,1308,1396858,10147
2020-11-16,California,06,1047360,11379,18304,39,21068894,202109,1029235,9890,20039659,192219
2020-11-16,Colorado,08,168890,4482,2605,31,1481306,18323,167713,4296,1313593,14027
2020-11-16,Connecticut,09,93284,4639,4759,22,2793152,86485,93284,4639,2699868,81846
2020-11-16,Delaware,10,29200,397,736,0,382909,3094,29200,397,353709,2697
2020-11-16,District of Columbia,11,19064,87,660,0,590352,1732,19064,87,571288,1645
2020-11-16,Florida,12,889856,4663,17558,41,6625477,26172,877340,4530,5748137,21642
2020-11-16,Georgia,13,410581,1077,8740,10,3900708,13422,387930,981,3512778,12441
2020-11-16,Guam,66,7144,251,99,6,78133,757,6175,54,71958,703
2020-11-16,Hawaii,15,16711,92,221,0,312006,94,16853,94,295153,0
2020-11-16,Idaho,16,83906,1361,773,10,442233,2519,82245,928,359988,1591
2020-11-16,Illinois,17,586569,11847,11217,47,9161453,90612,585248,11632,8576205,78980
2020-11-16,Indiana,18,259318,5146,4936,26,1952202,13913,256744,5147,1695458,8766
2020-11-16,Iowa,19,189597,3283,2023,34,992851,4250,169353,2071,823498,2179
2020-11-16,Kansas,20,124697,6846,1266,10,733756,26969,122741,7234,611015,19735
2020-11-16,Kentucky,21,142277,2010,1750,8,2265659,46889,139097,1511,2126562,45378
2020-11-16,Louisiana,22,205059,546,6139,7,3037236,7640,205059,546,2832177,7094
2020-11-16,Maine,23,9117,173,165,0,756172,21457,9117,173,747055,21284
2020-11-16,Maryland,24,168041,1724,4309,7,2123275,12809,167656,1726,1955619,11083
2020-11-16,Massachusetts,25,190439,2164,10340,11,3060081,17157,190439,2164,2869642,14993
2020-11-16,Michigan,26,288543,12651,8437,59,5808470,115886,288954,13162,5519516,102724
2020-11-16,Minnesota,27,231074,7437,2973,12,2176285,25003,231018,7437,1945267,17566
2020-11-16,Mississippi,28,134898,589,3545,2,1041889,33717,134898,589,906991,33128
2020-11-16,Missouri,29,255942,6334,3485,22,1678572,9099,243169,3718,1435403,5381
2020-11-16,Montana,30,48101,943,528,3,573334,773,48027,869,525307,-96
2020-11-16,Nebraska,31,101601,3440,805,14,664980,3737,98161,1327,566819,2410
2020-11-16,Nevada,32,122441,1697,1919,6,887159,4636,122097,1914,765062,2722
2020-11-16,New Hampshire,33,15029,358,500,1,387608,2856,15029,358,372579,2498
2020-11-16,New Jersey,34,283294,2219,16580,14,5341289,2219,281493,2219,5059796,0
2020-11-16,New Mexico,35,65454,1253,1236,21,1386121,13254,65454,1253,1320667,12001
2020-11-16,New York,36,568450,3498,33540,32,16876843,124565,563690,3490,16313153,121075
2020-11-16,North Carolina,37,315314,2908,4843,13,4659829,27220,314207,1972,4345622,25248
2020-11-16,North Dakota,38,64891,1089,749,7,325491,1831,64885,1089,260606,742
2020-11-16,Northern Mariana Islands,69,102,2,2,0,16569,2,102,2,16467,0
2020-11-16,Ohio,39,305364,7268,5742,20,5318839,56813,305364,7268,5013475,49545
2020-11-16,Oklahoma,40,156857,2729,1538,10,1810456,2729,156857,2729,1653599,0
2020-11-16,Oregon,41,57646,766,772,10,962982,5003,57646,766,905336,4237
2020-11-16,Pennsylvania,42,275257,6214,9399,14,2843234,18601,269613,4476,2573621,14125
2020-11-16,Puerto Rico,72,76631,537,942,7,348988,537,43016,537,305972,0
2020-11-16,Rhode Island,44,43923,2394,1270,16,485400,1817,43923,481,441477,1336
2020-11-16,South Carolina,45,196617,1110,4143,31,2105533,14944,196617,1110,1908916,13834
2020-11-16,South Dakota,46,66278,897,644,0,296147,2033,66278,897,229869,1136
2020-11-16,Tennessee,47,312710,7499,3884,28,4161846,61517,318888,7951,3842958,53566
2020-11-16,Texas,48,1101781,11281,20157,47,9378611,7168,1027889,7168,8350722,0
2020-11-16,Utah,49,155779,1971,725,7,1198557,9289,155779,1971,1042778,7318
2020-11-16,Vermont,50,3008,119,59,0,200472,938,3095,124,197377,814
2020-11-16,Virgin Islands,78,1434,0,23,0,26069,0,1434,0,24635,0
2020-11-16,Virginia,51,204637,2677,3806,6,2957245,18002,204637,2677,2752608,15325
2020-11-16,Washington,53,138602,3237,2661,23,2778095,29313,130040,2309,2648055,27004
2020-11-16,West Virginia,54,34460,801,585,3,938911,12032,34460,801,904451,11231
2020-11-16,Wisconsin,55,334640,4716,2775,16,2343710,12547,334562,4638,2009148,7909
2020-11-16,Wyoming,56,23193,699,144,0,153401,699,23193,699,130208,0
2020-11-17,Alabama,01,220848,1616,3301,52,1508520,7330,220848,1616,1287672,5714
2020-11-17,Alaska,02,24909,641,94,2,878622,6275,23874,634,854748,5641
2020-11-17,Arizona,04,281284,4105,6320,18,2011792,16556,279896,2984,1731896,13572
2020-11-17,Arkansas,05,135902,1554,2245,20,1540028,8822,135902,1554,1404126,7268
2020-11-17,California,06,1058096,10736,18360,56,21259076,190182,1037978,8743,20221098,181439
2020-11-17,Colorado,08,173220,4330,2626,21,1500349,19043,172044,4331,1328305,14712
2020-11-17,Connecticut,09,94986,1702,4771,12,2826458,33306,94986,1702,2731472,31604
2020-11-17,Delaware,10,29552,352,739,3,385476,2567,29552,352,355924,2215
2020-11-17,District of Columbia,11,19309,245,660,0,596742,6390,19309,245,577433,6145
2020-11-17,Florida,12,897315,7459,17643,85,6663538,38061,884625,7285,5778913,30776
2020-11-17,Georgia,13,414821,4240,8778,38,3954422,53714,391466,3536,3562956,50178
2020-11-17,Guam,66,7203,59,101,2,78948,815,6234,59,72714,756
2020-11-17,Hawaii,15,16755,44,221,0,312058,52,16905,52,295153,0
2020-11-17,Idaho,16,85383,1477,803,30,445207,2974,83344,1099,361863,1875
2020-11-17,Illinois,17,599358,12789,11327,110,9255658,94205,597849,12601,8657809,81604
2020-11-17,Indiana,18,264810,5492,5025,89,1969088,16886,262207,5463,1706881,11423
2020-11-17,Iowa,19,193196,3599,2064,41,997034,4183,171545,2192,825489,1991
2020-11-17,Kansas,20,125668,971,1266,0,733756,0,122741,0,611015,0
2020-11-17,Kentucky,21,145220,2943,1787,37,2287167,21508,142008,2911,2145159,18597
2020-11-17,Louisiana,22,207685,2626,6156,17,3068330,31094,207685,2626,2860645,28468
2020-11-17,Maine,23,9363,246,166,1,764918,8746,9363,246,755555,8500
2020-11-17,Maryland,24,170193,2152,4335,26,2135601,12326,169805,2149,1965796,10177
2020-11-17,Massachusetts,25,192964,2525,10360,20,3078086,18005,192964,2525,2885122,15480
2020-11-17,Michigan,26,296436,7893,8513,76,5865787,57317,296840,7886,5568947,49431
2020-11-17,Minnesota,27,237005,5931,2999,26,2191193,14908,236949,5931,1954244,8977
2020-11-17,Mississippi,28,135803,905,3581,36,1042794,905,135803,905,906991,0
2020-11-17,Missouri,29,261105,5163,3552,67,1692549,13977,248886,5717,1443663,8260
2020-11-17,Montana,30,49496,1395,548,20,583828,10494,49398,1371,534430,9123
2020-11-17,Nebraska,31,103805,2204,827,22,674139,9159,101601,3440,572538,5719
2020-11-17,Nevada,32,124082,1641,1946,27,892492,5333,123794,1697,768698,3636
2020-11-17,New Hampshire,33,15303,274,502,2,388900,1292,15303,274,373597,1018
2020-11-17,New Jersey,34,287320,4026,16618,38,5374691,33402,285519,4026,5089172,29376
2020-11-17,New Mexico,35,67559,2105,1264,28,1398339,12218,67559,2105,1330780,10113
2020-11-17,New York,36,573544,5094,33576,36,17036695,159852,568778,5088,16467917,154764
2020-11-17,North Carolina,37,318537,3223,4881,38,4697561,37732,317495,3288,4380066,34444
2020-11-17,North Dakota,38,65973,1082,775,26,327340,1849,65967,1082,261373,767
2020-11-17,Northern Mariana Islands,69,103,1,2,0,16570,1,103,1,16467,0
2020-11-17,Ohio,39,312443,7079,5772,30,5364520,45681,312443,7079,5052077,38602
2020-11-17,Oklahoma,40,158408,1551,1544,6,1851019,40563,158408,1551,1692611,39012
2020-11-17,Oregon,41,58570,924,779,7,969822,6840,58570,924,911252,5916
2020-11-17,Pennsylvania,42,280978,5721,9433,34,2863980,20746,275513,5900,2588467,14846
2020-11-17,Puerto Rico,72,77200,569,951,9,349557,569,43585,569,305972,0
2020-11-17,Rhode Island,44,44528,605,1278,8,488250,2850,44528,605,443722,2245
2020-11-17,South Carolina,45,197900,1283,4156,13,2122323,16790,197900,1283,1924423,15507
2020-11-17,South Dakota,46,67284,1006,644,0,298359,2212,67284,1006,231075,1206
2020-11-17,Tennessee,47,314553,1843,3953,69,4176151,14305,320729,1841,3855422,12464
2020-11-17,Texas,48,1112681,10900,20278,121,9441069,62458,1039513,11624,8401556,50834
2020-11-17,Utah,49,159006,3227,734,9,1208117,9560,158957,3178,1049160,6382
2020-11-17,Vermont,50,3104,96,59,0,201487,1015,3201,106,198286,909
2020-11-17,Virgin Islands,78,1450,16,23,0,26433,364,1450,16,24983,348
2020-11-17,Virginia,51,206762,2125,3835,29,2982632,25387,206762,2125,2775870,23262
2020-11-17,Washington,53,140923,2321,2686,25,2795736,17641,131532,1492,2664204,16149
2020-11-17,West Virginia,54,35324,864,598,13,947444,8533,35324,864,912120,7669
2020-11-17,Wisconsin,55,342155,7515,2876,101,2366956,23246,342155,7593,2024801,15653
2020-11-17,Wyoming,56,24453,1260,155,11,152140,-1261,24453,1260,127687,-2521
2020-11-18,Alabama,01,223486,2638,3347,46,1517531,9011,223486,2638,1294045,6373
2020-11-18,Alaska,02,25454,545,94,0,885558,6936,24419,545,861139,6391
2020-11-18,Arizona,04,284554,3270,6365,45,2026755,14963,283102,3206,1743653,11757
2020-11-18,Arkansas,05,137617,1715,2275,30,1552919,12891,137617,1715,1415302,11176
2020-11-18,California,06,1069517,11421,18467,107,21418543,159467,1047789,9811,20370754,149656
2020-11-18,Colorado,08,178224,5004,2669,43,1520268,19919,176694,4650,1343574,15269
2020-11-18,Connecticut,09,97028,2042,4784,13,2860684,34226,97028,2042,2763656,32184
2020-11-18,Delaware,10,29755,203,742,3,386673,1197,29755,203,356918,994
2020-11-18,District of Columbia,11,19465,156,665,5,601412,4670,19465,156,581947,4514
2020-11-18,Florida,12,905240,7925,17730,87,6704999,41461,892352,7727,5812647,33734
2020-11-18,Georgia,13,417934,3113,8833,55,3975069,20647,393890,2424,3581179,18223
2020-11-18,Guam,66,7315,112,101,0,79060,112,6346,112,72714,0
2020-11-18,Hawaii,15,16817,62,222,1,312127,69,16974,69,295153,0
2020-11-18,Idaho,16,87020,1637,815,12,448393,3186,85125,1781,363268,1405
2020-11-18,Illinois,17,608056,8698,11488,161,9359227,103569,606771,8922,8752456,94647
2020-11-18,Indiana,18,270847,6037,5084,59,1989456,20368,268222,6015,1721234,14353
2020-11-18,Iowa,19,197532,4336,2102,38,1003986,6952,174839,3294,829147,3658
2020-11-18,Kansas,20,131051,5383,1326,60,748261,14505,128594,5853,619667,8652
2020-11-18,Kentucky,21,148069,2849,1816,29,2318785,31618,144753,2745,2174032,28873
2020-11-18,Louisiana,22,209914,2229,6184,28,3085849,17519,209914,2229,2875935,15290
2020-11-18,Maine,23,9519,156,170,4,775369,10451,9519,156,765850,10295
2020-11-18,Maryland,24,172204,2011,4351,16,2149335,13734,171823,2018,1977512,11716
2020-11-18,Massachusetts,25,195868,2904,10407,47,3101308,23222,195868,2904,2905440,20318
2020-11-18,Michigan,26,302541,6105,8576,63,5922691,56904,303058,6218,5619633,50686
2020-11-18,Minnesota,27,242099,5094,3066,67,2207809,16616,242043,5094,1965766,11522
2020-11-18,Mississippi,28,137396,1593,3601,20,1044387,1593,137396,1593,906991,0
2020-11-18,Missouri,29,266079,4974,3591,39,1702476,9927,253473,4587,1449003,5340
2020-11-18,Montana,30,50650,1154,568,20,591406,7578,50582,1184,540824,6394
2020-11-18,Nebraska,31,106617,2812,838,11,678985,4846,103805,2204,575180,2642
2020-11-18,Nevada,32,126106,2024,1947,1,895771,3279,125459,1665,770312,1614
2020-11-18,New Hampshire,33,15749,446,504,2,391151,2251,15749,446,375402,1805
2020-11-18,New Jersey,34,291374,4054,16655,37,5466148,91457,289562,4043,5176586,87414
2020-11-18,New Mexico,35,70452,2893,1290,26,1409823,11484,70451,2892,1339372,8592
2020-11-18,New York,36,578826,5282,33607,31,17191129,154434,574072,5294,16617057,149140
2020-11-18,North Carolina,37,322258,3721,4927,46,4731171,33610,320862,3367,4410309,30243
2020-11-18,North Dakota,38,67236,1263,791,16,328910,1570,67230,1263,261680,307
2020-11-18,Northern Mariana Islands,69,103,0,2,0,16570,0,103,0,16467,0
2020-11-18,Ohio,39,318828,6385,5827,55,5370905,6385,318828,6385,5052077,0
2020-11-18,Oklahoma,40,161425,3017,1570,26,1868941,17922,161425,3017,1707516,14905
2020-11-18,Oregon,41,59670,1100,791,12,976850,7028,59669,1099,917181,5929
2020-11-18,Pennsylvania,42,287464,6486,9541,108,2890838,26858,281852,6339,2608986,20519
2020-11-18,Puerto Rico,72,77525,325,971,20,349882,325,43910,325,305972,0
2020-11-18,Rhode Island,44,45911,1383,1284,6,493071,4821,45911,1383,447160,3438
2020-11-18,South Carolina,45,199447,1547,4182,26,2138289,15966,199447,1547,1938842,14419
2020-11-18,South Dakota,46,68671,1387,674,30,300973,2614,68671,1387,232302,1227
2020-11-18,Tennessee,47,319021,4468,4005,52,4200984,24833,325201,4472,3875783,20361
2020-11-18,Texas,48,1125906,13225,20471,193,9522343,81274,1048383,8870,8473960,72404
2020-11-18,Utah,49,162091,3085,742,8,1218943,10826,162028,3071,1056915,7755
2020-11-18,Vermont,50,3161,57,60,1,202100,613,3255,54,198845,559
2020-11-18,Virgin Islands,78,1463,13,23,0,26698,265,1463,13,25235,252
2020-11-18,Virginia,51,208833,2071,3860,25,3003410,20778,208833,2071,2794577,18707
2020-11-18,Washington,53,142511,1588,2704,18,2813081,17345,134121,2589,2678960,14756
2020-11-18,West Virginia,54,36277,953,612,14,960384,12940,36277,953,924107,11987
2020-11-18,Wisconsin,55,350665,8510,2939,63,2387606,20650,350665,8510,2036941,12140
2020-11-18,Wyoming,56,25275,822,155,0,152962,822,25275,822,127687,0
2020-11-19,Alabama,01,225910,2424,3419,72,1533166,15635,225910,2424,1307256,13211
2020-11-19,Alaska,02,25946,492,95,1,898799,13241,24909,490,873890,12751
2020-11-19,Arizona,04,288807,4253,6384,19,2045295,18540,287225,4123,1758070,14417
2020-11-19,Arkansas,05,139855,2238,2297,22,1568140,15221,139855,2238,1428285,12983
2020-11-19,California,06,1082674,13157,18555,88,21552528,133985,1059267,11478,20493261,122507
2020-11-19,Colorado,08,184260,6036,2734,65,1546507,26239,182801,6107,1363706,20132
2020-11-19,Connecticut,09,99381,2353,4805,21,2897280,36596,99381,2353,2797899,34243
2020-11-19,Delaware,10,30153,398,742,0,389021,2348,30153,398,358868,1950
2020-11-19,District of Columbia,11,19678,213,667,2,607834,6422,19678,213,588156,6209
2020-11-19,Florida,12,914325,9085,17809,79,6755524,50525,901234,8882,5854290,41643
2020-11-19,Georgia,13,421381,3447,8867,34,4010676,35607,396641,2751,3614035,32856
2020-11-19,Guam,66,7385,70,102,1,79388,328,6416,70,72972,258
2020-11-19,Hawaii,15,16917,100,222,0,312234,107,17081,107,295153,0
2020-11-19,Idaho,16,88642,1622,838,23,452950,4557,86435,1310,366515,3247
2020-11-19,Illinois,17,622869,14813,11671,183,9472674,113447,621383,14612,8851291,98835
2020-11-19,Indiana,18,278142,7295,5143,59,2009763,20307,275503,7281,1734260,13026
2020-11-19,Iowa,19,201572,4040,2127,25,1011476,7490,178313,3474,833163,4016
2020-11-19,Kansas,20,131408,357,1326,0,748261,0,128594,0,619667,0
2020-11-19,Kentucky,21,151706,3637,1843,27,2355104,36319,148390,3637,2206714,32682
2020-11-19,Louisiana,22,211966,2052,6199,15,3111627,25778,211966,2052,2899661,23726
2020-11-19,Maine,23,9734,215,171,1,788349,12980,9734,215,778615,12765
2020-11-19,Maryland,24,175092,2888,4372,21,2169508,20173,174733,2910,1994775,17263
2020-11-19,Massachusetts,25,198550,2682,10435,28,3123408,22100,198550,2682,2924858,19418
2020-11-19,Michigan,26,310396,7855,8717,141,5992927,70236,311041,7983,5681886,62253
2020-11-19,Minnesota,27,249962,7863,3138,72,2236816,29007,249906,7863,1986910,21144
2020-11-19,Mississippi,28,138791,1395,3619,18,1045782,1395,138791,1395,906991,0
2020-11-19,Missouri,29,270387,4308,3618,27,1712709,10233,257822,4349,1454887,5884
2020-11-19,Montana,30,51872,1222,569,1,595829,4423,51818,1236,544011,3187
2020-11-19,Nebraska,31,109280,2663,863,25,685788,6803,106617,2812,579171,3991
2020-11-19,Nevada,32,128234,2128,1958,11,903173,7402,127875,2416,775298,4986
2020-11-19,New Hampshire,33,16277,528,506,2,395483,4332,16277,528,379206,3804
2020-11-19,New Jersey,34,295556,4182,16689,34,5470330,4182,293744,4182,5176586,0
2020-11-19,New Mexico,35,74116,3664,1302,12,1420797,10974,74116,3665,1346681,7309
2020-11-19,New York,36,584128,5302,33648,41,17386368,195239,579382,5310,16806986,189929
2020-11-19,North Carolina,37,325658,3400,4968,41,4786263,55092,325158,4296,4461105,50796
2020-11-19,North Dakota,38,68618,1382,801,10,331177,2267,68612,1382,262565,885
2020-11-19,Northern Mariana Islands,69,103,0,2,0,16570,0,103,0,16467,0
2020-11-19,Ohio,39,326615,7787,5890,63,5475735,104830,326615,7787,5149120,97043
2020-11-19,Oklahoma,40,164340,2915,1588,18,1890561,21620,164340,2915,1726221,18705
2020-11-19,Oregon,41,60874,1204,809,18,985292,8442,60873,1204,924419,7238
2020-11-19,Pennsylvania,42,294345,6881,9643,102,2918505,27667,288978,7126,2629527,20541
2020-11-19,Puerto Rico,72,78046,521,982,11,350403,521,44431,521,305972,0
2020-11-19,Rhode Island,44,46951,1040,1288,4,496789,3718,46951,1040,449838,2678
2020-11-19,South Carolina,45,201160,1713,4201,19,2162127,23838,201160,1713,1960967,22125
2020-11-19,South Dakota,46,69742,1071,705,31,303269,2296,69742,1071,233527,1225
2020-11-19,Tennessee,47,321832,2811,4082,77,4218632,17648,328088,2887,3890544,14761
2020-11-19,Texas,48,1139695,13789,20689,218,9656497,134154,1060883,12500,8595614,121654
2020-11-19,Utah,49,166040,3949,758,16,1233330,14387,165996,3968,1067334,10419
2020-11-19,Vermont,50,3310,149,61,1,205126,3026,3407,152,201719,2874
2020-11-19,Virgin Islands,78,1469,6,23,0,26940,242,1469,6,25471,236
2020-11-19,Virginia,51,210787,1954,3896,36,3028092,24682,210787,1954,2817305,22728
2020-11-19,Washington,53,144968,2457,2717,13,2835472,22391,135424,1303,2700048,21088
2020-11-19,West Virginia,54,37399,1122,623,11,977539,17155,37399,1122,940140,16033
2020-11-19,Wisconsin,55,358113,7448,3021,82,2407639,20033,358113,7448,2049526,12585
2020-11-19,Wyoming,56,26169,894,176,21,156299,3337,26169,894,130130,2443
2020-11-20,Alabama,01,228373,2463,3451,32,1545177,12011,228373,2463,1316804,9548
2020-11-20,Alaska,02,26403,457,95,0,904712,5913,25369,460,879343,5453
2020-11-20,Arizona,04,292880,4073,6427,43,2072188,26893,291696,4471,1780492,22422
2020-11-20,Arkansas,05,141916,2061,2321,24,1582006,13866,141916,2061,1440090,11805
2020-11-20,California,06,1096401,13727,18649,94,21730551,178023,1072272,13005,20658279,165018
2020-11-20,Colorado,08,190100,5840,2752,18,1572964,26457,188566,5765,1384398,20692
2020-11-20,Connecticut,09,101469,2088,4828,23,2929060,31780,101469,2088,2827591,29692
2020-11-20,Delaware,10,30816,663,746,4,393282,4261,30816,663,362466,3598
2020-11-20,District of Columbia,11,19808,130,669,2,612204,4370,19808,130,592396,4240
2020-11-20,Florida,12,923410,9085,17888,79,6802690,47166,910065,8831,5892625,38335
2020-11-20,Georgia,13,424759,3378,8904,37,4043126,32450,399410,2769,3643716,29681
2020-11-20,Guam,66,7421,36,104,2,79788,400,6452,36,73336,364
2020-11-20,Hawaii,15,17029,112,222,0,312352,118,17199,118,295153,0
2020-11-20,Idaho,16,90346,1704,849,11,457120,4170,87978,1543,369142,2627
2020-11-20,Illinois,17,635823,12954,11814,143,9588698,116024,634395,13012,8954303,103012
2020-11-20,Indiana,18,284960,6818,5206,63,2030938,21175,282311,6808,1748627,14367
2020-11-20,Iowa,19,205918,4346,2159,32,1019474,7998,181790,3477,837684,4521
2020-11-20,Kansas,20,137224,5816,1410,84,763893,15632,134533,5939,629360,9693
2020-11-20,Kentucky,21,155625,3919,1862,19,2381856,26752,152206,3816,2229650,22936
2020-11-20,Louisiana,22,216709,4743,6233,34,3209377,97750,216709,4743,2992668,93007
2020-11-20,Maine,23,9958,224,173,2,795391,7042,9958,224,785433,6818
2020-11-20,Maryland,24,177239,2147,4398,26,2185431,15923,177086,2353,2008345,13570
2020-11-20,Massachusetts,25,200949,2399,10469,34,3148397,24989,200949,2399,2947448,22590
2020-11-20,Michigan,26,320621,10225,8776,59,6076686,83759,321181,10140,5755505,73619
2020-11-20,Minnesota,27,256756,6794,3206,68,2264278,27462,256700,6794,2007578,20668
2020-11-20,Mississippi,28,140429,1638,3642,23,1047420,1638,140429,1638,906991,0
2020-11-20,Missouri,29,275917,5530,3675,57,1724526,11817,262436,4614,1462090,7203
2020-11-20,Montana,30,53346,1474,575,6,601675,5846,53293,1475,548382,4371
2020-11-20,Nebraska,31,111661,2381,917,54,692154,6366,109280,2663,582874,3703
2020-11-20,Nevada,32,130102,1868,1987,29,906394,3221,129714,1839,776680,1382
2020-11-20,New Hampshire,33,16797,520,507,1,399806,4323,16797,520,383009,3803
2020-11-20,New Jersey,34,299182,3626,16712,23,5517700,47370,297370,3626,5220330,43744
2020-11-20,New Mexico,35,77098,2982,1327,25,1433609,12812,77098,2982,1356511,9830
2020-11-20,New York,36,589605,5477,33696,48,17591834,205466,584850,5468,17006984,199998
2020-11-20,North Carolina,37,330021,4363,5012,44,4819029,32766,328846,3688,4490183,29078
2020-11-20,North Dakota,38,70022,1404,824,23,333328,2151,70016,1404,263312,747
2020-11-20,Northern Mariana Islands,69,103,0,2,0,16570,0,103,0,16467,0
2020-11-20,Ohio,39,335423,8808,5955,65,5544189,68454,335423,8808,5208766,59646
2020-11-20,Oklahoma,40,167261,2921,1603,15,1907186,16625,167261,2921,1739925,13704
2020-11-20,Oregon,41,62176,1302,815,6,993753,8461,62175,1302,931578,7159
2020-11-20,Pennsylvania,42,301373,7028,9748,105,2944656,26151,295786,6808,2648870,19343
2020-11-20,Puerto Rico,72,78950,904,991,9,351307,904,45335,904,305972,0
2020-11-20,Rhode Island,44,48001,1050,1294,6,500932,4143,48001,1050,452931,3093
2020-11-20,South Carolina,45,203161,2001,4231,30,2192748,30621,203161,2001,1989587,28620
2020-11-20,South Dakota,46,71070,1328,741,36,306869,3600,71070,1328,235799,2272
2020-11-20,Tennessee,47,325282,3450,4156,74,4240548,21916,331532,3444,3909016,18472
2020-11-20,Texas,48,1153399,13704,20872,183,9787236,130739,1072698,11815,8714538,118924
2020-11-20,Utah,49,170644,4604,776,18,1247675,14345,170584,4588,1077091,9757
2020-11-20,Vermont,50,3459,149,62,1,206450,1324,3551,144,202899,1180
2020-11-20,Virgin Islands,78,1482,13,23,0,27091,151,1482,13,25609,138
2020-11-20,Virginia,51,213331,2544,3912,16,3056992,28900,213331,2544,2843661,26356
2020-11-20,Washington,53,147251,2283,2738,21,2856474,21002,137411,1987,2719063,19015
2020-11-20,West Virginia,54,38480,1081,639,16,994372,16833,38480,1081,955892,15752
2020-11-20,Wisconsin,55,365190,7077,3106,85,2427381,19742,365190,7077,2062191,12665
2020-11-20,Wyoming,56,27129,960,176,0,158917,2618,27129,960,131788,1658
2020-11-21,Alabama,01,230708,2335,3457,6,1555799,10622,230708,2335,1325091,8287
2020-11-21,Alaska,02,27079,676,95,0,918745,14033,26044,675,892701,13358
2020-11-21,Arizona,04,296997,4117,6459,32,2092097,19909,295334,3638,1796763,16271
2020-11-21,Arkansas,05,143821,1905,2337,16,1597546,15540,143821,1905,1453725,13635
2020-11-21,California,06,1109844,13443,18709,60,21971832,241281,1087714,15442,20884118,225839
2020-11-21,Colorado,08,195220,5120,2791,39,1598694,25730,194679,6113,1404015,19617
2020-11-21,Connecticut,09,101469,0,4828,0,2929060,0,101469,0,2827591,0
2020-11-21,Delaware,10,31321,505,746,0,396943,3661,31321,505,365622,3156
2020-11-21,District of Columbia,11,19961,153,670,1,618784,6580,19961,153,598823,6427
2020-11-21,Florida,12,931819,8409,17929,41,6850174,47484,918240,8175,5931934,39309
2020-11-21,Georgia,13,430687,5928,8940,36,4086142,43016,402435,3025,3683707,39991
2020-11-21,Guam,66,7421,0,104,0,79812,24,6476,24,73336,0
2020-11-21,Hawaii,15,17182,153,229,7,312514,162,17361,162,295153,0
2020-11-21,Idaho,16,91312,966,851,2,461195,4075,89764,1786,371431,2289
2020-11-21,Illinois,17,647474,11651,11967,153,9708982,120284,646286,11891,9062696,108393
2020-11-21,Indiana,18,291838,6878,5246,40,2053143,22205,289183,6872,1763960,15333
2020-11-21,Iowa,19,209203,3285,2191,32,1027073,7599,184968,3178,842105,4421
2020-11-21,Kansas,20,137295,71,1411,1,763893,0,134533,0,629360,0
2020-11-21,Kentucky,21,159035,3410,1886,24,2434836,52980,155908,3702,2278928,49278
2020-11-21,Louisiana,22,216709,0,6233,0,3209377,0,216709,0,2992668,0
2020-11-21,Maine,23,10123,165,174,1,795556,165,10123,165,785433,0
2020-11-21,Maryland,24,180125,2886,4415,17,2206289,20858,179971,2885,2026318,17973
2020-11-21,Massachusetts,25,204155,3206,10488,19,3181171,32774,204155,3206,2977016,29568
2020-11-21,Michigan,26,328178,7557,8874,98,6164253,87567,329021,7840,5835232,79727
2020-11-21,Minnesota,27,263008,6252,3257,51,2282358,18080,262952,6252,2019406,11828
2020-11-21,Mississippi,28,142401,1972,3657,15,1049392,1972,142401,1972,906991,0
2020-11-21,Missouri,29,279987,4070,3684,9,1727217,2691,267312,4876,1459905,-2185
2020-11-21,Montana,30,54542,1196,604,29,608502,6827,54542,1249,553960,5578
2020-11-21,Nebraska,31,113029,1368,929,12,698840,6686,111661,2381,587179,4305
2020-11-21,Nevada,32,132610,2508,2017,30,919379,12985,131733,2019,787646,10966
2020-11-21,New Hampshire,33,17281,484,508,1,400533,727,17281,484,383252,243
2020-11-21,New Jersey,34,303851,4669,16746,34,5567342,49642,302039,4669,5265303,44973
2020-11-21,New Mexico,35,79440,2342,1352,25,1444121,10512,79440,2342,1364681,8170
2020-11-21,New York,36,595581,5976,33737,41,17799741,207907,590822,5972,17208919,201935
2020-11-21,North Carolina,37,333074,3053,5035,23,4878076,59047,332261,3415,4545815,55632
2020-11-21,North Dakota,38,71546,1524,840,16,335688,2360,71540,1524,264148,836
2020-11-21,Northern Mariana Islands,69,103,0,2,0,16570,0,103,0,16467,0
2020-11-21,Ohio,39,343286,7863,5984,29,5609595,65406,343286,7863,5266309,57543
2020-11-21,Oklahoma,40,170924,3663,1624,21,1960569,53383,170924,3663,1789645,49720
2020-11-21,Oregon,41,63668,1492,822,7,1001247,7494,63668,1493,937579,6001
2020-11-21,Pennsylvania,42,307247,5874,9862,114,2971240,26584,302564,6778,2668676,19806
2020-11-21,Puerto Rico,72,80049,1099,1012,21,352406,1099,46434,1099,305972,0
2020-11-21,Rhode Island,44,48001,0,1294,0,505662,4730,49406,1405,456256,3325
2020-11-21,South Carolina,45,205018,1857,4274,43,2225252,32504,205018,1857,2020234,30647
2020-11-21,South Dakota,46,72214,1144,777,36,309170,2301,72214,1144,236956,1157
2020-11-21,Tennessee,47,329490,4208,4163,7,4269060,28512,335887,4355,3933173,24157
2020-11-21,Texas,48,1164314,10915,21004,132,9908129,120893,1085524,12826,8822605,108067
2020-11-21,Utah,49,173987,3343,789,13,1259782,12107,173979,3395,1085803,8712
2020-11-21,Vermont,50,3546,87,63,1,209730,3280,3639,88,206091,3192
2020-11-21,Virgin Islands,78,1491,9,23,0,27267,176,1491,9,25776,167
2020-11-21,Virginia,51,215679,2348,3938,26,3093060,36068,215679,2348,2877381,33720
2020-11-21,Washington,53,148691,1440,2738,0,2877894,21420,139543,2132,2738351,19288
2020-11-21,West Virginia,54,39598,1118,658,19,1013043,18671,39598,1118,973445,17553
2020-11-21,Wisconsin,55,372219,7029,3155,49,2446079,18698,372219,7029,2073860,11669
2020-11-21,Wyoming,56,27410,281,176,0,159198,281,27410,281,131788,0
2020-11-22,Alabama,01,232506,1798,3457,0,1563307,7508,232506,1798,1330801,5710
2020-11-22,Alaska,02,27629,550,97,2,926361,7616,26587,543,899774,7073
2020-11-22,Arizona,04,299698,2701,6464,5,2112974,20877,299665,4331,1813309,16546
2020-11-22,Arkansas,05,145173,1352,2357,20,1611627,14081,145173,1352,1466454,12729
2020-11-22,California,06,1118652,8808,18726,17,22237309,265477,1102033,14319,21135276,251158
2020-11-22,Colorado,08,199296,4076,2811,20,1620879,22185,198600,3921,1422279,18264
2020-11-22,Connecticut,09,101469,0,4828,0,2929060,0,101469,0,2827591,0
2020-11-22,Delaware,10,31808,487,748,2,400436,3493,31808,487,368628,3006
2020-11-22,District of Columbia,11,20151,190,670,0,630532,11748,20151,190,610381,11558
2020-11-22,Florida,12,938406,6587,17990,61,6898401,48227,924614,6374,5973787,41853
2020-11-22,Georgia,13,432954,2267,8955,15,4112780,26638,404411,1976,3708369,24662
2020-11-22,Guam,66,7518,97,107,3,79885,73,6549,73,73336,0
2020-11-22,Hawaii,15,17302,120,231,2,312636,122,17483,122,295153,0
2020-11-22,Idaho,16,91935,623,852,1,464547,3352,90834,1070,373713,2282
2020-11-22,Illinois,17,657402,9928,12064,97,9801419,92437,656298,10012,9145121,82425
2020-11-22,Indiana,18,298021,6183,5305,59,2072690,19547,295357,6174,1777333,13373
2020-11-22,Iowa,19,211664,2461,2202,11,1033800,6727,187505,2537,846295,4190
2020-11-22,Kansas,20,137530,235,1410,-1,763893,0,134533,0,629360,0
2020-11-22,Kentucky,21,161222,2187,1887,1,2437028,2192,158100,2192,2278928,0
2020-11-22,Louisiana,22,220192,3483,6260,27,3251946,42569,220192,3483,3031754,39086
2020-11-22,Maine,23,10359,236,176,2,795792,236,10359,236,785433,0
2020-11-22,Maryland,24,182482,2357,4434,19,2225389,19100,182139,2168,2043250,16932
2020-11-22,Massachusetts,25,206850,2695,10512,24,3207055,25884,206850,2695,3000205,23189
2020-11-22,Michigan,26,328833,655,8874,0,6164253,0,329021,0,5835232,0
2020-11-22,Minnesota,27,270213,7205,3297,40,2318754,36396,270157,7205,2048597,29191
2020-11-22,Mississippi,28,143180,779,3676,19,1050171,779,143180,779,906991,0
2020-11-22,Missouri,29,283756,3769,3688,4,1739720,12503,271527,4215,1468193,8288
2020-11-22,Montana,30,55680,1138,607,3,613009,4507,55680,1138,557329,3369
2020-11-22,Nebraska,31,114061,1032,933,4,703689,4849,113029,1368,590660,3481
2020-11-22,Nevada,32,134761,2151,2022,5,925814,6435,133888,2155,791926,4280
2020-11-22,New Hampshire,33,17598,317,512,4,404324,3791,17598,317,386726,3474
2020-11-22,New Jersey,34,307819,3968,16761,15,5621149,53807,306007,3968,5315142,49839
2020-11-22,New Mexico,35,81896,2456,1385,33,1454997,10876,81896,2456,1373101,8420
2020-11-22,New York,36,600967,5386,33767,30,17996351,196610,596214,5392,17400137,191218
2020-11-22,North Carolina,37,336983,3909,5062,27,4947614,69538,336775,4514,4610839,65024
2020-11-22,North Dakota,38,72689,1143,846,6,337887,2199,72683,1143,265204,1056
2020-11-22,Northern Mariana Islands,69,104,1,2,0,16571,1,104,1,16467,0
2020-11-22,Ohio,39,351419,8133,5996,12,5672104,62509,351419,8133,5320685,54376
2020-11-22,Oklahoma,40,174330,3406,1634,10,1963975,3406,174330,3406,1789645,0
2020-11-22,Oregon,41,65170,1502,822,0,1009614,8367,65170,1502,944444,6865
2020-11-22,Pennsylvania,42,313788,6541,9901,39,3000624,29384,309639,7075,2690985,22309
2020-11-22,Puerto Rico,72,81074,1025,1017,5,353431,1025,47459,1025,305972,0
2020-11-22,Rhode Island,44,48001,0,1294,0,509556,3894,50144,738,459412,3156
2020-11-22,South Carolina,45,206295,1277,4283,9,2246568,21316,206295,1277,2040273,20039
2020-11-22,South Dakota,46,73065,851,819,42,311218,2048,73065,851,238153,1197
2020-11-22,Tennessee,47,333853,4363,4218,55,4305687,36627,340476,4589,3965211,32038
2020-11-22,Texas,48,1172848,8534,21083,79,9991420,83291,1094275,8751,8897145,74540
2020-11-22,Utah,49,177176,3189,793,4,1272248,12466,177176,3197,1095072,9269
2020-11-22,Vermont,50,3629,83,63,0,213237,3507,3727,88,209510,3419
2020-11-22,Virgin Islands,78,1504,13,23,0,27479,212,1504,13,25975,199
2020-11-22,Virginia,51,217796,2117,3938,0,3141191,48131,217796,2117,2923395,46014
2020-11-22,Washington,53,149703,1012,2738,0,2894367,16473,141260,1717,2753107,14756
2020-11-22,West Virginia,54,40478,880,662,4,1026969,13926,40478,880,986491,13046
2020-11-22,Wisconsin,55,376238,4019,3162,7,2461490,15411,376238,4019,2085252,11392
2020-11-22,Wyoming,56,28169,759,176,0,159957,759,28169,759,131788,0
2020-11-23,Alabama,01,234080,1574,3459,2,1571821,8514,234080,1574,1337741,6940
2020-11-23,Alaska,02,28128,499,97,0,933016,6655,27085,498,905931,6157
2020-11-23,Arizona,04,303188,3490,6465,1,2133623,20649,302324,2659,1831299,17990
2020-11-23,Arkansas,05,146190,1017,2387,30,1621958,10331,146190,1017,1475768,9314
2020-11-23,California,06,1136346,17694,18768,42,22457544,220235,1110370,8337,21347174,211898
2020-11-23,Colorado,08,203578,4282,2821,10,1640217,19338,202289,3689,1437928,15649
2020-11-23,Connecticut,09,106740,5271,4871,43,3038489,109429,106740,5271,2931749,104158
2020-11-23,Delaware,10,32211,403,752,4,402841,2405,32211,403,370630,2002
2020-11-23,District of Columbia,11,20290,139,672,2,639461,8929,20290,139,619171,8790
2020-11-23,Florida,12,944737,6331,18084,94,6928502,30101,930728,6114,5997774,23987
2020-11-23,Georgia,13,434916,1962,8972,17,4139509,26729,406220,1809,3733289,24920
2020-11-23,Guam,66,7571,53,107,0,80999,1114,6602,53,74397,1061
2020-11-23,Hawaii,15,17405,103,231,0,312749,113,17596,113,295153,0
2020-11-23,Idaho,16,93602,1667,869,17,467362,2815,91653,819,375709,1996
2020-11-23,Illinois,17,665865,8463,12141,77,9892981,91562,664620,8322,9228361,83240
2020-11-23,Indiana,18,303575,5554,5332,27,2090728,18038,300913,5556,1789815,12482
2020-11-23,Iowa,19,214792,3128,2222,20,1040373,6573,189856,2351,850517,4222
2020-11-23,Kansas,20,144831,7301,1462,52,784288,20395,142059,7526,642229,12869
2020-11-23,Kentucky,21,163767,2545,1906,19,2469063,32035,160232,2132,2308831,29903
2020-11-23,Louisiana,22,221160,968,6284,24,3262192,10246,221160,968,3041032,9278
2020-11-23,Maine,23,10544,185,177,1,825349,29557,10544,185,814805,29372
2020-11-23,Maryland,24,184140,1658,4448,14,2238492,13103,183797,1658,2054695,11445
2020-11-23,Massachusetts,25,208623,1773,10531,19,3222588,15533,208623,1773,3013965,13760
2020-11-23,Michigan,26,340223,11390,8937,63,6263536,99283,340964,11943,5922572,87340
2020-11-23,Minnesota,27,276556,6343,3321,24,2345719,26965,276500,6343,2069219,20622
2020-11-23,Mississippi,28,143879,699,3676,0,1091151,40980,143879,699,947272,40281
2020-11-23,Missouri,29,288308,4552,3697,9,1750096,10376,274897,3370,1475199,7006
2020-11-23,Montana,30,56428,748,615,8,617974,4965,56381,701,561593,4264
2020-11-23,Nebraska,31,115921,1860,958,25,706758,3069,114061,1032,592697,2037
2020-11-23,Nevada,32,136672,1911,2030,8,933588,7774,136227,2339,797361,5435
2020-11-23,New Hampshire,33,18042,444,512,0,406227,1903,18042,444,388185,1459
2020-11-23,New Jersey,34,311400,3581,16772,11,5675266,54117,309588,3581,5365678,50536
2020-11-23,New Mexico,35,84148,2252,1402,17,1464452,9455,84148,2252,1380304,7203
2020-11-23,New York,36,606878,5911,33804,37,18187840,191489,602120,5906,17585720,185583
2020-11-23,North Carolina,37,339672,2689,5076,14,4983768,36154,339194,2419,4644574,33735
2020-11-23,North Dakota,38,73403,714,852,6,339483,1596,73397,714,266086,882
2020-11-23,Northern Mariana Islands,69,104,0,2,0,16851,280,104,0,16747,280
2020-11-23,Ohio,39,363304,11885,6020,24,5683989,11885,363304,11885,5320685,0
2020-11-23,Oklahoma,40,177874,3544,1649,15,1967519,3544,177874,3544,1789645,0
2020-11-23,Oregon,41,66334,1164,830,8,1016282,6668,66333,1163,949949,5505
2020-11-23,Pennsylvania,42,320250,6462,9932,31,3019571,18947,314401,4762,2705170,14185
2020-11-23,Puerto Rico,72,81815,741,1032,15,354172,741,48200,741,305972,0
2020-11-23,Rhode Island,44,50573,2572,1309,15,511665,2109,50573,429,461092,1680
2020-11-23,South Carolina,45,207552,1257,4288,5,2267605,21037,207552,1257,2060053,19780
2020-11-23,South Dakota,46,73848,783,819,0,313297,2079,73848,783,239449,1296
2020-11-23,Tennessee,47,337637,3784,4254,36,4334644,28957,344550,4074,3990094,24883
2020-11-23,Texas,48,1184041,11193,21144,61,10123856,132436,1100979,6704,9022877,125732
2020-11-23,Utah,49,179420,2244,799,6,1279344,7096,179420,2244,1099924,4852
2020-11-23,Vermont,50,3714,85,63,0,214996,1759,3795,68,211201,1691
2020-11-23,Virgin Islands,78,1507,3,23,0,27479,0,1504,0,25975,0
2020-11-23,Virginia,51,221038,3242,3942,4,3183955,42764,221038,3242,2962917,39522
2020-11-23,Washington,53,155336,5633,2775,37,2894367,0,141260,0,2753107,0
2020-11-23,West Virginia,54,41114,636,667,5,1038846,11877,41114,636,997732,11241
2020-11-23,Wisconsin,55,379693,3455,3175,13,2474141,12651,379693,3455,2094448,9196
2020-11-23,Wyoming,56,29431,1262,202,26,161219,1262,29431,1262,131788,0
2020-11-24,Alabama,01,236865,2785,3472,13,1583882,12061,236865,2785,1347017,9276
2020-11-24,Alaska,02,28708,580,110,13,943401,10385,27669,584,915732,9801
2020-11-24,Arizona,04,307943,4755,6515,50,2148901,15278,306868,4544,1842033,10734
2020-11-24,Arkansas,05,148312,2122,2405,18,1635389,13431,148312,2122,1487077,11309
2020-11-24,California,06,1153005,16659,18875,107,22741363,283819,1125699,15329,21615664,268490
2020-11-24,Colorado,08,207882,4304,2868,47,1654599,14382,206439,4150,1448160,10232
2020-11-24,Connecticut,09,107280,540,4881,10,3051730,13241,107280,540,2944450,12701
2020-11-24,Delaware,10,32664,453,757,5,406207,3366,32664,453,373543,2913
2020-11-24,District of Columbia,11,20409,119,673,1,648922,9461,20409,119,628513,9342
2020-11-24,Florida,12,953292,8555,18156,72,6982425,53923,938830,8102,6043595,45821
2020-11-24,Georgia,13,438441,3525,8979,7,4173943,34434,408644,2424,3765299,32010
2020-11-24,Guam,66,7624,53,108,1,81600,601,6655,53,74945,548
2020-11-24,Hawaii,15,17461,56,231,0,312809,60,17656,60,295153,0
2020-11-24,Idaho,16,95588,1986,881,12,470788,3426,93090,1437,377698,1989
2020-11-24,Illinois,17,675543,9678,12294,153,9990304,97323,674089,9469,9316215,87854
2020-11-24,Indiana,18,309218,5643,5435,103,2107744,17016,306538,5625,1801206,11391
2020-11-24,Iowa,19,217786,2994,2271,49,1044789,4416,191152,1296,853637,3120
2020-11-24,Kansas,20,145272,441,1456,-6,784288,0,142059,0,642229,0
2020-11-24,Kentucky,21,166478,2711,1938,32,2498456,29393,162838,2606,2335618,26787
2020-11-24,Louisiana,22,224403,3243,6323,39,3296384,34192,224403,3243,3071981,30949
2020-11-24,Maine,23,10799,255,189,12,833554,8205,10799,255,822755,7950
2020-11-24,Maryland,24,185812,1672,4481,33,2252024,13532,185464,1667,2066560,11865
2020-11-24,Massachusetts,25,211199,2576,10551,20,3245573,22985,211199,2576,3034374,20409
2020-11-24,Michigan,26,347076,6853,9094,157,6334377,70841,347746,6782,5986631,64059
2020-11-24,Minnesota,27,282972,6416,3359,38,2370205,24486,282916,6416,2087289,18070
2020-11-24,Mississippi,28,144544,665,3729,53,1091816,665,144544,665,947272,0
2020-11-24,Missouri,29,292786,4478,3869,172,1759203,9107,278661,3764,1480542,5343
2020-11-24,Montana,30,57559,1131,630,15,622796,4822,57504,1123,565292,3699
2020-11-24,Nebraska,31,117682,1761,981,23,711971,5213,115921,1860,596050,3353
2020-11-24,Nevada,32,140572,3900,2053,23,943726,10138,139080,2853,804646,7285
2020-11-24,New Hampshire,33,18382,340,513,1,407668,1441,18382,340,389286,1101
2020-11-24,New Jersey,34,315675,4275,16819,47,5725579,50313,313863,4275,5411716,46038
2020-11-24,New Mexico,35,86247,2099,1430,28,1477284,12832,86247,2099,1391037,10733
2020-11-24,New York,36,611756,4878,33847,43,18352601,164761,607001,4881,17745600,159880
2020-11-24,North Carolina,37,343566,3894,5114,38,5028737,44969,342294,3100,4686443,41869
2020-11-24,North Dakota,38,74407,1004,889,37,341033,1550,74401,1004,266632,546
2020-11-24,Northern Mariana Islands,69,104,0,2,0,16851,0,104,0,16747,0
2020-11-24,Ohio,39,371908,8604,6118,98,5804292,120303,371908,8604,5432384,111699
2020-11-24,Oklahoma,40,180610,2736,1664,15,2011009,43490,180610,2736,1830399,40754
2020-11-24,Oregon,41,67337,1003,848,18,1024582,8300,67333,1000,957249,7300
2020-11-24,Pennsylvania,42,326615,6365,10014,82,3044438,24867,321070,6669,2723368,18198
2020-11-24,Puerto Rico,72,82163,348,1038,6,354520,348,48548,348,305972,0
2020-11-24,Rhode Island,44,51424,851,1325,16,515643,3978,51424,851,464219,3127
2020-11-24,South Carolina,45,209230,1678,4313,25,2287492,19887,209230,1678,2078262,18209
2020-11-24,South Dakota,46,74859,1011,821,2,315794,2497,74859,1011,240935,1486
2020-11-24,Tennessee,47,339059,1422,4325,71,4340462,5818,345854,1304,3994608,4514
2020-11-24,Texas,48,1204464,20423,21338,194,10240403,116547,1115371,14392,9125032,102155
2020-11-24,Utah,49,182121,2701,810,11,1291122,11778,182121,2701,1109001,9077
2020-11-24,Vermont,50,3762,48,64,1,216292,1296,3845,50,212447,1246
2020-11-24,Virgin Islands,78,1521,14,23,0,27734,255,1507,3,26227,252
2020-11-24,Virginia,51,223582,2544,3979,37,3210565,26610,223582,2544,2986983,24066
2020-11-24,Washington,53,158234,2898,2807,32,2900644,6277,147537,6277,2753107,0
2020-11-24,West Virginia,54,42083,969,682,15,1053635,14789,42083,969,1011552,13820
2020-11-24,Wisconsin,55,386441,6748,3295,120,2491197,17056,386441,6748,2104756,10308
2020-11-24,Wyoming,56,29959,528,202,0,161747,528,29959,528,131788,0
2020-11-25,Alabama,01,239318,2453,3532,60,1593279,9397,239318,2453,1353961,6944
2020-11-25,Alaska,02,29386,678,110,0,954276,10875,28339,670,925937,10205
2020-11-25,Arizona,04,311727,3784,6529,14,2166252,17351,310850,3982,1855402,13369
2020-11-25,Arkansas,05,150277,1965,2425,20,1650534,15145,150277,1965,1500257,13180
2020-11-25,California,06,1167149,14144,18982,107,22910351,168988,1144049,18350,21766302,150638
2020-11-25,Colorado,08,212416,4534,2930,62,1671722,17123,210630,4191,1461092,12932
2020-11-25,Connecticut,09,109152,1872,4926,45,3083113,31383,109152,1872,2973961,29511
2020-11-25,Delaware,10,32995,331,760,3,408654,2447,32995,331,375659,2116
2020-11-25,District of Columbia,11,20516,107,677,4,650235,1313,20516,107,629719,1206
2020-11-25,Florida,12,961668,8376,18253,97,7028635,46210,946956,8126,6081679,38084
2020-11-25,Georgia,13,441737,3296,9054,75,4195929,21986,411002,2358,3784927,19628
2020-11-25,Guam,66,7674,50,110,2,82709,1109,6705,50,76004,1059
2020-11-25,Hawaii,15,17561,100,233,2,312917,108,17764,108,295153,0
2020-11-25,Idaho,16,97007,1419,901,20,474042,3254,94730,1640,379312,1614
2020-11-25,Illinois,17,686855,11312,12465,171,10104537,114233,685467,11378,9419070,102855
2020-11-25,Indiana,18,315212,5994,5498,63,2126395,18651,312521,5983,1813874,12668
2020-11-25,Iowa,19,221288,3502,2312,41,1050640,5851,194395,3243,856245,2608
2020-11-25,Kansas,20,150515,5243,1503,47,799185,14897,147797,5738,651388,9159
2020-11-25,Kentucky,21,169822,3344,1975,37,2508849,10393,166139,3301,2342710,7092
2020-11-25,Louisiana,22,225638,1235,6350,27,3310705,14321,225638,1235,3085067,13086
2020-11-25,Maine,23,11027,228,190,1,841090,7536,11027,228,830063,7308
2020-11-25,Maryland,24,188509,2697,4518,37,2270660,18636,188161,2697,2082499,15939
2020-11-25,Massachusetts,25,214594,3395,10604,53,3275409,29836,214594,3395,3060815,26441
2020-11-25,Michigan,26,352052,4976,9168,74,6392563,58186,352433,4687,6040130,53499
2020-11-25,Minnesota,27,289362,6390,3434,75,2403190,32985,289303,6387,2113887,26598
2020-11-25,Mississippi,28,145636,1092,3745,16,1092908,1092,145636,1092,947272,0
2020-11-25,Missouri,29,297374,4588,3908,39,1770305,11102,282792,4131,1487513,6971
2020-11-25,Montana,30,58620,1061,653,23,627851,5055,58565,1061,569286,3994
2020-11-25,Nebraska,31,120076,2394,1004,23,716768,4797,117682,1761,599086,3036
2020-11-25,Nevada,32,142951,2379,2077,24,950716,6990,142239,3159,808477,3831
2020-11-25,New Hampshire,33,18776,394,514,1,411047,3379,18776,394,392271,2985
2020-11-25,New Jersey,34,319734,4059,16886,67,5827339,101760,317905,4042,5509434,97718
2020-11-25,New Mexico,35,88102,1855,1451,21,1487840,10556,88102,1855,1399738,8701
2020-11-25,New York,36,618023,6267,33890,43,18525686,173085,613266,6265,17912420,166820
2020-11-25,North Carolina,37,348102,4536,5177,63,5084569,55832,346506,4212,4738063,51620
2020-11-25,North Dakota,38,75484,1077,893,4,342837,1804,75478,1077,267359,727
2020-11-25,Northern Mariana Islands,69,104,0,2,0,16851,0,104,0,16747,0
2020-11-25,Ohio,39,382743,10835,6274,156,5856888,52596,382743,10835,5474145,41761
2020-11-25,Oklahoma,40,184342,3732,1680,16,2032905,21896,184342,3732,1848563,18164
2020-11-25,Oregon,41,68504,1167,871,23,1028972,4390,68503,1170,960469,3220
2020-11-25,Pennsylvania,42,333571,6956,10162,148,3071050,26612,327829,6759,2743221,19853
2020-11-25,Puerto Rico,72,82340,177,1052,14,354697,177,48725,177,305972,0
2020-11-25,Rhode Island,44,52317,893,1335,10,515106,-537,52317,893,462789,-1430
2020-11-25,South Carolina,45,210905,1675,4317,4,2308163,20671,210905,1675,2097258,18996
2020-11-25,South Dakota,46,76142,1283,849,28,318354,2560,76142,1283,242212,1277
2020-11-25,Tennessee,47,341456,2397,4415,90,4354895,14433,347972,2118,4006923,12315
2020-11-25,Texas,48,1219392,14928,21536,198,10319842,79439,1130980,15609,9188862,63830
2020-11-25,Utah,49,183960,1839,834,24,1297873,6751,183902,1781,1113971,4970
2020-11-25,Vermont,50,3827,65,64,0,218195,1903,3938,93,214257,1810
2020-11-25,Virgin Islands,78,1521,0,23,0,28036,302,1521,14,26515,288
2020-11-25,Virginia,51,226300,2718,4008,29,3237740,27175,226300,2718,3011440,24457
2020-11-25,Washington,53,161207,2973,2825,18,2904126,3482,151019,3482,2753107,0
2020-11-25,West Virginia,54,43050,967,695,13,1069343,15708,43050,967,1026293,14741
2020-11-25,Wisconsin,55,392443,6002,3363,68,2508987,17790,392438,5997,2116549,11793
2020-11-25,Wyoming,56,30761,802,215,13,162549,802,30761,802,131788,0
2020-11-26,Alabama,01,241957,2639,3572,40,1603144,9865,241957,2639,1361187,7226
2020-11-26,Alaska,02,29940,554,113,3,969573,15297,28892,553,940681,14744
2020-11-26,Arizona,04,314326,2599,6568,39,2188188,21936,314326,3476,1873862,18460
2020-11-26,Arkansas,05,152625,2348,2436,11,1665827,15293,152625,2348,1513202,12945
2020-11-26,California,06,1176137,8988,19025,43,23096745,186394,1158689,14640,21938056,171754
2020-11-26,Colorado,08,217655,5239,2977,47,1699645,27923,216683,6053,1482962,21870
2020-11-26,Connecticut,09,109152,0,4926,0,3083113,0,109152,0,2973961,0
2020-11-26,Delaware,10,33579,584,761,1,412412,3758,33579,584,378833,3174
2020-11-26,District of Columbia,11,20736,220,677,0,663201,12966,20736,220,642465,12746
2020-11-26,Florida,12,961668,0,18253,0,7028635,0,946956,0,6081679,0
2020-11-26,Georgia,13,445204,3467,9089,35,4226691,30762,413909,2907,3812782,27855
2020-11-26,Guam,66,7717,43,112,2,82752,43,6748,43,76004,0
2020-11-26,Hawaii,15,17678,117,235,2,313034,117,17881,117,295153,0
2020-11-26,Idaho,16,97007,0,901,0,478886,4844,96503,1773,382383,3071
2020-11-26,Illinois,17,698364,11509,12609,144,10212093,107556,697489,12022,9514604,95534
2020-11-26,Indiana,18,321595,6383,5561,63,2145727,19332,318894,6373,1826833,12959
2020-11-26,Iowa,19,223323,2035,2349,37,1057718,7078,197086,2691,860632,4387
2020-11-26,Kansas,20,150522,7,1503,0,799185,0,147797,0,651388,0
2020-11-26,Kentucky,21,170081,259,1983,8,2508849,0,166139,0,2342710,0
2020-11-26,Louisiana,22,225638,0,6350,0,3310705,0,225638,0,3085067,0
2020-11-26,Maine,23,11265,238,190,0,841328,238,11265,238,830063,0
2020-11-26,Maryland,24,190635,2126,4547,29,2287167,16507,190480,2319,2096687,14188
2020-11-26,Massachusetts,25,214594,0,10604,0,3275409,0,214594,0,3060815,0
2020-11-26,Michigan,26,352342,290,9169,1,6392563,0,352433,0,6040130,0
2020-11-26,Minnesota,27,289362,0,3434,0,2403190,0,289303,0,2113887,0
2020-11-26,Mississippi,28,147382,1746,3763,18,1094654,1746,147382,1746,947272,0
2020-11-26,Missouri,29,300825,3451,3932,24,1782717,12412,287263,4471,1495454,7941
2020-11-26,Montana,30,59682,1062,658,5,631927,4076,59682,1117,572245,2959
2020-11-26,Nebraska,31,122952,2876,1008,4,723010,6242,120076,2394,602934,3848
2020-11-26,Nevada,32,144794,1843,2093,16,959193,8477,144781,2542,814412,5935
2020-11-26,New Hampshire,33,18776,0,514,0,411047,0,18776,0,392271,0
2020-11-26,New Jersey,34,324207,4473,16925,39,5831812,4473,322378,4473,5509434,0
2020-11-26,New Mexico,35,89796,1694,1469,18,1504856,17016,89796,1694,1415060,15322
2020-11-26,New York,36,624961,6938,33959,69,18743407,217721,620199,6933,18123208,210788
2020-11-26,North Carolina,37,348148,46,5177,0,5084569,0,346506,0,4738063,0
2020-11-26,North Dakota,38,76448,964,903,10,344754,1917,76442,964,268312,953
2020-11-26,Northern Mariana Islands,69,104,0,2,0,16851,0,104,0,16747,0
2020-11-26,Ohio,39,382743,0,6274,0,5856888,0,382743,0,5474145,0
2020-11-26,Oklahoma,40,184342,0,1680,0,2057810,24905,184342,0,1873468,24905
2020-11-26,Oregon,41,70006,1502,884,13,1030663,1691,70006,1503,960657,188
2020-11-26,Pennsylvania,42,340998,7427,10271,109,3101483,30433,336254,8425,2765229,22008
2020-11-26,Puerto Rico,72,82841,501,1069,17,355198,501,49226,501,305972,0
2020-11-26,Rhode Island,44,52317,0,1335,0,518855,3749,53491,1174,465364,2575
2020-11-26,South Carolina,45,210905,0,4317,0,2308163,0,210905,0,2097258,0
2020-11-26,South Dakota,46,76142,0,849,0,318354,0,76142,0,242212,0
2020-11-26,Tennessee,47,345371,3915,4468,53,4391717,36822,352376,4404,4039341,32418
2020-11-26,Texas,48,1223896,4504,21709,173,10386194,66352,1143616,12636,9242578,53716
2020-11-26,Utah,49,184382,422,834,0,1297873,0,183902,0,1113971,0
2020-11-26,Vermont,50,3827,0,64,0,219897,1702,4017,79,215880,1623
2020-11-26,Virgin Islands,78,1521,0,23,0,28036,0,1521,0,26515,0
2020-11-26,Virginia,51,228900,2600,4029,21,3261387,23647,228900,2600,3032487,21047
2020-11-26,Washington,53,161911,704,2825,0,2907013,2887,153906,2887,2753107,0
2020-11-26,West Virginia,54,44180,1130,712,17,1085099,15756,44180,1130,1040919,14626
2020-11-26,Wisconsin,55,398104,5661,3431,68,2523306,14319,398104,5666,2125202,8653
2020-11-26,Wyoming,56,30761,0,215,0,162549,0,30761,0,131788,0
2020-11-27,Alabama,01,242874,917,3572,0,1608114,4970,242874,917,1365240,4053
2020-11-27,Alaska,02,30612,672,113,0,990773,21200,29554,662,961219,20538
2020-11-27,Arizona,04,318695,4369,6588,20,2213289,25101,318638,4312,1894651,20789
2020-11-27,Arkansas,05,153677,1052,2436,0,1674767,8940,153677,1052,1521090,7888
2020-11-27,California,06,1193071,16934,19100,75,23315918,219173,1171324,12635,22144594,206538
2020-11-27,Colorado,08,222544,4889,2998,21,1717407,17762,220953,4270,1496454,13492
2020-11-27,Connecticut,09,112581,3429,4961,35,3154617,71504,112581,3429,3042036,68075
2020-11-27,Delaware,10,34170,591,763,2,416059,3647,34170,591,381889,3056
2020-11-27,District of Columbia,11,20937,201,677,0,672439,9238,20937,201,651502,9037
2020-11-27,Florida,12,979012,17344,18362,109,7130836,102201,963751,16795,6167085,85406
2020-11-27,Georgia,13,447942,2738,9130,41,4258413,31722,416303,2394,3842110,29328
2020-11-27,Guam,66,7737,20,113,1,83201,449,6768,20,76433,429
2020-11-27,Hawaii,15,17796,118,238,3,313159,125,18006,125,295153,0
2020-11-27,Idaho,16,99148,2141,914,13,478886,0,96503,0,382383,0
2020-11-27,Illinois,17,706123,7759,12705,96,10289223,77130,705063,7574,9584160,69556
2020-11-27,Indiana,18,327234,5639,5594,33,2162110,16383,324537,5643,1837573,10740
2020-11-27,Iowa,19,225065,1742,2360,11,1060478,2760,198222,1136,862256,1624
2020-11-27,Kansas,20,155245,4723,1529,26,812424,13239,153021,5224,659403,8015
2020-11-27,Kentucky,21,174684,4603,2009,26,2558059,49210,171755,5616,2386304,43594
2020-11-27,Louisiana,22,230602,4964,6391,41,3378743,68038,230602,4964,3148141,63074
2020-11-27,Maine,23,11265,0,190,0,841328,0,11265,0,830063,0
2020-11-27,Maryland,24,193205,2570,4569,22,2305545,18378,192858,2378,2112687,16000
2020-11-27,Massachusetts,25,219252,4658,10635,31,3309180,33771,219252,4658,3089928,29113
2020-11-27,Michigan,26,369022,16680,9352,183,6513757,121194,369801,17368,6143956,103826
2020-11-27,Minnesota,27,295060,5698,3535,101,2426221,23031,295001,5698,2131220,17333
2020-11-27,Mississippi,28,148387,1005,3769,6,1095659,1005,148387,1005,947272,0
2020-11-27,Missouri,29,304234,3409,3943,11,1791413,8696,290536,3273,1500877,5423
2020-11-27,Montana,30,59796,114,658,0,642514,10587,59796,114,582718,10473
2020-11-27,Nebraska,31,124068,1116,1014,6,731641,8631,122952,2876,608689,5755
2020-11-27,Nevada,32,147145,2351,2103,10,965745,6552,146317,1536,819428,5016
2020-11-27,New Hampshire,33,19313,537,517,3,413290,2243,19313,537,393977,1706
2020-11-27,New Jersey,34,328302,4095,16942,17,5835907,4095,326473,4095,5509434,0
2020-11-27,New Mexico,35,91852,2056,1504,35,1521747,16891,91852,2056,1429895,14835
2020-11-27,New York,36,633140,8179,34004,45,18962849,219442,628375,8176,18334474,211266
2020-11-27,North Carolina,37,355664,7516,5240,63,5192822,108253,354514,8008,4838308,100245
2020-11-27,North Dakota,38,77238,790,908,5,346071,1317,77232,790,268839,527
2020-11-27,Northern Mariana Islands,69,104,0,2,0,16851,0,104,0,16747,0
2020-11-27,Ohio,39,399808,17065,6346,72,5919541,62653,399808,17065,5519733,45588
2020-11-27,Oklahoma,40,187567,3225,1704,24,2061035,3225,187567,3225,1873468,0
2020-11-27,Oregon,41,70833,827,890,6,1031436,773,70832,826,960604,-53
2020-11-27,Pennsylvania,42,349360,8362,10295,24,3129689,28206,343614,7360,2786075,20846
2020-11-27,Puerto Rico,72,84293,1452,1076,7,356650,1452,50678,1452,305972,0
2020-11-27,Rhode Island,44,53954,1637,1346,11,520851,1996,53954,463,466897,1533
2020-11-27,South Carolina,45,213120,2215,4346,29,2339037,30874,213120,2215,2125917,28659
2020-11-27,South Dakota,46,78280,2138,888,39,323484,5130,78280,2138,245204,2992
2020-11-27,Tennessee,47,349506,4135,4475,7,4426634,34917,356716,4340,4069918,30577
2020-11-27,Texas,48,1228649,4753,21762,53,10498559,112365,1147045,3429,9351514,108936
2020-11-27,Utah,49,190044,5662,849,15,1318355,20482,190044,6142,1128311,14340
2020-11-27,Vermont,50,4005,178,67,3,220964,1067,4115,98,216849,969
2020-11-27,Virgin Islands,78,1521,0,23,0,28036,0,1521,0,26515,0
2020-11-27,Virginia,51,230444,1544,4044,15,3294522,33135,230444,1544,3064078,31591
2020-11-27,Washington,53,165230,3319,2828,3,2907013,0,153906,0,2753107,0
2020-11-27,West Virginia,54,45046,866,712,0,1102054,16955,45046,866,1057008,16089
2020-11-27,Wisconsin,55,399557,1453,3444,13,2533226,9920,399526,1422,2133700,8498
2020-11-27,Wyoming,56,31773,1012,215,0,170677,8128,31773,1012,138904,7116
2020-11-28,Alabama,01,244993,2119,3572,0,1614785,6671,244993,2119,1369792,4552
2020-11-28,Alaska,02,31279,667,115,2,999054,8281,30204,650,968850,7631
2020-11-28,Arizona,04,322774,4079,6624,36,2227793,14504,322774,4136,1905019,10368
2020-11-28,Arkansas,05,155026,1349,2449,13,1684540,9773,155026,1349,1529514,8424
2020-11-28,California,06,1206278,13207,19132,32,23573182,257264,1183320,11996,22389862,245268
2020-11-28,Colorado,08,226567,4023,3012,14,1735542,18135,225283,4330,1510259,13805
2020-11-28,Connecticut,09,112581,0,4961,0,3154617,0,112581,0,3042036,0
2020-11-28,Delaware,10,34670,500,763,0,419244,3185,34670,500,384574,2685
2020-11-28,District of Columbia,11,21308,371,678,1,685338,12899,21308,371,664030,12528
2020-11-28,Florida,12,985289,6277,18441,79,7167102,36266,969813,6062,6197289,30204
2020-11-28,Georgia,13,450627,2685,9173,43,4289024,30611,418936,2633,3870088,27978
2020-11-28,Guam,66,7751,14,113,0,83215,14,6782,14,76433,0
2020-11-28,Hawaii,15,17871,75,238,0,313235,76,18082,76,295153,0
2020-11-28,Idaho,16,99984,836,919,5,483659,4773,98500,1997,385159,2776
2020-11-28,Illinois,17,714070,7947,12852,147,10368278,79055,712936,7873,9655342,71182
2020-11-28,Indiana,18,331725,4491,5663,69,2174751,12641,329008,4471,1845743,8170
2020-11-28,Iowa,19,227181,2116,2375,15,1063681,3203,199683,1461,863998,1742
2020-11-28,Kansas,20,155265,20,1529,0,812424,0,153021,0,659403,0
2020-11-28,Kentucky,21,177453,2769,2028,19,2578361,20302,174182,2427,2404179,17875
2020-11-28,Louisiana,22,230602,0,6391,0,3378743,0,230602,0,3148141,0
2020-11-28,Maine,23,11288,23,191,1,841351,23,11288,23,830063,0
2020-11-28,Maryland,24,194603,1398,4602,33,2317570,12025,194448,1590,2123122,10435
2020-11-28,Massachusetts,25,222469,3217,10676,41,3327434,18254,222469,3217,3104965,15037
2020-11-28,Michigan,26,377279,8257,9461,109,6574441,60684,378152,8351,6196289,52333
2020-11-28,Minnesota,27,304082,9022,3580,45,2474553,48332,304023,9022,2170530,39310
2020-11-28,Mississippi,28,149940,1553,3779,10,1097212,1553,149940,1553,947272,0
2020-11-28,Missouri,29,306526,2292,3950,7,1797533,6120,292740,2204,1504793,3916
2020-11-28,Montana,30,60845,1049,670,12,645393,2879,60845,1049,584548,1830
2020-11-28,Nebraska,31,125323,1255,1018,4,734480,2839,124066,1114,610414,1725
2020-11-28,Nevada,32,149613,2468,2123,20,973116,7371,149229,2912,823887,4459
2020-11-28,New Hampshire,33,20002,689,523,6,416158,2868,20002,689,396156,2179
2020-11-28,New Jersey,34,332104,3802,16965,23,5943584,107677,330275,3802,5613309,103875
2020-11-28,New Mexico,35,93982,2130,1527,23,1536202,14455,93982,2130,1442220,12325
2020-11-28,New York,36,639200,6060,34049,45,19115204,152355,634438,6063,18480766,146292
2020-11-28,North Carolina,37,358654,2990,5249,9,5244854,52032,357958,3444,4886896,48588
2020-11-28,North Dakota,38,77941,703,921,13,347381,1310,77935,703,269446,607
2020-11-28,Northern Mariana Islands,69,104,0,2,0,16851,0,104,0,16747,0
2020-11-28,Ohio,39,406703,6895,6378,32,6028709,109168,406703,6895,5622006,102273
2020-11-28,Oklahoma,40,193824,6257,1717,13,2067292,6257,193824,6257,1873468,0
2020-11-28,Oregon,41,72506,1673,899,9,1033150,1714,72506,1674,960644,40
2020-11-28,Pennsylvania,42,356243,6883,10337,42,3156131,26442,351667,8053,2804464,18389
2020-11-28,Puerto Rico,72,85196,903,1083,7,357553,903,51581,903,305972,0
2020-11-28,Rhode Island,44,53954,0,1346,0,523428,2577,55017,1063,468411,1514
2020-11-28,South Carolina,45,214911,1791,4346,0,2370233,31196,214911,1791,2155322,29405
2020-11-28,South Dakota,46,79099,819,942,54,325376,1892,79099,819,246277,1073
2020-11-28,Tennessee,47,355885,6379,4489,14,4470321,43687,363466,6750,4106855,36937
2020-11-28,Texas,48,1234675,6026,21847,85,10636849,138290,1151069,4024,9485780,134266
2020-11-28,Utah,49,192087,2043,863,14,1325093,6738,192087,2043,1133006,4695
2020-11-28,Vermont,50,4033,28,67,0,221496,532,4155,40,217341,492
2020-11-28,Virgin Islands,78,1540,19,23,0,28272,236,1538,17,26734,219
2020-11-28,Virginia,51,233617,3173,4054,10,3320656,26134,233617,3173,3087039,22961
2020-11-28,Washington,53,166736,1506,2828,0,2911274,4261,158167,4261,2753107,0
2020-11-28,West Virginia,54,45845,799,718,6,1115015,12961,45845,799,1069170,12162
2020-11-28,Wisconsin,55,404999,5442,3474,30,2543109,9883,404999,5473,2138110,4410
2020-11-28,Wyoming,56,31929,156,215,0,170833,156,31929,156,138904,0
2020-11-29,Alabama,01,247229,2236,3577,5,1620999,6214,247229,2236,1373770,3978
2020-11-29,Alaska,02,31896,617,115,0,1006180,7126,30816,612,975364,6514
2020-11-29,Arizona,04,325995,3221,6635,11,2246314,18521,325995,3221,1920319,15300
2020-11-29,Arkansas,05,156247,1221,2470,21,1694985,10445,156247,1221,1538738,9224
2020-11-29,California,06,1219496,13218,19151,19,23807501,234319,1198934,15614,22608567,218705
2020-11-29,Colorado,08,230057,3490,3025,13,1748078,12536,228772,3489,1519306,9047
2020-11-29,Connecticut,09,112581,0,4961,0,3154617,0,112581,0,3042036,0
2020-11-29,Delaware,10,35251,581,770,7,422384,3140,35251,581,387133,2559
2020-11-29,District of Columbia,11,21448,140,680,2,690342,5004,21448,140,668894,4864
2020-11-29,Florida,12,992652,7363,18499,58,7204335,37233,976944,7131,6227391,30102
2020-11-29,Georgia,13,452322,1695,9189,16,4302927,13903,420601,1665,3882326,12238
2020-11-29,Guam,66,7787,36,113,0,83251,36,6818,36,76433,0
2020-11-29,Hawaii,15,17925,54,242,4,313291,56,18138,56,295153,0
2020-11-29,Idaho,16,100758,774,925,6,486067,2408,99660,1160,386407,1248
2020-11-29,Illinois,17,721487,7417,12895,43,10431018,62740,720114,7178,9710904,55562
2020-11-29,Indiana,18,336027,4302,5685,22,2188928,14177,333312,4304,1855616,9873
2020-11-29,Iowa,19,228690,1509,2399,24,1067985,4304,201267,1584,866718,2720
2020-11-29,Kansas,20,155377,112,1529,0,812424,0,153021,0,659403,0
2020-11-29,Kentucky,21,180164,2711,2039,11,2581104,2743,176925,2743,2404179,0
2020-11-29,Louisiana,22,232245,1643,6407,16,3402706,23963,232245,1643,3170461,22320
2020-11-29,Maine,23,11508,220,191,0,841571,220,11508,220,830063,0
2020-11-29,Maryland,24,196727,2124,4625,23,2332839,15269,196447,1999,2136392,13270
2020-11-29,Massachusetts,25,224964,2495,10722,46,3345687,18253,224964,2495,3120723,15758
2020-11-29,Michigan,26,377596,317,9461,0,6574441,0,378152,0,6196289,0
2020-11-29,Minnesota,27,313028,8946,3637,57,2519056,44503,312969,8946,2206087,35557
2020-11-29,Mississippi,28,151785,1845,3806,27,1099057,1845,151785,1845,947272,0
2020-11-29,Missouri,29,309420,2894,3956,6,1805036,7503,295933,3193,1509103,4310
2020-11-29,Montana,30,61801,956,672,2,650223,4830,61801,956,588422,3874
2020-11-29,Nebraska,31,126491,1168,1022,4,737852,3372,125323,1257,612529,2115
2020-11-29,Nevada,32,150825,1212,2140,17,975296,2180,150527,1298,824769,882
2020-11-29,New Hampshire,33,20480,478,526,3,418976,2818,20480,478,398496,2340
2020-11-29,New Jersey,34,335943,3839,16978,13,5947423,3839,334114,3839,5613309,0
2020-11-29,New Mexico,35,95417,1435,1540,13,1547171,10969,95417,1435,1451754,9534
2020-11-29,New York,36,645932,6732,34101,52,19272524,157320,641161,6723,18631363,150597
2020-11-29,North Carolina,37,362124,3470,5279,30,5286488,41634,361778,3820,4924710,37814
2020-11-29,North Dakota,38,78664,723,926,5,348939,1558,78658,723,270281,835
2020-11-29,Northern Mariana Islands,69,104,0,2,0,16851,0,104,0,16747,0
2020-11-29,Ohio,39,414432,7729,6399,21,6083485,54776,414432,7729,5669053,47047
2020-11-29,Oklahoma,40,195545,1721,1736,19,2069013,1721,195545,1721,1873468,0
2020-11-29,Oregon,41,74120,1614,907,8,1042806,9656,74120,1614,968686,8042
2020-11-29,Pennsylvania,42,361387,5144,10406,69,3176073,19942,357196,5529,2818877,14413
2020-11-29,Puerto Rico,72,85317,121,1094,11,357674,121,51702,121,305972,0
2020-11-29,Rhode Island,44,53954,0,1346,0,527158,3730,56072,1055,471086,2675
2020-11-29,South Carolina,45,216129,1218,4353,7,2386587,16354,216129,1218,2170458,15136
2020-11-29,South Dakota,46,79900,801,943,1,327744,2368,79900,801,247844,1567
2020-11-29,Tennessee,47,358809,2924,4500,11,4489451,19130,366518,3052,4122933,16078
2020-11-29,Texas,48,1247065,12390,21900,53,10703677,66828,1157273,6204,9546404,60624
2020-11-29,Utah,49,193809,1722,868,5,1330584,5491,193809,1722,1136775,3769
2020-11-29,Vermont,50,4100,67,67,0,222914,1418,4225,70,218689,1348
2020-11-29,Virgin Islands,78,1544,4,23,0,28327,55,1544,6,26783,49
2020-11-29,Virginia,51,235942,2325,4058,4,3335502,14846,235942,2325,3099560,12521
2020-11-29,Washington,53,168333,1597,2828,0,2913741,2467,160634,2467,2753107,0
2020-11-29,West Virginia,54,46997,1152,729,11,1129226,14211,46997,1152,1082229,13059
2020-11-29,Wisconsin,55,409054,4055,3496,22,2552844,9735,409054,4055,2143790,5680
2020-11-29,Wyoming,56,32489,560,215,0,171393,560,32489,560,138904,0
2020-11-30,Alabama,01,249524,2295,3578,1,1625848,4849,249524,2295,1376324,2554
2020-11-30,Alaska,02,32407,511,115,0,1011396,5216,31323,507,980073,4709
2020-11-30,Arizona,04,327046,1051,6640,5,2263766,17452,326817,822,1936949,16630
2020-11-30,Arkansas,05,157359,1112,2502,32,1702760,7775,157359,1112,1545401,6663
2020-11-30,California,06,1237192,17696,19209,58,24025171,217670,1212968,14034,22812203,203636
2020-11-30,Colorado,08,234502,4445,3060,35,1764249,16171,232905,4133,1531344,12038
2020-11-30,Connecticut,09,117295,4714,5020,59,3261454,106837,117295,4714,3144159,102123
2020-11-30,Delaware,10,35654,403,772,2,424342,1958,35654,403,388688,1555
2020-11-30,District of Columbia,11,21552,104,680,0,695256,4914,21552,104,673704,4810
2020-11-30,Florida,12,999311,6659,18596,97,7239802,35467,983370,6426,6256432,29041
2020-11-30,Georgia,13,454328,2006,9198,9,4314448,11521,422133,1532,3892315,9989
2020-11-30,Guam,66,7821,34,113,0,84419,1168,6852,34,77567,1134
2020-11-30,Hawaii,15,18006,81,242,0,313376,85,18223,85,295153,0
2020-11-30,Idaho,16,102158,1400,937,12,488090,2023,100484,824,387606,1199
2020-11-30,Illinois,17,727825,6338,13015,120,10497998,66980,726304,6190,9771694,60790
2020-11-30,Indiana,18,341694,5667,5723,38,2204581,15653,338977,5665,1865604,9988
2020-11-30,Iowa,19,230634,1944,2426,27,1070816,2831,202410,1143,868406,1688
2020-11-30,Kansas,20,160428,5051,1560,31,822884,10460,157446,4425,665438,6035
2020-11-30,Kentucky,21,183255,3091,2065,26,2613737,32633,179041,2116,2434696,30517
2020-11-30,Louisiana,22,232414,169,6420,13,3403719,1013,232414,169,3171305,844
2020-11-30,Maine,23,11757,249,194,3,875799,34228,11757,249,864042,33979
2020-11-30,Maryland,24,198710,1983,4641,16,2344909,12070,198370,1923,2146539,10147
2020-11-30,Massachusetts,25,226132,1168,10748,26,3353346,7659,226132,1168,3127214,6491
2020-11-30,Michigan,26,388364,10768,9565,104,6677336,102895,388942,10790,6288394,92105
2020-11-30,Minnesota,27,318822,5794,3652,15,2536343,17287,318763,5794,2217580,11493
2020-11-30,Mississippi,28,153270,1485,3807,1,1135665,36608,153270,1485,982395,35123
2020-11-30,Missouri,29,314981,5561,3981,25,1813693,8657,299762,3829,1513931,4828
2020-11-30,Montana,30,62256,455,684,12,656021,5798,62198,397,593823,5401
2020-11-30,Nebraska,31,128433,1942,1039,17,740367,2515,126466,1143,613901,1372
2020-11-30,Nevada,32,152726,1901,2149,9,979849,4553,152169,1642,827680,2911
2020-11-30,New Hampshire,33,20994,514,526,0,421261,2285,20994,514,400267,1771
2020-11-30,New Jersey,34,339133,3190,16993,15,6086496,139073,337304,3190,5749192,135883
2020-11-30,New Mexico,35,97095,1678,1568,28,1558291,11120,97095,1678,1461196,9442
2020-11-30,New York,36,652748,6816,34150,49,19421498,148974,647980,6819,18773518,142155
2020-11-30,North Carolina,37,364968,2844,5296,17,5316284,29796,364512,2734,4951772,27062
2020-11-30,North Dakota,38,79258,594,933,7,350217,1278,79252,594,270965,684
2020-11-30,Northern Mariana Islands,69,106,2,2,0,16853,2,106,2,16747,0
2020-11-30,Ohio,39,421063,6631,6429,30,6128597,45112,421063,6631,5707534,38481
2020-11-30,Oklahoma,40,197745,2200,1743,7,2071213,2200,197745,2200,1873468,0
2020-11-30,Oregon,41,75454,1334,919,12,1044117,1311,75431,1311,968686,0
2020-11-30,Pennsylvania,42,366971,5584,10439,33,3189513,13440,361464,4268,2828049,9172
2020-11-30,Puerto Rico,72,86160,843,1106,12,358517,843,52545,843,305972,0
2020-11-30,Rhode Island,44,56723,2769,1373,27,529884,2726,56723,651,473161,2075
2020-11-30,South Carolina,45,217487,1358,4381,28,2399463,12876,217487,1358,2181976,11518
2020-11-30,South Dakota,46,80464,564,946,3,328852,1108,80464,564,248388,544
2020-11-30,Tennessee,47,366412,7603,4546,46,4545436,55985,374493,7975,4170943,48010
2020-11-30,Texas,48,1262145,15080,21968,68,10761759,58082,1168111,10838,9593648,47244
2020-11-30,Utah,49,195744,1935,871,3,1335394,4810,195706,1897,1139688,2913
2020-11-30,Vermont,50,4172,72,69,2,223885,971,4296,71,219589,900
2020-11-30,Virgin Islands,78,1544,0,23,0,28327,0,1544,0,26783,0
2020-11-30,Virginia,51,237835,1893,4062,4,3352908,17406,237835,1893,3115073,15513
2020-11-30,Washington,53,172175,3842,2895,67,2915807,2066,162700,2066,2753107,0
2020-11-30,West Virginia,54,47842,845,735,6,1137951,8725,47842,845,1090109,7880
2020-11-30,Wisconsin,55,411730,2676,3504,8,2561726,8882,411730,2676,2149996,6206
2020-11-30,Wyoming,56,33305,816,215,0,174771,3378,33305,816,141466,2562
2020-12-01,Alabama,01,252900,3376,3638,60,1636705,10857,252900,3376,1383805,7481
2020-12-01,Alaska,02,32911,504,116,1,1018628,7232,31834,511,986794,6721
2020-12-01,Arizona,04,338254,11208,6692,52,2282215,18449,337139,10322,1945076,8127
2020-12-01,Arkansas,05,159309,1950,2512,10,1711564,8804,159309,1950,1552255,6854
2020-12-01,California,06,1253867,16675,19327,118,24161313,136142,1225189,12221,22936124,123921
2020-12-01,Colorado,08,238779,4277,3136,76,1778454,14205,237310,4405,1541144,9800
2020-12-01,Connecticut,09,118754,1459,5040,20,3286210,24756,118754,1459,3167456,23297
2020-12-01,Delaware,10,36343,689,777,5,427250,2908,36343,689,390907,2219
2020-12-01,District of Columbia,11,21685,133,685,5,697409,2153,21685,133,675724,2020
2020-12-01,Florida,12,1008158,8847,18678,82,7287819,48017,991910,8540,6295909,39477
2020-12-01,Georgia,13,458985,4657,9253,55,4338967,24519,424929,2796,3914038,21723
2020-12-01,Guam,66,7858,37,113,0,85038,619,6889,37,78149,582
2020-12-01,Hawaii,15,18049,43,242,0,313419,43,18266,43,295153,0
2020-12-01,Idaho,16,103642,1484,966,29,490103,2013,101698,1214,388405,799
2020-12-01,Illinois,17,740510,12685,13175,160,10614079,116081,738846,12542,9875233,103539
2020-12-01,Indiana,18,347097,5403,5864,141,2217258,12677,344373,5396,1872885,7281
2020-12-01,Iowa,19,233062,2428,2449,23,1072992,2176,203398,988,869594,1188
2020-12-01,Kansas,20,160718,290,1560,0,822884,0,157446,0,665438,0
2020-12-01,Kentucky,21,187285,4030,2097,32,2639892,26155,183168,4127,2456724,22028
2020-12-01,Louisiana,22,237740,5326,6455,35,3454451,50732,237740,5326,3216711,45406
2020-12-01,Maine,23,11976,219,214,20,881709,5910,11976,219,869733,5691
2020-12-01,Maryland,24,201479,2769,4673,32,2357711,12802,201135,2765,2156576,10037
2020-12-01,Massachusetts,25,229205,3073,10778,30,3371701,18355,229205,3073,3142496,15282
2020-12-01,Michigan,26,394838,6474,9758,193,6716589,39253,395453,6511,6321136,32742
2020-12-01,Minnesota,27,322371,3549,3674,22,2545927,9584,322312,3549,2223615,6035
2020-12-01,Mississippi,28,154411,1141,3836,29,1136806,1141,154411,1141,982395,0
2020-12-01,Missouri,29,317903,2922,4130,149,1819587,5894,302691,2929,1516896,2965
2020-12-01,Montana,30,63324,1068,700,16,660895,4874,63205,1007,597690,3867
2020-12-01,Nebraska,31,130212,1779,1086,47,744724,4357,128407,1941,616317,2416
2020-12-01,Nevada,32,155312,2586,2182,33,986756,6907,154867,2698,831889,4209
2020-12-01,New Hampshire,33,21766,772,528,2,424089,2828,21766,772,402323,2056
2020-12-01,New Jersey,34,343739,4606,17083,90,6091102,4606,341910,4606,5749192,0
2020-12-01,New Mexico,35,99419,2324,1589,21,1579759,21468,99419,2324,1480340,19144
2020-12-01,New York,36,660041,7293,34222,72,19568173,146675,655265,7285,18912908,139390
2020-12-01,North Carolina,37,368615,3647,5322,26,5344037,27753,367395,2883,4976642,24870
2020-12-01,North Dakota,38,79661,403,960,27,350838,621,79655,403,271183,218
2020-12-01,Northern Mariana Islands,69,106,0,2,0,17116,263,106,0,17010,263
2020-12-01,Ohio,39,430093,9030,6548,119,6182931,54334,430093,9030,5752838,45304
2020-12-01,Oklahoma,40,199482,1737,1758,15,2122950,51737,199482,1737,1923468,50000
2020-12-01,Oregon,41,76655,1201,938,19,2002330,958213,76654,1223,1925676,956990
2020-12-01,Pennsylvania,42,372688,5717,10614,175,3203585,14072,367140,5676,2836445,8396
2020-12-01,Puerto Rico,72,86935,775,1122,16,359292,775,53320,775,305972,0
2020-12-01,Rhode Island,44,57906,1183,1380,7,533713,3829,57906,1183,475807,2646
2020-12-01,South Carolina,45,218912,1425,4404,23,2417026,17563,218912,1425,2198114,16138
2020-12-01,South Dakota,46,80912,448,948,2,330533,1681,80912,448,249621,1233
2020-12-01,Tennessee,47,371980,5568,4584,38,4582233,36797,380186,5693,4202047,31104
2020-12-01,Texas,48,1275499,13354,22204,236,10870202,108443,1184250,16139,9685952,92304
2020-12-01,Utah,49,198260,2516,890,19,1342463,7069,198216,2510,1144247,4559
2020-12-01,Vermont,50,4239,67,72,3,225150,1265,4365,69,220785,1196
2020-12-01,Virgin Islands,78,1550,6,23,0,28578,251,1550,6,27028,245
2020-12-01,Virginia,51,240063,2228,4093,31,3368573,15665,240063,2228,3128510,13437
2020-12-01,Washington,53,174969,2794,2927,32,2918126,2319,165019,2319,2753107,0
2020-12-01,West Virginia,54,48818,976,758,23,1149027,11076,48818,976,1100209,10100
2020-12-01,Wisconsin,55,416365,4635,3628,124,2572775,11049,416365,4635,2156410,6414
2020-12-01,Wyoming,56,33805,500,230,15,175271,500,33805,500,141466,0
2020-12-02,Alabama,01,256828,3928,3711,73,1647179,10474,256828,3928,1390351,6546
2020-12-02,Alaska,02,33614,703,116,0,1024643,6015,32531,697,992112,5318
2020-12-02,Arizona,04,342925,4671,6755,63,2298866,16651,340979,3840,1957887,12811
2020-12-02,Arkansas,05,161521,2212,2522,10,1724082,12518,161521,2212,1562561,10306
2020-12-02,California,06,1272041,18174,19440,113,24299126,137813,1245948,20759,23053178,117054
2020-12-02,Colorado,08,243324,4545,3226,90,1789850,11396,241172,3862,1548678,7534
2020-12-02,Connecticut,09,121426,2672,5091,51,3327440,41230,121426,2672,3206014,38558
2020-12-02,Delaware,10,36698,355,779,2,428533,1283,36698,355,391835,928
2020-12-02,District of Columbia,11,21842,157,690,5,701485,4076,21842,157,679643,3919
2020-12-02,Florida,12,1018152,9994,18775,97,7338187,50368,1001800,9890,6336387,40478
2020-12-02,Georgia,13,464417,5432,9301,48,4362964,23997,428980,4051,3933984,19946
2020-12-02,Guam,66,7889,31,113,0,85486,448,6920,31,78566,417
2020-12-02,Hawaii,15,18117,68,242,0,313495,76,18342,76,295153,0
2020-12-02,Idaho,16,105250,1608,1002,36,493134,3031,103305,1607,389829,1424
2020-12-02,Illinois,17,750208,9698,13433,258,10699586,85507,748603,9757,9950983,75750
2020-12-02,Indiana,18,353722,6625,5973,109,2232102,14844,350970,6597,1881132,8247
2020-12-02,Iowa,19,236159,3097,2518,69,1078029,5037,205773,2375,872256,2662
2020-12-02,Kansas,20,164981,4263,1679,119,831182,8298,162061,4615,669121,3683
2020-12-02,Kentucky,21,191067,3782,2124,27,2652314,12422,186765,3597,2465549,8825
2020-12-02,Louisiana,22,241335,3595,6501,46,3518499,64048,241335,3595,3277164,60453
2020-12-02,Maine,23,12208,232,218,4,892341,10632,12208,232,880133,10400
2020-12-02,Maryland,24,203672,2193,4715,42,2371358,13647,203355,2220,2168003,11427
2020-12-02,Massachusetts,25,234232,5027,10824,46,3395423,23722,234232,5027,3161191,18695
2020-12-02,Michigan,26,402255,7417,9839,81,6762022,45433,402886,7433,6359136,38000
2020-12-02,Minnesota,27,327536,5165,3751,77,2563919,17992,327477,5165,2236442,12827
2020-12-02,Mississippi,28,156868,2457,3851,15,1139263,2457,156868,2457,982395,0
2020-12-02,Missouri,29,321411,3508,4185,55,1825375,5788,305370,2679,1520005,3109
2020-12-02,Montana,30,64399,1075,713,13,663581,2686,64340,1135,599241,1551
2020-12-02,Nebraska,31,132530,2318,1132,46,748366,3642,130194,1787,618172,1855
2020-12-02,Nevada,32,157586,2274,2225,43,991427,4671,156996,2129,834431,2542
2020-12-02,New Hampshire,33,22332,566,537,9,427816,3727,22332,566,405484,3161
2020-12-02,New Jersey,34,348042,4303,17145,62,6133587,42485,346206,4296,5787381,38189
2020-12-02,New Mexico,35,100963,1544,1629,40,1592222,12463,100963,1544,1491259,10919
2020-12-02,New York,36,669016,8975,34286,64,19761724,193551,664238,8973,19097486,184578
2020-12-02,North Carolina,37,372525,3910,5406,84,5378004,33967,371594,4199,5006410,29768
2020-12-02,North Dakota,38,80141,480,972,12,351652,814,80135,480,271517,334
2020-12-02,Northern Mariana Islands,69,106,0,2,0,17116,0,106,0,17010,0
2020-12-02,Ohio,39,437928,7835,6671,123,6217744,34813,437928,7835,5779816,26978
2020-12-02,Oklahoma,40,202341,2859,1812,54,2143079,20129,202341,2859,1940738,17270
2020-12-02,Oregon,41,78206,1551,962,24,2021942,19612,78160,1506,1943782,18106
2020-12-02,Pennsylvania,42,381342,8654,10803,189,3228055,24470,375431,8291,2852624,16179
2020-12-02,Puerto Rico,72,87323,388,1144,22,359680,388,53708,388,305972,0
2020-12-02,Rhode Island,44,59005,1099,1391,11,536906,3193,59005,1099,477901,2094
2020-12-02,South Carolina,45,220835,1923,4444,40,2432901,15875,220835,1923,2212066,13952
2020-12-02,South Dakota,46,82203,1291,995,47,332540,2007,82203,1291,250337,716
2020-12-02,Tennessee,47,375995,4015,4635,51,4605389,23156,384285,4099,4221104,19057
2020-12-02,Texas,48,1293212,17713,22422,218,10932546,62344,1200674,16424,9731872,45920
2020-12-02,Utah,49,202220,3960,906,16,1351342,8879,202220,4004,1149122,4875
2020-12-02,Vermont,50,4461,222,74,2,225930,780,4466,101,221464,679
2020-12-02,Virgin Islands,78,1589,39,23,0,28810,232,1563,13,27247,219
2020-12-02,Virginia,51,242480,2417,4113,20,3378990,10417,242480,2417,3136510,8000
2020-12-02,Washington,53,177929,2960,2979,52,2920323,2197,167216,2197,2753107,0
2020-12-02,West Virginia,54,49905,1087,778,20,1159681,10654,49905,1087,1109776,9567
2020-12-02,Wisconsin,55,420930,4565,3715,87,2583546,10771,420930,4565,2162616,6206
2020-12-02,Wyoming,56,34507,702,230,0,175973,702,34507,702,141466,0
2020-12-03,Alabama,01,260359,3531,3776,65,1660369,13190,260359,3531,1400010,9659
2020-12-03,Alaska,02,34377,763,124,8,1040505,15862,33291,760,1007214,15102
2020-12-03,Arizona,04,348134,5209,6834,79,2316257,17391,346421,5442,1969836,11949
2020-12-03,Arkansas,05,164310,2789,2555,33,1740989,16907,164310,2789,1576679,14118
2020-12-03,California,06,1293887,21846,19586,146,24474642,175516,1264539,18591,23210103,156925
2020-12-03,Colorado,08,248779,5455,3335,109,1808065,18215,247209,6037,1560856,12178
2020-12-03,Connecticut,09,126177,4751,5111,20,3394113,66673,126177,4751,3267936,61922
2020-12-03,Delaware,10,37456,758,779,0,431760,3227,37456,758,394304,2469
2020-12-03,District of Columbia,11,22164,322,692,2,709991,8506,22164,322,687827,8184
2020-12-03,Florida,12,1029022,10870,18873,98,7388737,50550,1012456,10656,6376281,39894
2020-12-03,Georgia,13,469955,5538,9377,76,4396665,33701,433353,4373,3963312,29328
2020-12-03,Guam,66,7911,22,113,0,85958,472,6942,22,79016,450
2020-12-03,Hawaii,15,18256,139,244,2,313637,142,18484,142,295153,0
2020-12-03,Idaho,16,106882,1632,1023,21,497009,3875,104734,1429,392275,2446
2020-12-03,Illinois,17,761209,11001,13650,217,10806364,106778,759562,10959,10046802,95819
2020-12-03,Indiana,18,362182,8460,6033,60,2252864,20762,359430,8460,1893434,12302
2020-12-03,Iowa,19,238722,2563,2603,85,1083485,5456,207969,2196,875516,3260
2020-12-03,Kansas,20,165613,632,1679,0,831182,0,162061,0,669121,0
2020-12-03,Kentucky,21,194851,3784,2185,61,2721444,69130,190601,3836,2530843,65294
2020-12-03,Louisiana,22,244078,2743,6524,23,3541901,23402,244078,2743,3297823,20659
2020-12-03,Maine,23,12554,346,220,2,901836,9495,12554,346,889282,9149
2020-12-03,Maryland,24,205716,2044,4764,49,2383341,11983,205399,2044,2177942,9939
2020-12-03,Massachusetts,25,240907,6675,10874,50,3427846,32423,240907,6675,3186939,25748
2020-12-03,Michigan,26,410379,8124,10031,192,6831799,69777,410843,7957,6420956,61820
2020-12-03,Minnesota,27,333685,6149,3843,92,2584374,20455,333626,6149,2250748,14306
2020-12-03,Mississippi,28,159036,2168,3879,28,1141431,2168,159036,2168,982395,0
2020-12-03,Missouri,29,325519,4108,4274,89,1834404,9029,309368,3998,1525036,5031
2020-12-03,Montana,30,65242,843,723,10,669081,5500,65122,782,603959,4718
2020-12-03,Nebraska,31,134710,2180,1174,42,752981,4615,132530,2336,620451,2279
2020-12-03,Nevada,32,160317,2731,2259,34,999188,7761,159532,2536,839656,5225
2020-12-03,New Hampshire,33,22925,593,544,7,431027,3211,22925,593,408102,2618
2020-12-03,New Jersey,34,352835,4793,17209,64,6176836,43249,350999,4793,5825837,38456
2020-12-03,New Mexico,35,102873,1910,1673,44,1604914,12692,102862,1899,1502052,10793
2020-12-03,New York,36,678869,9853,34346,60,19965164,203440,674093,9855,19291071,193585
2020-12-03,North Carolina,37,378370,5845,5454,48,5432699,54695,377231,5637,5055468,49058
2020-12-03,North Dakota,38,81111,970,983,11,353683,2031,81105,970,272578,1061
2020-12-03,Northern Mariana Islands,69,106,0,2,0,17116,0,106,0,17010,0
2020-12-03,Ohio,39,446859,8931,6753,82,6270788,53044,446849,8921,5823939,44123
2020-12-03,Oklahoma,40,204048,1707,1836,24,2161489,18410,204048,1707,1957441,16703
2020-12-03,Oregon,41,79294,1088,974,12,2043324,21382,79263,1103,1964061,20279
2020-12-03,Pennsylvania,42,392610,11268,11008,205,3259394,31339,386837,11406,2872557,19933
2020-12-03,Puerto Rico,72,87720,397,1155,11,360077,397,54105,397,305972,0
2020-12-03,Rhode Island,44,60722,1717,1400,9,541476,4570,60722,1717,480754,2853
2020-12-03,South Carolina,45,223063,2228,4466,22,2449100,16199,223063,2228,2226037,13971
2020-12-03,South Dakota,46,83348,1145,1033,38,334697,2157,83348,1145,251349,1012
2020-12-03,Tennessee,47,379679,3684,4727,92,4625661,20272,388252,3967,4237409,16305
2020-12-03,Texas,48,1310534,17322,22645,223,11017447,84901,1215113,14439,9802334,70462
2020-12-03,Utah,49,206255,4035,918,12,1361891,10549,206165,3945,1155726,6604
2020-12-03,Vermont,50,4642,181,75,1,227768,1838,4690,224,223078,1614
2020-12-03,Virgin Islands,78,1589,0,23,0,29009,199,1589,26,27420,173
2020-12-03,Virginia,51,244503,2023,4147,34,3389736,10746,244503,2023,3145233,8723
2020-12-03,Washington,53,180125,2196,3040,61,2923449,3126,170342,3126,2753107,0
2020-12-03,West Virginia,54,51025,1120,789,11,1171602,11921,51025,1120,1120577,10801
2020-12-03,Wisconsin,55,426534,5604,3781,66,2596504,12958,426534,5604,2169970,7354
2020-12-03,Wyoming,56,35078,571,257,27,178355,2382,35078,571,143277,1811
2020-12-04,Alabama,01,264199,3840,3831,55,1671498,11129,264199,3840,1407299,7289
2020-12-04,Alaska,02,35138,761,135,11,1050369,9864,34041,750,1016328,9114
2020-12-04,Arizona,04,355054,6920,6885,51,2338378,22121,352101,5680,1986277,16441
2020-12-04,Arkansas,05,167137,2827,2586,31,1756913,15924,167137,2827,1589776,13097
2020-12-04,California,06,1318139,24252,19791,205,24675478,200836,1286557,22018,23388921,178818
2020-12-04,Colorado,08,252960,4181,3375,40,1826441,18376,252222,5013,1574219,13363
2020-12-04,Connecticut,09,127715,1538,5146,35,3422098,27985,127715,1538,3294383,26447
2020-12-04,Delaware,10,38398,942,782,3,435067,3307,38398,942,396669,2365
2020-12-04,District of Columbia,11,22480,316,693,1,718242,8251,22480,316,695762,7935
2020-12-04,Florida,12,1039199,10177,18993,120,7444184,55447,1022354,9898,6421830,45549
2020-12-04,Georgia,13,476181,6226,9443,66,4435020,38355,438300,4947,3996720,33408
2020-12-04,Guam,66,7928,17,114,1,86530,572,6959,17,79571,555
2020-12-04,Hawaii,15,18373,117,254,10,313758,121,18605,121,295153,0
2020-12-04,Idaho,16,108741,1859,1037,14,500908,3899,106455,1721,394453,2178
2020-12-04,Illinois,17,771696,10487,13808,158,10918998,112634,770088,10526,10148910,102108
2020-12-04,Indiana,18,370091,7909,6122,89,2272182,19318,367329,7899,1904853,11419
2020-12-04,Iowa,19,241531,2809,2665,62,1089561,6076,210236,2267,879325,3809
2020-12-04,Kansas,20,171513,5900,1786,107,845186,14004,168295,6234,676891,7770
2020-12-04,Kentucky,21,198506,3655,2216,31,2733708,12264,194193,3592,2539515,8672
2020-12-04,Louisiana,22,247177,3099,6548,24,3566534,24633,247177,3099,3319357,21534
2020-12-04,Maine,23,12844,290,224,4,913676,11840,12844,290,900832,11550
2020-12-04,Maryland,24,209512,3796,4790,26,2403287,19946,209191,3792,2194096,16154
2020-12-04,Massachusetts,25,246398,5491,10910,36,3454355,26509,246398,5491,3207957,21018
2020-12-04,Michigan,26,419704,9325,10113,82,6900160,68361,420268,9425,6479892,58936
2020-12-04,Minnesota,27,339032,5347,3904,61,2608190,23816,338973,5347,2269217,18469
2020-12-04,Mississippi,28,161516,2480,3916,37,1143911,2480,161516,2480,982395,0
2020-12-04,Missouri,29,330445,4926,4375,101,1844062,9658,313421,4053,1530641,5605
2020-12-04,Montana,30,66494,1252,728,5,675262,6181,66436,1314,608826,4867
2020-12-04,Nebraska,31,136349,1639,1199,25,757832,4851,134710,2180,623122,2671
2020-12-04,Nevada,32,163065,2748,2276,17,1004655,5467,162434,2902,842221,2565
2020-12-04,New Hampshire,33,23690,765,552,8,433764,2737,23690,765,410074,1972
2020-12-04,New Jersey,34,358498,5663,17255,46,6182499,5663,356662,5663,5825837,0
2020-12-04,New Mexico,35,104935,2062,1706,33,1620383,15469,104935,2073,1515448,13396
2020-12-04,New York,36,690143,11274,34409,63,20173461,208297,685364,11271,19488097,197026
2020-12-04,North Carolina,37,384165,5795,5505,51,5485287,52588,382534,5303,5102753,47285
2020-12-04,North Dakota,38,81955,844,995,12,355196,1513,81949,844,273247,669
2020-12-04,Northern Mariana Islands,69,106,0,2,0,17116,0,106,0,17010,0
2020-12-04,Ohio,39,456963,10104,6882,129,6349442,78654,456963,10114,5892479,68540
2020-12-04,Oklahoma,40,208875,4827,1860,24,2191644,30155,208875,4827,1982769,25328
2020-12-04,Oregon,41,81441,2147,1004,30,2087054,43730,81437,2174,2005617,41556
2020-12-04,Pennsylvania,42,404699,12089,11189,181,3291921,32527,398600,11763,2893321,20764
2020-12-04,Puerto Rico,72,88212,492,1172,17,360569,492,54597,492,305972,0
2020-12-04,Rhode Island,44,62137,1415,1413,13,545059,3583,62137,1415,482922,2168
2020-12-04,South Carolina,45,226013,2950,4496,30,2474899,25799,226013,2950,2248886,22849
2020-12-04,South Dakota,46,84398,1050,1064,31,336512,1815,84398,1050,252114,765
2020-12-04,Tennessee,47,383829,4150,4822,95,4651344,25683,392608,4356,4258736,21327
2020-12-04,Texas,48,1322711,12177,22890,245,11111036,93589,1228812,13699,9882224,79890
2020-12-04,Utah,49,209258,3003,926,8,1374502,12611,209170,3005,1165332,9606
2020-12-04,Vermont,50,4763,121,77,2,230109,2341,4763,73,225346,2268
2020-12-04,Virgin Islands,78,1613,24,23,0,29115,106,1613,24,27502,82
2020-12-04,Virginia,51,247380,2877,4160,13,3416416,26680,247380,2877,3169036,23803
2020-12-04,Washington,53,182758,2633,3062,22,2925544,2095,172437,2095,2753107,0
2020-12-04,West Virginia,54,52172,1147,799,10,1188605,17003,52172,1147,1136433,15856
2020-12-04,Wisconsin,55,432217,5683,3847,66,2612527,16023,432207,5673,2180320,10350
2020-12-04,Wyoming,56,35737,659,257,0,180313,1958,35737,659,144576,1299
2020-12-05,Alabama,01,267589,3390,3877,46,1682946,11448,267589,3390,1415357,8058
2020-12-05,Alaska,02,36083,945,136,1,1067231,16862,34963,922,1032268,15940
2020-12-05,Arizona,04,361186,6132,6940,55,2362052,23674,358900,6799,2003152,16875
2020-12-05,Arkansas,05,169382,2245,2620,34,1771117,14204,169382,2245,1601735,11959
2020-12-05,California,06,1343145,25006,19876,85,24901975,226497,1311625,25068,23590350,201429
2020-12-05,Colorado,08,258124,5164,3415,40,1831566,5125,257347,5125,1574219,0
2020-12-05,Connecticut,09,127715,0,5146,0,3422098,0,127715,0,3294383,0
2020-12-05,Delaware,10,39096,698,782,0,437610,2543,39096,698,398514,1845
2020-12-05,District of Columbia,11,22872,392,695,2,727387,9145,22872,392,704515,8753
2020-12-05,Florida,12,1049630,10431,19083,90,7496592,52408,1032552,10198,6464040,42210
2020-12-05,Georgia,13,481126,4945,9506,63,4466200,31180,442017,3717,4024183,27463
2020-12-05,Guam,66,7946,18,114,0,86548,18,6977,18,79571,0
2020-12-05,Hawaii,15,18484,111,259,5,313891,133,18738,133,295153,0
2020-12-05,Idaho,16,109764,1023,1037,0,504583,3675,108366,1911,396217,1764
2020-12-05,Illinois,17,781441,9745,14028,220,11021676,102678,779975,9887,10241701,92791
2020-12-05,Indiana,18,377790,7699,6207,85,2292178,19996,375019,7690,1917159,12306
2020-12-05,Iowa,19,243385,1854,2682,17,1094502,4941,211891,1655,882611,3286
2020-12-05,Kansas,20,171626,113,1786,0,845186,0,168295,0,676891,0
2020-12-05,Kentucky,21,202135,3629,2241,25,2766608,32900,198065,3872,2568543,29028
2020-12-05,Louisiana,22,247177,0,6548,0,3566534,0,247177,0,3319357,0
2020-12-05,Maine,23,13127,283,227,3,913959,283,13127,283,900832,0
2020-12-05,Maryland,24,212545,3033,4820,30,2423180,19893,212384,3193,2210796,16700
2020-12-05,Massachusetts,25,252017,5619,10953,43,3482924,28569,252017,5619,3230907,22950
2020-12-05,Michigan,26,425776,6072,10313,200,6965058,64898,426576,6308,6538482,58590
2020-12-05,Minnesota,27,345340,6308,3979,75,2626659,18469,345281,6308,2281378,12161
2020-12-05,Mississippi,28,163458,1942,3949,33,1145853,1942,163458,1942,982395,0
2020-12-05,Missouri,29,334637,4192,4412,37,1855990,11928,318422,5001,1537568,6927
2020-12-05,Montana,30,67092,598,734,6,682583,7321,67069,633,615514,6688
2020-12-05,Nebraska,31,138568,2219,1202,3,761879,4047,136325,1615,625554,2432
2020-12-05,Nevada,32,166187,3122,2309,33,1014896,10241,165628,3194,849268,7047
2020-12-05,New Hampshire,33,24138,448,559,7,437553,3789,24138,448,413415,3341
2020-12-05,New Jersey,34,363822,5324,17306,51,6280783,98284,361986,5324,5918797,92960
2020-12-05,New Mexico,35,106856,1921,1738,32,1634917,14534,106856,1921,1528061,12613
2020-12-05,New York,36,700902,10759,34488,79,20388862,215401,696125,10761,19692737,204640
2020-12-05,North Carolina,37,388760,4595,5547,42,5546614,61327,388552,6018,5158062,55309
2020-12-05,North Dakota,38,82510,555,1013,18,356518,1322,82504,555,274014,767
2020-12-05,Northern Mariana Islands,69,106,0,2,0,17116,0,106,0,17010,0
2020-12-05,Ohio,39,467432,10469,6947,65,6416665,67223,467432,10469,5949233,56754
2020-12-05,Oklahoma,40,213245,4370,1874,14,2222074,30430,213245,4370,2008829,26060
2020-12-05,Oregon,41,83243,1802,1027,23,2088860,1806,83243,1806,2005617,0
2020-12-05,Pennsylvania,42,416073,11374,11331,142,3323124,31203,411484,12884,2911640,18319
2020-12-05,Puerto Rico,72,89147,935,1184,12,361504,935,55532,935,305972,0
2020-12-05,Rhode Island,44,62137,0,1413,0,545059,0,62137,0,482922,0
2020-12-05,South Carolina,45,229235,3222,4517,21,2503921,29022,229235,3222,2274686,25800
2020-12-05,South Dakota,46,85304,906,1091,27,338369,1857,85304,906,253065,951
2020-12-05,Tennessee,47,388500,4671,4851,29,4675056,23712,397522,4914,4277534,18798
2020-12-05,Texas,48,1333809,11098,23111,221,11242753,131717,1240750,11938,10002003,119779
2020-12-05,Utah,49,212844,3586,939,13,1386715,12213,212844,3674,1173871,8539
2020-12-05,Vermont,50,4894,131,79,2,231751,1642,4894,131,226857,1511
2020-12-05,Virgin Islands,78,1613,0,23,0,29293,178,1633,20,27660,158
2020-12-05,Virginia,51,251173,3793,4197,37,3467011,50595,251173,3793,3215838,46802
2020-12-05,Washington,53,184079,1321,3065,3,3120146,194602,174290,1853,2945856,192749
2020-12-05,West Virginia,54,53572,1400,829,30,1215319,26714,53572,1400,1161747,25314
2020-12-05,Wisconsin,55,437918,5701,3938,91,2626867,14340,437918,5711,2188949,8629
2020-12-05,Wyoming,56,35941,204,257,0,180517,204,35941,204,144576,0
2020-12-06,Alabama,01,269877,2288,3889,12,1691003,8057,269877,2288,1421126,5769
2020-12-06,Alaska,02,36847,764,136,0,1077776,10545,35720,757,1042056,9788
2020-12-06,Arizona,04,364276,3090,6950,10,2383089,21037,364276,5376,2018813,15661
2020-12-06,Arkansas,05,170924,1542,2660,40,1785903,14786,170924,1542,1614979,13244
2020-12-06,California,06,1371940,28795,19937,61,25195046,293071,1341700,30075,23853346,262996
2020-12-06,Colorado,08,262460,4336,3437,22,1869410,37844,260581,3234,1608829,34610
2020-12-06,Connecticut,09,127715,0,5146,0,3422098,0,127715,0,3294383,0
2020-12-06,Delaware,10,39912,816,793,11,440766,3156,39912,816,400854,2340
2020-12-06,District of Columbia,11,23136,264,697,2,734633,7246,23136,264,711497,6982
2020-12-06,Florida,12,1058066,8436,19176,93,7545964,49372,1040727,8175,6505237,41197
2020-12-06,Georgia,13,483106,1980,9516,10,4476052,9852,443822,1805,4032230,8047
2020-12-06,Guam,66,7973,27,114,0,86575,27,7004,27,79571,0
2020-12-06,Hawaii,15,18581,97,260,1,313995,104,18842,104,295153,0
2020-12-06,Idaho,16,110553,789,1040,3,507732,3149,109705,1339,398027,1810
2020-12-06,Illinois,17,788922,7481,14127,99,11101214,79538,787573,7598,10313641,71940
2020-12-06,Indiana,18,384391,6601,6242,35,2309879,17701,381617,6598,1928262,11103
2020-12-06,Iowa,19,244689,1304,2717,35,1098589,4087,213390,1499,885199,2588
2020-12-06,Kansas,20,171635,9,1786,0,845186,0,168295,0,676891,0
2020-12-06,Kentucky,21,204772,2637,2250,9,2769175,2567,200632,2567,2568543,0
2020-12-06,Louisiana,22,251123,3946,6584,36,3608083,41549,251123,3946,3356960,37603
2020-12-06,Maine,23,13348,221,227,0,914180,221,13348,221,900832,0
2020-12-06,Maryland,24,215348,2803,4846,26,2440622,17442,215027,2643,2225595,14799
2020-12-06,Massachusetts,25,256844,4827,11004,51,3507572,24648,256844,4827,3250728,19821
2020-12-06,Michigan,26,426124,348,10313,0,6965058,0,426576,0,6538482,0
2020-12-06,Minnesota,27,350921,5581,4043,64,2651997,25338,350862,5581,2301135,19757
2020-12-06,Mississippi,28,164931,1473,3961,12,1147326,1473,164931,1473,982395,0
2020-12-06,Missouri,29,337927,3290,4420,8,1866524,10534,322298,3876,1544226,6658
2020-12-06,Montana,30,67875,783,736,2,688214,5631,67875,806,620339,4825
2020-12-06,Nebraska,31,139834,1266,1213,11,770307,8428,138568,2243,631739,6185
2020-12-06,Nevada,32,168758,2571,2318,9,1021786,6890,168139,2511,853647,4379
2020-12-06,New Hampshire,33,24771,633,564,5,440747,3194,24771,633,415976,2561
2020-12-06,New Jersey,34,369852,6030,17321,15,6286813,6030,368016,6030,5918797,0
2020-12-06,New Mexico,35,108088,1232,1749,11,1647976,13059,108088,1232,1539888,11827
2020-12-06,New York,36,710612,9710,34552,64,20594694,205832,705827,9702,19888867,196130
2020-12-06,North Carolina,37,395020,6260,5578,31,5611276,64662,394990,6438,5216286,58224
2020-12-06,North Dakota,38,82987,477,1019,6,357473,955,82981,477,274492,478
2020-12-06,Northern Mariana Islands,69,106,0,2,0,17116,0,106,0,17010,0
2020-12-06,Ohio,39,475024,7592,6960,13,6475710,59045,475024,7592,6000686,51453
2020-12-06,Oklahoma,40,216486,3241,1896,22,2225315,3241,216486,3241,2008829,0
2020-12-06,Oregon,41,84496,1253,1033,6,2090113,1253,84496,1253,2005617,0
2020-12-06,Pennsylvania,42,423828,7755,11389,58,3349150,26026,420114,8630,2929036,17396
2020-12-06,Puerto Rico,72,90286,1139,1191,7,362643,1139,56671,1139,305972,0
2020-12-06,Rhode Island,44,62137,0,1413,0,545059,0,62137,0,482922,0
2020-12-06,South Carolina,45,232099,2864,4566,49,2528191,24270,232099,2864,2296092,21406
2020-12-06,South Dakota,46,85991,687,1110,19,339995,1626,85991,687,254004,939
2020-12-06,Tennessee,47,391393,2893,4888,37,4690522,15466,400594,3072,4289928,12394
2020-12-06,Texas,48,1344195,10386,23187,76,11360976,118223,1249323,8573,10111653,109650
2020-12-06,Utah,49,215407,2563,939,0,1395728,9013,215407,2563,1180321,6450
2020-12-06,Vermont,50,5015,121,79,0,233880,2129,5015,121,228865,2008
2020-12-06,Virgin Islands,78,1613,0,23,0,29293,0,1633,0,27660,0
2020-12-06,Virginia,51,255053,3880,4200,3,3523875,56864,255053,3880,3268822,52984
2020-12-06,Washington,53,185505,1426,3065,0,3133845,13699,175793,1503,2958052,12196
2020-12-06,West Virginia,54,54997,1425,838,9,1223363,8044,54997,1425,1168366,6619
2020-12-06,Wisconsin,55,441067,3149,3956,18,2637789,10922,441067,3149,2196722,7773
2020-12-06,Wyoming,56,36317,376,257,0,180893,376,36317,376,144576,0
