date,state,fips,cases,newCases,deaths,newDeaths,tests,newTests,positive,newPositive,negative,newNegative
2020-10-19,US,00,8279803,65440,220058,517,117261016,1048667,8144591,57650,109116425,991017
2020-10-20,US,00,8340397,60594,220987,929,118098467,837451,8205165,60574,109893302,776877
2020-10-21,US,00,8404634,64237,222195,1208,118905253,806786,8266875,61710,110638378,745076
2020-10-22,US,00,8479762,75128,223023,828,119918690,1013437,8340294,73419,111578396,940018
2020-10-23,US,00,8564893,85131,223949,926,121040813,1122123,8422869,82575,112617944,1039548
2020-10-24,US,00,8643591,78698,224821,872,122059973,1019160,8506661,83792,113553312,935368
2020-10-25,US,00,8703303,59712,225160,339,123011909,951936,8571132,64471,114440777,887465
2020-10-26,US,00,8777800,74497,225698,538,124037933,1026024,8634562,63430,115403371,962594
2020-10-27,US,00,8852197,74397,226681,983,124928960,891027,8706817,72255,116222143,818772
2020-10-28,US,00,8934121,81924,227697,1016,125851667,922707,8786517,79700,117065150,843007
2020-10-29,US,00,9024915,90794,228701,1004,126956075,1104408,8875882,89365,118080193,1015043
2020-10-30,US,00,9124729,99814,229672,971,128037932,1081857,8973824,97942,119064108,983915
2020-10-31,US,00,9208964,84235,230510,838,129177192,1139260,9065118,91294,120112074,1047966
2020-11-01,US,00,9283188,74224,230937,427,130108887,931695,9207091,141973,120901796,789722
2020-11-02,US,00,9376927,93739,231477,540,131217721,1108834,9290545,83454,121927176,1025380
2020-11-03,US,00,9469557,92630,232607,1130,132205723,988002,9380557,90012,122825166,897990
2020-11-04,US,00,9577440,107883,234223,1616,133203220,997497,9485661,105104,123717559,892393
2020-11-05,US,00,9698981,121541,235331,1108,134519438,1316218,9604256,118595,124915182,1197623
2020-11-06,US,00,9831853,132872,236577,1246,135805860,1286422,9733182,128926,126072678,1157496
2020-11-07,US,00,9957785,125932,237584,1007,136934894,1129034,9864819,131637,127070075,997397
2020-11-08,US,00,10061201,103416,238048,464,137920223,985329,9977078,112259,127943145,873070
2020-11-09,US,00,10191642,130441,238793,745,139181294,1261071,10095312,118234,129085982,1142837
2020-11-10,US,00,10331382,139740,240258,1465,140319552,1138258,10228435,133123,130091117,1005135
2020-11-11,US,00,10474242,142860,241689,1431,141492060,1172508,10377166,148731,131114894,1023777
2020-11-12,US,00,10637733,163491,242861,1172,142690569,1198509,10534222,157056,132156347,1041453
2020-11-13,US,00,10819326,181593,244250,1389,144076607,1386038,10708176,173954,133368431,1212084
2020-11-14,US,00,10978447,159121,245460,1210,145432507,1355900,10875359,167183,134557148,1188717
2020-11-15,US,00,11113634,135187,246083,623,146663670,1231163,11022289,146930,135641381,1084233
2020-11-16,US,00,11280088,166454,246879,796,147949817,1286147,11172000,149711,136777817,1136436
2020-11-17,US,00,11441833,161745,248486,1607,149254943,1305126,11331027,159027,137923916,1146099
2020-11-18,US,00,11614116,172283,250411,1925,150532585,1277642,11498600,167573,139033985,1110069
2020-11-19,US,00,11801586,187470,252373,1962,151986928,1454343,11685769,187169,140301159,1267174
2020-11-20,US,00,12000258,198672,254325,1952,153561641,1574713,11882263,196494,141679378,1378219
2020-11-21,US,00,12172261,172003,255754,1429,155176451,1614810,12065464,183201,143110987,1431609
2020-11-22,US,00,12313295,141034,256597,843,156576071,1399620,12219300,153836,144356771,1245784
2020-11-23,US,00,12492394,179099,257635,1038,158002538,1426467,12373881,154581,145628657,1271886
2020-11-24,US,00,12670684,178290,259844,2209,159550964,1548426,12539132,165251,147011832,1383175
2020-11-25,US,00,12851220,180536,262157,2313,160954282,1403318,12726809,187677,148227473,1215641
2020-11-26,US,00,12954324,103104,263336,1179,161985144,1030862,12855872,129063,149129272,901799
2020-11-27,US,00,13159786,205462,264748,1412,163588352,1603208,13054131,198259,150534221,1404949
2020-11-28,US,00,13311031,151245,265940,1192,164949717,1361365,13205195,151064,151744522,1210301
2020-11-29,US,00,13447369,136338,266758,818,165948907,999190,13342162,136967,152606745,862223
2020-11-30,US,00,13615129,167760,268023,1265,167313422,1364515,13491678,149516,153821744,1214999
2020-12-01,US,00,13799415,184286,270633,2610,168504051,1190629,13670815,179137,154833236,1011492
2020-12-02,US,00,14000601,201186,273518,2885,170686086,2182035,13872561,201746,156813525,1980289
2020-12-03,US,00,14218560,217959,276375,2857,172168806,1482720,14087366,214805,158081440,1267915
2020-12-04,US,00,14449741,231181,279012,2637,173657401,1488595,14316250,228884,159341151,1259711
2020-12-05,US,00,14655498,205757,281202,2190,175424686,1767285,14534020,217770,160890666,1549515
2020-12-06,US,00,14827657,172159,282313,1111,176722346,1297660,14716371,182351,162005975,1115309
2020-12-07,US,00,15031799,204142,283846,1533,178173664,1451318,14897844,181473,163275820,1269845
2020-12-08,US,00,15251704,219905,286667,2821,179668819,1495155,15113797,215953,164555022,1279202
2020-12-09,US,00,15471382,219678,289824,3157,181152290,1483471,15328757,214960,165823533,1268511
2020-12-10,US,00,15696634,225252,292761,2937,182643321,1491031,15548042,219285,167095279,1271746
2020-12-11,US,00,15977148,280514,295712,2951,184220834,1577513,15783513,235471,168437321,1342042
2020-12-12,US,00,16184592,207444,297971,2259,185635042,1414208,16008800,225287,169626242,1188921
2020-12-13,US,00,16368840,184248,299328,1357,187036225,1401183,16195563,186763,170840662,1214420
2020-12-14,US,00,16569913,201073,301006,1678,188861015,1824790,16388425,192862,172472590,1631928
2020-12-15,US,00,16772913,203000,304031,3025,190400542,1539527,16579018,190593,173821524,1348934
2020-12-16,US,00,17017946,245033,307642,3611,191847405,1446863,16810868,231850,175036537,1215013
2020-12-17,US,00,17256391,238445,310940,3298,193346307,1498902,17051896,241028,176294411,1257874
2020-12-18,US,00,17507582,251191,313810,2870,195124480,1778173,17291633,239737,177832847,1538436
2020-12-19,US,00,17701529,193947,316371,2561,196536655,1412175,17494979,203346,179041676,1208829
2020-12-20,US,00,17881485,179956,317800,1429,197954205,1417550,17691942,196963,180262263,1220587
2020-12-21,US,00,18083055,201570,319763,1963,199692912,1738707,17870939,178997,181821973,1559710
2020-12-22,US,00,18284729,201674,323002,3239,201151818,1458906,18061071,190132,183090747,1268774
2020-12-23,US,00,18512479,227750,326413,3411,202561816,1409998,18282977,221906,184278839,1188092
2020-12-24,US,00,18706036,193557,329237,2824,204040799,1478983,18487274,204297,185553525,1274686
2020-12-25,US,00,18807030,100994,330366,1129,205152486,1111687,18613141,125867,186539345,985820
2020-12-26,US,00,19023888,216858,332012,1646,206863351,1710865,18803256,190115,188060095,1520750
2020-12-27,US,00,19175990,152102,333242,1230,208027612,1164261,18956234,152978,189071378,1011283
2020-12-28,US,00,19365034,189044,335141,1899,209314933,1287321,19119572,163338,190195361,1123983
2020-12-29,US,00,19566140,201106,338769,3628,210459991,1145058,19315654,196082,191144337,948976
2020-12-30,US,00,19795178,229038,342577,3808,211651615,1191624,19541562,225908,192110053,965716
2020-12-31,US,00,20026223,231045,346039,3462,212994436,1342821,19764598,223036,193229838,1119785
2021-01-01,US,00,20173382,147159,347956,1917,214066255,1071819,19945086,180488,194121169,891331
2021-01-02,US,00,20464766,291384,350329,2373,215704383,1638128,20224475,279389,195479908,1358739
2021-01-03,US,00,20666746,201980,351682,1353,216913336,1208953,20432231,207756,196481105,1001197
2021-01-04,US,00,20918664,251918,353730,2048,218284052,1370716,20610669,178438,197673383,1192278
2021-01-05,US,00,21153715,235051,357419,3689,219733762,1449710,20825755,215086,198908007,1234624
2021-01-06,US,00,21409443,255728,361383,3964,220985960,1252198,21073841,248086,199912119,1004112
2021-01-07,US,00,21689735,280292,365495,4112,222470908,1484948,21343166,269325,201127742,1215623
2021-01-08,US,00,21990329,300594,369390,3895,224127684,1656776,21635370,292204,202492314,1364572
2021-01-09,US,00,22242471,252142,372651,3261,225767751,1640067,21901769,266399,203865982,1373668
2021-01-10,US,00,22450809,208338,374428,1777,227401398,1633647,22129477,227708,205271921,1405939
2021-01-11,US,00,22673730,222921,376476,2048,228980014,1578616,22323617,194140,206656397,1384476
2021-01-12,US,00,22903442,229712,380882,4406,230610633,1630619,22538426,214809,208072207,1415810
2021-01-13,US,00,23132740,229298,384812,3930,232070251,1459618,22759983,221557,209310268,1238061
2021-01-14,US,00,23371360,238620,388792,3980,233635432,1565181,22982927,222944,210652505,1342237
2021-01-15,US,00,23612307,240947,392541,3749,235472418,1836986,23226923,243996,212245495,1592990
2021-01-16,US,00,23813966,201659,395882,3341,237088289,1615871,23443401,216478,213644888,1399393
2021-01-17,US,00,23983607,169641,397612,1730,238626419,1538130,23629671,186270,214996748,1351860
2021-01-18,US,00,24126194,142587,399053,1441,240455887,1829468,23779891,150220,216675996,1679248
2021-01-19,US,00,24311264,185070,401824,2771,241901723,1445836,23923938,144047,217977785,1301789
2021-01-20,US,00,24497499,186235,406194,4370,243371876,1470153,24110660,186722,219261216,1283431
2021-01-21,US,00,24688129,190630,410336,4142,244819613,1447737,24294693,184033,220524920,1263704
2021-01-22,US,00,24880041,191912,414070,3734,246383689,1564076,24483676,188983,221900013,1375093
2021-01-23,US,00,25047995,167954,417392,3322,247845583,1461894,24657405,173729,223188178,1288165
2021-01-24,US,00,25177522,129527,419207,1815,249199187,1353604,24800354,142949,224398833,1210655
2020-10-19,Alabama,01,173485,859,2789,1,1281313,6318,173485,859,1107828,5459
2020-10-19,Alaska,02,12138,204,63,0,536223,3512,11225,204,524998,3308
2020-10-19,Arizona,04,231933,784,5830,3,1645001,8791,231897,748,1413104,8043
2020-10-19,Arkansas,05,99597,531,1714,10,1229721,8067,99597,531,1130124,7536
2020-10-19,California,06,882665,4271,16987,8,17042408,150346,870791,3474,16171617,146872
2020-10-19,Colorado,08,86727,924,2207,8,1095280,9312,86374,1072,1008906,8240
2020-10-19,Connecticut,09,64021,1191,4554,12,2039597,71964,64021,1191,1975576,70773
2020-10-19,Delaware,10,23196,103,666,1,329018,1722,23196,103,305822,1619
2020-10-19,District of Columbia,11,16395,25,641,0,469040,2235,16395,25,452645,2210
2020-10-19,Florida,12,756719,1707,16020,54,5729739,16875,747183,1691,4982556,15184
2020-10-19,Georgia,13,350654,1881,7479,19,3314279,15821,341310,752,2972969,15069
2020-10-19,Guam,66,4725,218,67,3,59549,581,3756,81,55793,500
2020-10-19,Hawaii,15,14218,35,186,0,14225,82,14225,82,,0
2020-10-19,Idaho,16,54123,1031,535,3,359107,2967,53092,510,306015,2457
2020-10-19,Illinois,17,352449,3579,9520,29,6827824,48684,350748,3113,6477076,45571
2020-10-19,Indiana,18,151588,1583,3960,23,1564722,9285,149166,1584,1415556,7701
2020-10-19,Iowa,19,108114,780,1548,16,835573,3037,102517,557,733056,2480
2020-10-19,Kansas,20,74616,1894,872,13,598394,9205,72968,2113,525426,7092
2020-10-19,Kentucky,21,90443,905,1381,9,1711919,23579,88247,640,1623672,22939
2020-10-19,Louisiana,22,179070,201,5766,16,2597464,4866,179070,201,2418394,4665
2020-10-19,Maine,23,5962,23,146,0,549477,15762,5962,23,543515,15739
2020-10-19,Maryland,24,136643,494,4041,4,1816722,10060,136154,497,1680568,9563
2020-10-19,Massachusetts,25,144488,828,9753,16,2535301,17655,144488,828,2390813,16827
2020-10-19,Michigan,26,164055,4718,7364,41,4335624,64867,164123,5004,4171501,59863
2020-10-19,Minnesota,27,124492,1627,2292,5,1694569,13251,124439,1627,1570130,11624
2020-10-19,Mississippi,28,110592,353,3171,0,840136,586,110592,586,729544,0
2020-10-19,Missouri,29,164249,2093,2660,12,1393100,6564,158101,1405,1234999,5159
2020-10-19,Montana,30,23503,682,242,1,442366,11232,23390,569,418976,10663
2020-10-19,Nebraska,31,58817,749,568,11,543213,4086,58068,734,485145,3352
2020-10-19,Nevada,32,90978,604,1714,3,763202,3694,90843,582,672359,3112
2020-10-19,New Hampshire,33,9746,52,468,1,315287,1455,9746,52,305541,1403
2020-10-19,New Jersey,34,222994,1192,16214,3,4225392,80813,228892,1371,3996500,79442
2020-10-19,New Mexico,35,37302,514,935,1,1061268,6377,37302,514,1023966,5863
2020-10-19,New York,36,490015,999,32990,18,12982175,82009,485279,998,12496896,81011
2020-10-19,North Carolina,37,247551,1435,3969,8,3648364,31106,247172,1144,3401192,29962
2020-10-19,North Dakota,38,32642,659,413,4,272644,2181,32544,658,240100,1523
2020-10-19,Northern Mariana Islands,69,86,0,2,0,15542,0,86,0,15456,0
2020-10-19,Ohio,39,183624,1837,5075,8,3941567,40918,183624,1837,3757943,39081
2020-10-19,Oklahoma,40,108073,774,1173,2,1435605,774,108073,774,1327532,0
2020-10-19,Oregon,41,39799,267,630,8,785104,3461,39532,216,745572,3245
2020-10-19,Pennsylvania,42,188442,1670,8562,7,2327281,12418,183315,1103,2143966,11315
2020-10-19,Puerto Rico,72,57950,657,768,2,335110,427,29138,427,305972,0
2020-10-19,Rhode Island,44,28347,656,1159,7,399326,1102,28347,85,370979,1017
2020-10-19,South Carolina,45,164609,619,3661,11,1610200,8937,164609,619,1445591,8318
2020-10-19,South Dakota,46,33836,567,323,0,232450,1403,33836,567,198614,836
2020-10-19,Tennessee,47,228267,3141,2896,12,3383392,42573,232061,3317,3151331,39256
2020-10-19,Texas,48,874080,4704,17564,23,7603161,23929,825673,1894,6777488,22035
2020-10-19,Utah,49,95572,1178,547,3,954879,6634,95562,1168,859317,5466
2020-10-19,Vermont,50,1946,9,58,0,178084,1055,1951,8,176133,1047
2020-10-19,Virgin Islands,78,1335,0,21,0,22852,0,1335,0,21517,0
2020-10-19,Virginia,51,166828,690,3457,24,2408500,11422,166828,690,2241672,10732
2020-10-19,Washington,53,103323,920,2357,18,2234101,16104,101517,409,2132584,15695
2020-10-19,West Virginia,54,20293,212,399,0,687990,7118,20293,212,667697,6906
2020-10-19,Wisconsin,55,183177,7525,1624,36,1886955,121159,183142,7915,1703813,113244
2020-10-19,Wyoming,56,9311,286,57,0,118065,286,9311,286,108754,0
2020-10-20,Alabama,01,174528,1043,2805,16,1287087,5774,174528,1043,1112559,4731
2020-10-20,Alaska,02,12349,211,63,0,546525,10302,11456,231,535069,10071
2020-10-20,Arizona,04,232939,1006,5837,7,1652612,7611,232937,1040,1419675,6571
2020-10-20,Arkansas,05,100441,844,1728,14,1237675,7954,100441,844,1137234,7110
2020-10-20,California,06,887093,4428,17067,80,17189070,146662,874077,3286,16314993,143376
2020-10-20,Colorado,08,87966,1239,2212,5,1101775,6495,87582,1208,1014193,5287
2020-10-20,Connecticut,09,64455,434,4559,5,2054262,14665,64455,434,1989807,14231
2020-10-20,Delaware,10,23325,129,668,2,330726,1708,23325,129,307401,1579
2020-10-20,District of Columbia,11,16445,50,642,1,473807,4767,16445,50,457362,4717
2020-10-20,Florida,12,760381,3662,16104,84,5758297,28558,750739,3556,5007558,25002
2020-10-20,Georgia,13,351990,1336,7494,15,3327836,13557,342438,1128,2985398,12429
2020-10-20,Guam,66,4855,130,67,0,60506,957,3886,130,56620,827
2020-10-20,Hawaii,15,14302,84,188,2,14262,37,14262,37,,0
2020-10-20,Idaho,16,55153,1030,541,6,361402,2295,53790,698,307612,1597
2020-10-20,Illinois,17,356151,3702,9562,42,6886901,59077,354462,3714,6532439,55363
2020-10-20,Indiana,18,153088,1500,4008,48,1572350,7628,150664,1498,1421686,6130
2020-10-20,Iowa,19,109210,1096,1576,28,837718,2145,103011,494,734707,1651
2020-10-20,Kansas,20,74883,267,902,30,598394,0,72968,0,525426,0
2020-10-20,Kentucky,21,91731,1288,1403,22,1720328,8409,89544,1297,1630784,7112
2020-10-20,Louisiana,22,179769,699,5772,6,2616457,18993,179769,699,2436688,18294
2020-10-20,Maine,23,5989,27,146,0,554094,4617,5989,27,548105,4590
2020-10-20,Maryland,24,137229,586,4050,9,1824905,8183,136744,590,1688161,7593
2020-10-20,Massachusetts,25,145464,976,9758,5,2552694,17393,145464,976,2407230,16417
2020-10-20,Michigan,26,165949,1894,7386,22,4385791,50167,165994,1871,4219797,48296
2020-10-20,Minnesota,27,125584,1092,2299,7,1700265,5696,125531,1092,1574734,4604
2020-10-20,Mississippi,28,111322,730,3202,31,840866,730,111322,730,729544,0
2020-10-20,Missouri,29,164891,642,2668,8,1394624,1524,159625,1524,1234999,0
2020-10-20,Montana,30,24201,698,252,10,445021,2655,24093,703,420928,1952
2020-10-20,Nebraska,31,59409,592,575,7,546669,3456,58817,749,487852,2707
2020-10-20,Nevada,32,91679,701,1728,14,766312,3110,91499,656,674813,2454
2020-10-20,New Hampshire,33,9828,82,468,0,316588,1301,9828,82,306760,1219
2020-10-20,New Jersey,34,223982,988,16227,13,4243234,17842,230127,1235,4013107,16607
2020-10-20,New Mexico,35,37896,594,942,7,1070481,9213,37896,594,1032585,8619
2020-10-20,New York,36,491216,1201,32998,8,13072715,90540,486480,1201,12586235,89339
2020-10-20,North Carolina,37,249158,1607,4018,49,3671793,23429,248750,1578,3423043,21851
2020-10-20,North Dakota,38,33671,1029,417,4,274499,1855,33593,1049,240906,806
2020-10-20,Northern Mariana Islands,69,88,2,2,0,15811,269,88,2,15723,267
2020-10-20,Ohio,39,185639,2015,5083,8,3979414,37847,185639,2015,3793775,35832
2020-10-20,Oklahoma,40,109548,1475,1191,18,1467010,31405,109548,1475,1357462,29930
2020-10-20,Oregon,41,40149,350,636,6,788509,3405,39794,262,748715,3143
2020-10-20,Pennsylvania,42,189988,1546,8591,29,2340511,13230,184872,1557,2155639,11673
2020-10-20,Puerto Rico,72,58643,693,769,1,335557,447,29585,447,305972,0
2020-10-20,Rhode Island,44,28649,302,1164,5,401055,1729,28649,302,372406,1427
2020-10-20,South Carolina,45,165493,884,3696,35,1619922,9722,165493,884,1454429,8838
2020-10-20,South Dakota,46,34457,621,330,7,234726,2276,34457,621,200269,1655
2020-10-20,Tennessee,47,229794,1527,2924,28,3396736,13344,233569,1508,3163167,11836
2020-10-20,Texas,48,879949,5869,17644,80,7687050,83889,833557,7884,6853493,76005
2020-10-20,Utah,49,96643,1071,552,5,959942,5063,96643,1081,863299,3982
2020-10-20,Vermont,50,1956,10,58,0,178444,360,1963,12,176481,348
2020-10-20,Virgin Islands,78,1337,2,21,0,22852,0,1335,0,21517,0
2020-10-20,Virginia,51,167754,926,3485,28,2422481,13981,167754,926,2254727,13055
2020-10-20,Washington,53,103845,522,2380,23,2247490,13389,101815,298,2145675,13091
2020-10-20,West Virginia,54,20519,226,408,9,691809,3819,20519,226,671290,3593
2020-10-20,Wisconsin,55,187898,4721,1660,36,1900711,13756,187828,4686,1712883,9070
2020-10-20,Wyoming,56,9526,215,61,4,118280,215,9526,215,108754,0
2020-10-21,Alabama,01,175674,1146,2828,23,1295035,7948,174528,0,1120507,7948
2020-10-21,Alaska,02,12559,210,64,1,547140,615,11680,224,535460,391
2020-10-21,Arizona,04,233948,1009,5854,17,1662704,10092,233912,975,1428792,9117
2020-10-21,Arkansas,05,101596,1155,1751,23,1248949,11274,101596,1155,1147353,10119
2020-10-21,California,06,890153,3060,17189,122,17293139,104069,877784,3707,16415355,100362
2020-10-21,Colorado,08,89245,1279,2220,8,1110243,8468,88849,1267,1021394,7201
2020-10-21,Connecticut,09,64871,416,4567,8,2070126,15864,64871,416,2005255,15448
2020-10-21,Delaware,10,23375,50,670,2,331480,754,23375,50,308105,704
2020-10-21,District of Columbia,11,16498,53,642,0,476443,2636,16498,53,459945,2583
2020-10-21,Florida,12,762525,2144,16209,105,5760403,2106,752845,2106,5007558,0
2020-10-21,Georgia,13,353449,1459,7523,29,3338315,10479,343750,1312,2994565,9167
2020-10-21,Guam,66,4937,82,69,2,61243,737,3968,82,57275,655
2020-10-21,Hawaii,15,14379,77,202,14,14350,88,14350,88,,0
2020-10-21,Idaho,16,55922,769,551,10,363972,2570,54663,873,309309,1697
2020-10-21,Illinois,17,360160,4009,9622,60,6953692,66791,358804,4342,6594888,62449
2020-10-21,Indiana,18,154822,1734,4023,15,1581109,8759,152396,1732,1428713,7027
2020-10-21,Iowa,19,110444,1234,1594,18,842542,4824,104190,1179,738352,3645
2020-10-21,Kansas,20,76299,1416,952,50,605509,7115,74456,1488,531053,5627
2020-10-21,Kentucky,21,93110,1379,1424,21,1728638,8310,90996,1452,1637642,6858
2020-10-21,Louisiana,22,181132,1363,5790,18,2631404,14947,181132,1363,2450272,13584
2020-10-21,Maine,23,6027,38,146,0,560810,6716,6027,38,554783,6678
2020-10-21,Maryland,24,137720,491,4058,8,1832007,7102,137236,492,1694771,6610
2020-10-21,Massachusetts,25,146166,702,9780,22,2565472,12778,146166,702,2419306,12076
2020-10-21,Michigan,26,167857,1908,7420,34,4420831,35040,167872,1878,4252959,33162
2020-10-21,Minnesota,27,126644,1060,2334,35,1708514,8249,126591,1060,1581923,7189
2020-10-21,Mississippi,28,112123,801,3223,21,841667,801,112123,801,729544,0
2020-10-21,Missouri,29,167435,2544,2716,48,1407874,13250,160869,1244,1247005,12006
2020-10-21,Montana,30,24818,617,276,24,447994,2973,24712,619,423282,2354
2020-10-21,Nebraska,31,60308,899,586,11,549922,3253,59409,592,490513,2661
2020-10-21,Nevada,32,92193,514,1735,7,769613,3301,92064,565,677549,2736
2020-10-21,New Hampshire,33,9917,89,469,1,318829,2241,9917,89,308912,2152
2020-10-21,New Jersey,34,225012,1030,16245,18,4272328,29094,231428,1301,4040900,27793
2020-10-21,New Mexico,35,38715,819,950,8,1078087,7606,38715,819,1039372,6787
2020-10-21,New York,36,493245,2029,33005,7,13197504,124789,488506,2026,12708998,122763
2020-10-21,North Carolina,37,251010,1852,4063,45,3692043,20250,250592,1842,3441451,18408
2020-10-21,North Dakota,38,34170,499,427,10,275545,1046,34114,521,241431,525
2020-10-21,Northern Mariana Islands,69,88,0,2,0,15811,0,88,0,15723,0
2020-10-21,Ohio,39,188005,2366,5149,66,4011513,32099,188005,2366,3823508,29733
2020-10-21,Oklahoma,40,110855,1307,1210,19,1478225,11215,110855,1307,1367370,9908
2020-10-21,Oregon,41,40458,309,638,2,795317,6808,40136,342,755181,6466
2020-10-21,Pennsylvania,42,191347,1359,8629,38,2353833,13322,186297,1425,2167536,11897
2020-10-21,Puerto Rico,72,58830,187,774,5,335689,132,29717,132,305972,0
2020-10-21,Rhode Island,44,29123,474,1169,5,404680,3625,29123,474,375557,3151
2020-10-21,South Carolina,45,166357,864,3708,12,1633549,13627,166357,864,1467192,12763
2020-10-21,South Dakota,46,35044,587,333,3,236250,1524,35044,587,201206,937
2020-10-21,Tennessee,47,232100,2306,2946,22,3416255,19519,235861,2292,3180394,17227
2020-10-21,Texas,48,886421,6472,17743,99,7769909,82859,838809,5252,6931100,77607
2020-10-21,Utah,49,98037,1394,558,6,966892,6950,98006,1363,868886,5587
2020-10-21,Vermont,50,1971,15,58,0,179235,791,1983,20,177252,771
2020-10-21,Virgin Islands,78,1337,0,21,0,23105,253,1337,2,21768,251
2020-10-21,Virginia,51,168772,1018,3515,30,2442510,20029,168772,1018,2273738,19011
2020-10-21,Washington,53,104624,779,2384,4,2256366,8876,102728,913,2153638,7963
2020-10-21,West Virginia,54,20734,215,413,5,696597,4788,20734,215,675863,4573
2020-10-21,Wisconsin,55,192225,4327,1707,47,1910755,10044,192191,4363,1718564,5681
2020-10-21,Wyoming,56,9848,322,61,0,121670,3390,9848,322,111822,3068
2020-10-22,Alabama,01,177064,1390,2843,15,1302817,7782,177064,2536,1125753,5246
2020-10-22,Alaska,02,12790,231,64,0,548709,1569,11919,239,536790,1330
2020-10-22,Arizona,04,234914,966,5859,5,1673903,11199,234906,994,1438997,10205
2020-10-22,Arkansas,05,102798,1202,1772,21,1262040,13091,102798,1202,1159242,11889
2020-10-22,California,06,896424,6271,17266,77,17358770,65631,880724,2940,16478046,62691
2020-10-22,Colorado,08,90639,1394,2224,4,1120200,9957,90222,1373,1029978,8584
2020-10-22,Connecticut,09,65373,502,4569,2,2092263,22137,65373,502,2026890,21635
2020-10-22,Delaware,10,23528,153,670,0,333059,1579,23528,153,309531,1426
2020-10-22,District of Columbia,11,16537,39,642,0,479435,2992,16537,39,462898,2953
2020-10-22,Florida,12,768083,5558,16266,57,5812154,51751,758306,5461,5053848,46290
2020-10-22,Georgia,13,355156,1707,7547,24,3367534,29219,345535,1785,3021999,27434
2020-10-22,Guam,66,5025,88,70,1,62287,1044,4056,88,58231,956
2020-10-22,Hawaii,15,14478,99,205,3,14427,77,14427,77,,0
2020-10-22,Idaho,16,56944,1022,560,9,366607,2635,55650,987,310957,1648
2020-10-22,Illinois,17,365120,4960,9663,41,7034669,80977,363746,4942,6670923,76035
2020-10-22,Indiana,18,157678,2856,4065,42,1594365,13256,155246,2850,1439119,10406
2020-10-22,Iowa,19,112242,1798,1617,23,848270,5728,105625,1435,742645,4293
2020-10-22,Kansas,20,76546,247,952,0,605509,0,74456,0,531053,0
2020-10-22,Kentucky,21,94582,1472,1439,15,1758052,29414,92299,1303,1665753,28111
2020-10-22,Louisiana,22,181904,772,5799,9,2651160,19756,181904,772,2469256,18984
2020-10-22,Maine,23,6064,37,146,0,567382,6572,6064,37,561318,6535
2020-10-22,Maryland,24,138473,753,4070,12,1843355,11348,137979,743,1705376,10605
2020-10-22,Massachusetts,25,147215,1049,9810,30,2583501,18029,147215,1049,2436286,16980
2020-10-22,Michigan,26,170102,2245,7465,45,4468863,48032,170076,2204,4298787,45828
2020-10-22,Minnesota,27,128205,1561,2354,20,1722897,14383,128152,1561,1594745,12822
2020-10-22,Mississippi,28,113081,958,3231,8,842625,958,113081,958,729544,0
2020-10-22,Missouri,29,169311,1876,2734,18,1432472,24598,162723,1854,1269749,22744
2020-10-22,Montana,30,25736,918,279,3,452846,4852,25640,928,427206,3924
2020-10-22,Nebraska,31,61285,977,589,3,554539,4617,60308,899,494231,3718
2020-10-22,Nevada,32,93028,835,1736,1,774095,4482,92853,789,681242,3693
2020-10-22,New Hampshire,33,9994,77,470,1,323734,4905,9994,77,313740,4828
2020-10-22,New Jersey,34,226174,1162,16263,18,4306099,33771,232872,1444,4073227,32327
2020-10-22,New Mexico,35,39377,662,953,3,1089150,11063,39377,662,1049773,10401
2020-10-22,New York,36,494874,1629,33022,17,13332845,135341,490134,1628,12842711,133713
2020-10-22,North Carolina,37,253418,2408,4110,47,3727675,35632,252992,2400,3474683,33232
2020-10-22,North Dakota,38,35057,887,436,9,277802,2257,35162,1048,242640,1209
2020-10-22,Northern Mariana Islands,69,88,0,2,0,15811,0,88,0,15723,0
2020-10-22,Ohio,39,190430,2425,5161,12,4055125,43612,190430,2425,3864695,41187
2020-10-22,Oklahoma,40,112483,1628,1221,11,1491088,12863,112483,1628,1378605,11235
2020-10-22,Oregon,41,40825,367,647,9,799935,4618,40443,307,759492,4311
2020-10-22,Pennsylvania,42,193401,2054,8660,31,2373439,19606,188360,2063,2185079,17543
2020-10-22,Puerto Rico,72,59037,207,783,9,335776,87,29804,87,305972,0
2020-10-22,Rhode Island,44,29594,471,1173,4,408302,3622,29594,471,378708,3151
2020-10-22,South Carolina,45,167485,1128,3755,47,1649351,15802,167485,1128,1481866,14674
2020-10-22,South Dakota,46,36017,973,347,14,238446,2196,36017,973,202429,1223
2020-10-22,Tennessee,47,234079,1979,2983,37,3436334,20079,237907,2046,3198427,18033
2020-10-22,Texas,48,891714,5293,17760,17,7851327,81418,845100,6291,7006227,75127
2020-10-22,Utah,49,99563,1526,563,5,976126,9234,99549,1543,876577,7691
2020-10-22,Vermont,50,1987,16,58,0,180122,887,1999,16,178123,871
2020-10-22,Virgin Islands,78,1343,6,21,0,23254,149,1343,6,21911,143
2020-10-22,Virginia,51,170104,1332,3524,9,2462742,20232,170104,1332,2292638,18900
2020-10-22,Washington,53,105364,740,2389,5,2280225,23859,103646,918,2176579,22941
2020-10-22,West Virginia,54,21057,323,418,5,705151,8554,21057,323,684094,8231
2020-10-22,Wisconsin,55,195853,3628,1730,23,1926469,15714,195823,3632,1730646,12082
2020-10-22,Wyoming,56,10119,271,68,7,121941,271,10119,271,111822,0
2020-10-23,Alabama,01,180916,3852,2859,16,1314774,11957,180916,3852,1133858,8105
2020-10-23,Alaska,02,13067,277,64,0,552746,4037,12167,248,540579,3789
2020-10-23,Arizona,04,235910,996,5865,6,1686863,12960,235882,976,1450981,11984
2020-10-23,Arkansas,05,104135,1337,1782,10,1274297,12257,104135,1337,1170162,10920
2020-10-23,California,06,902325,5901,17316,50,17483293,124523,886865,6141,16596428,118382
2020-10-23,Colorado,08,92067,1428,2233,9,1130901,10701,91572,1350,1039329,9351
2020-10-23,Connecticut,09,66052,679,4577,8,2115744,23481,66052,679,2049692,22802
2020-10-23,Delaware,10,23687,159,678,8,335112,2053,23687,159,311425,1894
2020-10-23,District of Columbia,11,16609,72,642,0,485753,6318,16609,72,469144,6246
2020-10-23,Florida,12,771772,3689,16339,73,5855896,43742,761924,3618,5093972,40124
2020-10-23,Georgia,13,357319,2163,7584,37,3407623,40089,347759,2224,3059864,37865
2020-10-23,Guam,66,5110,85,70,0,62906,619,4141,85,58765,534
2020-10-23,Hawaii,15,14617,139,208,3,14529,102,14529,102,,0
2020-10-23,Idaho,16,58083,1139,568,8,369667,3060,56600,950,313067,2110
2020-10-23,Illinois,17,370134,5014,9704,41,7118051,83382,368746,5000,6749305,78382
2020-10-23,Indiana,18,160145,2467,4092,27,1605596,11231,157713,2467,1447883,8764
2020-10-23,Iowa,19,113596,1354,1629,12,852949,4679,106874,1249,746075,3430
2020-10-23,Kansas,20,78122,1576,975,23,616262,10753,76230,1774,540032,8979
2020-10-23,Kentucky,21,96043,1461,1462,23,1777204,19152,93748,1449,1683456,17703
2020-10-23,Louisiana,22,182603,699,5820,21,2671238,20078,182603,699,2488635,19379
2020-10-23,Maine,23,6095,31,146,0,574283,6901,6095,31,568188,6870
2020-10-23,Maryland,24,139185,712,4078,8,1855294,11939,138691,712,1716603,11227
2020-10-23,Massachusetts,25,148285,1070,9830,20,2599364,15863,148285,1070,2451079,14793
2020-10-23,Michigan,26,172128,2026,7485,20,4525886,57023,172122,2046,4353764,54977
2020-10-23,Minnesota,27,129916,1711,2367,13,1734245,11348,129863,1711,1604382,9637
2020-10-23,Mississippi,28,113876,795,3238,7,843420,795,113876,795,729544,0
2020-10-23,Missouri,29,171871,2560,2764,30,1439316,6844,164534,1811,1274782,5033
2020-10-23,Montana,30,26600,864,283,4,461000,8154,26503,863,434497,7291
2020-10-23,Nebraska,31,62511,1226,594,5,559308,4769,61285,977,498023,3792
2020-10-23,Nevada,32,94044,1016,1739,3,780647,6552,93666,813,686981,5739
2020-10-23,New Hampshire,33,10112,118,471,1,326745,3011,10112,118,316633,2893
2020-10-23,New Jersey,34,227219,1045,16273,10,4346742,40643,234187,1315,4112555,39328
2020-10-23,New Mexico,35,40168,791,960,7,1099484,10334,40168,791,1059316,9543
2020-10-23,New York,36,496510,1636,33038,16,13474353,141508,491771,1637,12982582,139871
2020-10-23,North Carolina,37,255534,2116,4140,30,3763315,35640,255708,2716,3507607,32924
2020-10-23,North Dakota,38,35944,887,445,9,279821,2019,36058,896,243763,1123
2020-10-23,Northern Mariana Islands,69,88,0,2,0,15811,0,88,0,15723,0
2020-10-23,Ohio,39,192948,2518,5184,23,4101393,46268,192948,2518,3908445,43750
2020-10-23,Oklahoma,40,113856,1373,1234,13,1511552,20464,113856,1373,1397696,19091
2020-10-23,Oregon,41,41357,532,651,4,806001,6066,40810,367,765191,5699
2020-10-23,Pennsylvania,42,195659,2258,8695,35,2391447,18008,190579,2219,2200868,15789
2020-10-23,Puerto Rico,72,60984,1947,791,8,336928,1152,30956,1152,305972,0
2020-10-23,Rhode Island,44,30118,524,1177,4,412850,4548,30118,524,382732,4024
2020-10-23,South Carolina,45,168549,1064,3777,22,1667501,18150,168549,1064,1498952,17086
2020-10-23,South Dakota,46,37202,1185,356,9,241002,2556,37202,1185,203800,1371
2020-10-23,Tennessee,47,237607,3528,3043,60,3478495,42161,241513,3606,3236982,38555
2020-10-23,Texas,48,899390,7676,17874,114,7930083,78756,851572,6472,7078511,72284
2020-10-23,Utah,49,101574,2011,567,4,984137,8011,101509,1960,882628,6051
2020-10-23,Vermont,50,2016,29,58,0,181287,1165,2029,30,179258,1135
2020-10-23,Virgin Islands,78,1346,3,21,0,23435,181,1346,3,22089,178
2020-10-23,Virginia,51,171284,1180,3539,15,2483341,20599,171284,1180,2312057,19419
2020-10-23,Washington,53,106189,825,2396,7,2300181,19956,104431,785,2195750,19171
2020-10-23,West Virginia,54,21392,335,422,4,710357,5206,21392,335,688965,4871
2020-10-23,Wisconsin,55,200479,4626,1776,46,1944538,18069,200466,4643,1744072,13426
2020-10-23,Wyoming,56,10545,426,68,0,124231,2290,10545,426,113686,1864
2020-10-24,Alabama,01,183276,2360,2866,7,1322198,7424,183276,2360,1138922,5064
2020-10-24,Alaska,02,13439,372,64,0,552746,0,12523,356,540223,-356
2020-10-24,Arizona,04,236898,988,5870,5,1698966,12103,236772,890,1462194,11213
2020-10-24,Arkansas,05,105318,1183,1797,15,1287123,12826,105318,1183,1181805,11643
2020-10-24,California,06,906644,4319,17345,29,17609179,125886,892810,5945,16716369,119941
2020-10-24,Colorado,08,93989,1922,2241,8,1144155,13254,93400,1828,1050755,11426
2020-10-24,Connecticut,09,66052,0,4577,0,2115744,0,66052,0,2049692,0
2020-10-24,Delaware,10,23847,160,680,2,337276,2164,23847,160,313429,2004
2020-10-24,District of Columbia,11,16706,97,642,0,491553,5800,16706,97,474847,5703
2020-10-24,Florida,12,776243,4471,16416,77,5928115,72219,766305,4381,5161810,67838
2020-10-24,Georgia,13,359001,1682,7625,41,3426110,18487,349605,1846,3076505,16641
2020-10-24,Guam,66,5144,34,72,2,63240,334,4175,34,59065,300
2020-10-24,Hawaii,15,14706,89,211,3,14669,140,14669,140,,0
2020-10-24,Idaho,16,58964,881,573,5,372818,3151,57673,1073,315145,2078
2020-10-24,Illinois,17,376034,5900,9765,61,7201568,83517,374907,6161,6826661,77356
2020-10-24,Indiana,18,162886,2741,4118,26,1618331,12735,160454,2741,1457877,9994
2020-10-24,Iowa,19,114952,1356,1634,5,859419,6470,108514,1640,750905,4830
2020-10-24,Kansas,20,78177,55,975,0,616262,0,76230,0,540032,0
2020-10-24,Kentucky,21,97501,1458,1469,7,1799931,22727,95480,1732,1704451,20995
2020-10-24,Louisiana,22,182603,0,5820,0,2671238,0,182603,0,2488635,0
2020-10-24,Maine,23,6137,42,146,0,574325,42,6137,42,568188,0
2020-10-24,Maryland,24,139859,674,4091,13,1866927,11633,139487,796,1727440,10837
2020-10-24,Massachusetts,25,149488,1203,9839,9,2618607,19243,149488,1203,2469119,18040
2020-10-24,Michigan,26,175385,3257,7522,37,4579991,54105,175612,3490,4404379,50615
2020-10-24,Minnesota,27,132175,2259,2381,14,1744115,9870,132122,2259,1611993,7611
2020-10-24,Mississippi,28,115088,1212,3255,17,844632,1212,115088,1212,729544,0
2020-10-24,Missouri,29,173746,1875,2854,90,1450015,10699,167452,2918,1282563,7781
2020-10-24,Montana,30,27149,549,295,12,464032,3032,27142,639,436890,2393
2020-10-24,Nebraska,31,63215,704,603,9,564275,4967,62510,1225,501765,3742
2020-10-24,Nevada,32,94935,891,1746,7,783707,3060,94812,1146,688895,1914
2020-10-24,New Hampshire,33,10238,126,473,2,329667,2922,10238,126,319429,2796
2020-10-24,New Jersey,34,229128,1909,16281,8,4348948,2206,236393,2206,4112555,0
2020-10-24,New Mexico,35,41040,872,965,5,1109095,9611,41040,872,1068055,8739
2020-10-24,New York,36,498568,2058,33049,11,13631293,156940,493832,2061,13137461,154879
2020-10-24,North Carolina,37,258439,2905,4170,30,3809077,45762,258292,2584,3550785,43178
2020-10-24,North Dakota,38,36879,935,453,8,281819,1998,37025,967,244794,1031
2020-10-24,Northern Mariana Islands,69,88,0,2,0,15811,0,88,0,15723,0
2020-10-24,Ohio,39,195806,2858,5206,22,4149769,48376,195806,2858,3953963,45518
2020-10-24,Oklahoma,40,115685,1829,1245,11,1532709,21157,115685,1829,1417024,19328
2020-10-24,Oregon,41,41739,382,654,3,815201,9200,41348,538,773853,8662
2020-10-24,Pennsylvania,42,197370,1711,8721,26,2407679,16232,192622,2043,2215057,14189
2020-10-24,Puerto Rico,72,61280,296,794,3,337044,116,31072,116,305972,0
2020-10-24,Rhode Island,44,30118,0,1177,0,416075,3225,30583,465,385492,2760
2020-10-24,South Carolina,45,169341,792,3793,16,1679084,11583,169341,792,1509743,10791
2020-10-24,South Dakota,46,38141,939,366,10,243680,2678,38141,939,205539,1739
2020-10-24,Tennessee,47,240191,2584,3067,24,3505140,26645,244087,2574,3261053,24071
2020-10-24,Texas,48,906657,7267,17998,124,7999540,69457,858071,6499,7141469,62958
2020-10-24,Utah,49,103137,1563,568,1,992734,8597,103117,1608,889617,6989
2020-10-24,Vermont,50,2043,27,58,0,182928,1641,2057,28,180871,1613
2020-10-24,Virgin Islands,78,1346,0,21,0,23435,0,1346,0,22089,0
2020-10-24,Virginia,51,172372,1088,3578,39,2500546,17205,172372,1088,2328174,16117
2020-10-24,Washington,53,106772,583,2396,0,2322866,22685,105280,849,2217586,21836
2020-10-24,West Virginia,54,21712,320,422,0,715690,5333,21712,320,693978,5013
2020-10-24,Wisconsin,55,205139,4660,1804,28,1962769,18231,205139,4673,1757630,13558
2020-10-24,Wyoming,56,10805,260,68,0,124491,260,10805,260,113686,0
2020-10-25,Alabama,01,184355,1079,2866,0,1329140,6942,184355,1079,1144785,5863
2020-10-25,Alaska,02,13968,529,64,0,559969,7223,13041,518,546928,6705
2020-10-25,Arizona,04,238200,1302,5874,4,1711869,12903,238163,1391,1473706,11512
2020-10-25,Arkansas,05,106115,797,1812,15,1295235,8112,106115,797,1189120,7315
2020-10-25,California,06,909344,2700,17358,13,17787885,178706,898029,5219,16889856,173487
2020-10-25,Colorado,08,95742,1753,2244,3,1156234,12079,95089,1689,1061145,10390
2020-10-25,Connecticut,09,66052,0,4577,0,2115744,0,66052,0,2049692,0
2020-10-25,Delaware,10,23961,114,681,1,339341,2065,23961,114,315380,1951
2020-10-25,District of Columbia,11,16767,61,642,0,496232,4679,16767,61,479465,4618
2020-10-25,Florida,12,778628,2385,16428,12,5942740,14625,768653,2348,5174087,12277
2020-10-25,Georgia,13,360344,1343,7626,1,3445032,18922,350923,1318,3094109,17604
2020-10-25,Guam,66,5185,41,72,0,63494,254,4216,41,59278,213
2020-10-25,Hawaii,15,14823,117,211,0,14758,89,14758,89,,0
2020-10-25,Idaho,16,59344,380,574,1,375527,2709,58694,1021,316833,1688
2020-10-25,Illinois,17,380065,4031,9788,23,7273665,72097,378969,4062,6894696,68035
2020-10-25,Indiana,18,165038,2152,4130,12,1629468,11137,162607,2153,1466861,8984
2020-10-25,Iowa,19,116238,1286,1635,1,863361,3942,109657,1143,753704,2799
2020-10-25,Kansas,20,78241,64,975,0,616262,0,76230,0,540032,0
2020-10-25,Kentucky,21,98730,1229,1472,3,1801393,1462,96942,1462,1704451,0
2020-10-25,Louisiana,22,183575,972,5837,17,2697507,26269,183575,972,2513932,25297
2020-10-25,Maine,23,6201,64,146,0,574389,64,6201,64,568188,0
2020-10-25,Maryland,24,140770,911,4096,5,1878929,12002,140279,792,1738650,11210
2020-10-25,Massachusetts,25,150565,1077,9864,25,2635607,17000,150565,1077,2485042,15923
2020-10-25,Michigan,26,175515,130,7522,0,4579991,0,175612,0,4404379,0
2020-10-25,Minnesota,27,133855,1680,2402,21,1770733,26618,133802,1680,1636931,24938
2020-10-25,Mississippi,28,115088,0,3255,0,844632,0,115088,0,729544,0
2020-10-25,Missouri,29,175243,1497,2857,3,1458840,8825,169495,2043,1289345,6782
2020-10-25,Montana,30,27880,731,298,3,465607,1575,27880,738,437727,837
2020-10-25,Nebraska,31,63797,582,604,1,567426,3151,63215,705,504211,2446
2020-10-25,Nevada,32,95798,863,1748,2,787869,4162,95703,891,692166,3271
2020-10-25,New Hampshire,33,10328,90,473,0,332193,2526,10328,90,321865,2436
2020-10-25,New Jersey,34,230257,1129,16285,4,4395214,46266,237800,1407,4157414,44859
2020-10-25,New Mexico,35,41863,823,967,2,1118844,9749,41863,823,1076981,8926
2020-10-25,New York,36,500201,1633,33059,10,13752123,120830,495464,1632,13256659,119198
2020-10-25,North Carolina,37,260128,1689,4183,13,3844453,35376,260099,1807,3584354,33569
2020-10-25,North Dakota,38,37724,845,461,8,283565,1746,37874,849,245691,897
2020-10-25,Northern Mariana Islands,69,88,0,2,0,15811,0,88,0,15723,0
2020-10-25,Ohio,39,198115,2309,5206,0,4199457,49688,198115,2309,4001342,47379
2020-10-25,Oklahoma,40,116736,1051,1249,4,1533760,1051,116736,1051,1417024,0
2020-10-25,Oregon,41,42101,362,654,0,821142,5941,41739,391,779403,5550
2020-10-25,Pennsylvania,42,198756,1386,8730,9,2424265,16586,194288,1666,2229977,14920
2020-10-25,Puerto Rico,72,62503,1223,801,7,337709,665,31737,665,305972,0
2020-10-25,Rhode Island,44,30118,0,1177,0,418420,2345,30857,274,387563,2071
2020-10-25,South Carolina,45,170678,1337,3802,9,1706414,27330,170678,1337,1535736,25993
2020-10-25,South Dakota,46,39203,1062,375,9,245930,2250,39203,1062,206727,1188
2020-10-25,Tennessee,47,243508,3317,3105,38,3546736,41596,247587,3500,3299149,38096
2020-10-25,Texas,48,910592,3935,18042,44,8036693,37153,862375,4304,7174318,32849
2020-10-25,Utah,49,105053,1916,572,4,1001239,8505,104882,1765,896357,6740
2020-10-25,Vermont,50,2073,30,58,0,183729,801,2087,30,181642,771
2020-10-25,Virgin Islands,78,1346,0,21,0,23435,0,1346,0,22089,0
2020-10-25,Virginia,51,173371,999,3579,1,2521816,21270,173371,999,2348445,20271
2020-10-25,Washington,53,107270,498,2396,0,2363589,40723,106115,835,2257474,39888
2020-10-25,West Virginia,54,21906,194,423,1,723207,7517,21906,194,701301,7323
2020-10-25,Wisconsin,55,208917,3778,1814,10,1976943,14174,208917,3778,1768026,10396
2020-10-25,Wyoming,56,11041,236,68,0,124727,236,11041,236,113686,0
2020-10-26,Alabama,01,185322,967,2866,0,1334315,5175,185322,967,1148993,4208
2020-10-26,Alaska,02,14316,348,64,0,570844,10875,13391,350,557453,10525
2020-10-26,Arizona,04,239193,993,5875,1,1720285,8416,238964,801,1481321,7615
2020-10-26,Arkansas,05,106727,612,1833,21,1302162,6927,106727,612,1195435,6315
2020-10-26,California,06,913699,4355,17398,40,17982829,194944,901010,2981,17081819,191963
2020-10-26,Colorado,08,97686,1944,2255,11,1175350,19116,97300,2211,1078050,16905
2020-10-26,Connecticut,09,68099,2047,4589,12,2207937,92193,68099,2047,2139838,90146
2020-10-26,Delaware,10,24168,207,685,4,342071,2730,24168,207,317903,2523
2020-10-26,District of Columbia,11,16812,45,642,0,498190,1958,16812,45,481378,1913
2020-10-26,Florida,12,782005,3377,16448,20,5974725,31985,771989,3336,5202736,28649
2020-10-26,Georgia,13,364275,3931,7644,18,3461388,16356,351881,958,3109507,15398
2020-10-26,Guam,66,5305,120,76,4,64454,960,4336,120,60118,840
2020-10-26,Hawaii,15,14858,35,211,0,14877,119,14877,119,,0
2020-10-26,Idaho,16,60400,1056,582,8,377823,2296,59344,650,318479,1646
2020-10-26,Illinois,17,385084,5019,9811,23,7330929,57264,383698,4729,6947231,52535
2020-10-26,Indiana,18,167010,1972,4143,13,1638232,8764,164581,1974,1473651,6790
2020-10-26,Iowa,19,117198,960,1657,22,866323,2962,110404,747,755919,2215
2020-10-26,Kansas,20,80473,2232,976,1,625931,9669,78676,2446,547255,7223
2020-10-26,Kentucky,21,99965,1235,1480,8,1824845,23452,97866,924,1726979,22528
2020-10-26,Louisiana,22,183802,227,5854,17,2702566,5059,183802,227,2518764,4832
2020-10-26,Maine,23,6254,53,146,0,588653,14264,6254,53,582399,14211
2020-10-26,Maryland,24,141334,564,4099,3,1888371,9442,140844,565,1747527,8877
2020-10-26,Massachusetts,25,151777,1212,9881,17,2655689,20082,151777,1212,2503912,18870
2020-10-26,Michigan,26,179624,4109,7551,29,4652388,72397,179669,4057,4472719,68340
2020-10-26,Minnesota,27,135425,1570,2406,4,1784312,13579,135372,1570,1648940,12009
2020-10-26,Mississippi,28,115763,675,3263,8,845307,675,115763,675,729544,0
2020-10-26,Missouri,29,177733,2490,2869,12,1465949,7109,171022,1527,1294927,5582
2020-10-26,Montana,30,28580,700,304,6,476325,10718,28501,621,447824,10097
2020-10-26,Nebraska,31,64506,709,609,5,569834,2408,63797,582,506037,1826
2020-10-26,Nevada,32,96330,532,1751,3,791321,3452,96178,475,695143,2977
2020-10-26,New Hampshire,33,10397,69,475,2,333764,1571,10397,69,323367,1502
2020-10-26,New Jersey,34,231473,1216,16292,7,4464845,69631,239295,1495,4225550,68136
2020-10-26,New Mexico,35,42586,723,976,9,1124922,6078,42586,723,1082336,5355
2020-10-26,New York,36,501393,1192,33073,14,13834240,82117,496655,1191,13337585,80926
2020-10-26,North Carolina,37,262159,2031,4200,17,3872913,28460,261742,1643,3611171,26817
2020-10-26,North Dakota,38,38246,522,466,5,284643,1078,38406,532,246237,546
2020-10-26,Northern Mariana Islands,69,92,4,2,0,15815,4,92,4,15723,0
2020-10-26,Ohio,39,200231,2116,5217,11,4235663,36206,200231,2116,4035432,34090
2020-10-26,Oklahoma,40,117399,663,1251,2,1534423,663,117399,663,1417024,0
2020-10-26,Oregon,41,42454,353,657,3,825250,4108,42101,362,783149,3746
2020-10-26,Pennsylvania,42,201248,2492,8737,7,2437125,12860,195695,1407,2241430,11453
2020-10-26,Puerto Rico,72,63135,632,804,3,338170,461,32198,461,305972,0
2020-10-26,Rhode Island,44,31024,906,1184,7,419892,1472,31024,167,388868,1305
2020-10-26,South Carolina,45,171501,823,3823,21,1733232,26818,171501,823,1561731,25995
2020-10-26,South Dakota,46,39741,538,375,0,247094,1164,39741,538,207353,626
2020-10-26,Tennessee,47,245760,2252,3132,27,3569435,22699,249866,2279,3319569,20420
2020-10-26,Texas,48,917240,6648,18077,35,8063288,26595,867075,4700,7196213,21895
2020-10-26,Utah,49,106083,1030,575,3,1006802,5563,106083,1201,900719,4362
2020-10-26,Vermont,50,2083,10,58,0,184153,424,2096,9,182057,415
2020-10-26,Virgin Islands,78,1348,2,21,0,23617,182,1348,2,22269,180
2020-10-26,Virginia,51,174275,904,3581,2,2537269,15453,174275,904,2362994,14549
2020-10-26,Washington,53,108393,1123,2428,32,2364178,589,106704,589,2257474,0
2020-10-26,West Virginia,54,22223,317,424,1,736376,13169,22223,317,714153,12852
2020-10-26,Wisconsin,55,212116,3199,1825,11,1989820,12877,211928,3011,1777892,9866
2020-10-26,Wyoming,56,11477,436,77,9,125163,436,11477,436,113686,0
2020-10-27,Alabama,01,186437,1115,2892,26,1339885,5570,186437,1115,1153448,4455
2020-10-27,Alaska,02,14699,383,66,2,577429,6585,13779,388,563650,6197
2020-10-27,Arizona,04,240158,965,5891,16,1730162,9877,240122,1158,1490040,8719
2020-10-27,Arkansas,05,107679,952,1857,24,1310854,8692,107679,952,1203175,7740
2020-10-27,California,06,918627,4928,17478,80,18127049,144220,904198,3188,17222851,141032
2020-10-27,Colorado,08,99111,1425,2265,10,1183754,8404,98733,1433,1085021,6971
2020-10-27,Connecticut,09,68637,538,4595,6,2221034,13097,68637,538,2152397,12559
2020-10-27,Delaware,10,24249,81,686,1,343141,1070,24249,81,318892,989
2020-10-27,District of Columbia,11,16906,94,644,2,502538,4348,16906,94,485632,4254
2020-10-27,Florida,12,786303,4298,16504,56,5991638,16913,776215,4226,5215423,12687
2020-10-27,Georgia,13,365498,1223,7661,17,3474891,13503,353372,1491,3121519,12012
2020-10-27,Guam,66,5387,82,76,0,65045,591,4418,82,60627,509
2020-10-27,Hawaii,15,14920,62,214,3,14914,37,14914,37,,0
2020-10-27,Idaho,16,61282,882,588,6,380532,2709,60041,697,320491,2012
2020-10-27,Illinois,17,389088,4004,9860,49,7393003,62074,387698,4000,7005305,58074
2020-10-27,Indiana,18,168996,1986,4194,51,1646542,8310,166564,1983,1479978,6327
2020-10-27,Iowa,19,118852,1654,1680,23,869020,2697,111261,857,757759,1840
2020-10-27,Kansas,20,80761,288,979,3,625931,0,78676,0,547255,0
2020-10-27,Kentucky,21,101700,1735,1493,13,1836688,11843,99637,1771,1737051,10072
2020-10-27,Louisiana,22,184724,922,5872,18,2723277,20711,184724,922,2538553,19789
2020-10-27,Maine,23,6311,57,146,0,595786,7133,6311,57,589475,7076
2020-10-27,Maryland,24,142237,903,4108,9,1898094,9723,141741,897,1756353,8826
2020-10-27,Massachusetts,25,153037,1260,9888,7,2669651,13962,153037,1260,2516614,12702
2020-10-27,Michigan,26,182284,2660,7585,34,4693470,41082,182344,2675,4511126,38407
2020-10-27,Minnesota,27,137589,2164,2421,15,1792078,7766,137536,2164,1654542,5602
2020-10-27,Mississippi,28,116617,854,3283,20,846161,854,116617,854,729544,0
2020-10-27,Missouri,29,179457,1724,2912,43,1474405,8456,172717,1695,1301688,6761
2020-10-27,Montana,30,29422,842,309,5,481322,4997,29346,845,451976,4152
2020-10-27,Nebraska,31,65376,870,623,14,572760,2926,64499,702,508261,2224
2020-10-27,Nevada,32,97138,808,1757,6,794921,3600,96908,730,698013,2870
2020-10-27,New Hampshire,33,10530,133,475,0,335084,1320,10531,134,324553,1186
2020-10-27,New Jersey,34,233120,1647,16306,14,4494858,30013,241376,2081,4253482,27932
2020-10-27,New Mexico,35,43169,583,980,4,1129419,4497,43169,583,1086250,3914
2020-10-27,New York,36,503387,1994,33092,19,13945858,111618,498646,1991,13447212,109627
2020-10-27,North Carolina,37,264334,2175,4236,36,3890764,17851,263883,2141,3626881,15710
2020-10-27,North Dakota,38,39135,889,481,15,286375,1732,39309,903,247066,829
2020-10-27,Northern Mariana Islands,69,92,0,2,0,16085,270,92,0,15993,270
2020-10-27,Ohio,39,202740,2509,5239,22,4282604,46941,202740,2509,4079864,44432
2020-10-27,Oklahoma,40,118409,1010,1273,22,1564476,30053,118409,1010,1446067,29043
2020-10-27,Oregon,41,42821,367,665,8,830284,5034,42436,335,787848,4699
2020-10-27,Pennsylvania,42,203520,2272,8760,23,2452969,15844,198446,2751,2254523,13093
2020-10-27,Puerto Rico,72,63497,362,808,4,338433,263,32461,263,305972,0
2020-10-27,Rhode Island,44,31445,421,1188,4,423469,3577,31445,421,392024,3156
2020-10-27,South Carolina,45,172579,1078,3842,19,1745026,11794,172579,1078,1572447,10716
2020-10-27,South Dakota,46,40730,989,375,0,249165,2071,40730,989,208435,1082
2020-10-27,Tennessee,47,247688,1928,3176,44,3586241,16806,251774,1908,3334467,14898
2020-10-27,Texas,48,924475,7235,18155,78,8150614,87326,874367,7292,7276247,80034
2020-10-27,Utah,49,107246,1163,579,4,1013395,6593,107228,1145,906167,5448
2020-10-27,Vermont,50,2113,30,58,0,185042,889,2127,31,182915,858
2020-10-27,Virgin Islands,78,1351,3,21,0,23659,42,1351,3,22308,39
2020-10-27,Virginia,51,175409,1134,3600,19,2555585,18316,175409,1134,2380176,17182
2020-10-27,Washington,53,108966,573,2438,10,2376148,11970,107052,348,2269096,11622
2020-10-27,West Virginia,54,22706,483,432,8,743737,7361,22706,483,721031,6878
2020-10-27,Wisconsin,55,217447,5331,1896,71,2006587,16767,217429,5501,1789158,11266
2020-10-27,Wyoming,56,11806,329,77,0,125492,329,11806,329,113686,0
2020-10-28,Alabama,01,187706,1269,2911,19,1347632,7747,187706,1269,1159926,6478
2020-10-28,Alaska,02,15053,354,67,1,580599,3170,14131,352,566468,2818
2020-10-28,Arizona,04,241259,1101,5906,15,1736979,6817,241165,1043,1495814,5774
2020-10-28,Arkansas,05,108640,961,1875,18,1320831,9977,108640,961,1212191,9016
2020-10-28,California,06,922680,4053,17541,63,18223596,96547,908713,4515,17314883,92032
2020-10-28,Colorado,08,100614,1503,2277,12,1191858,8104,100208,1475,1091650,6629
2020-10-28,Connecticut,09,69127,490,4604,9,2235373,14339,69127,490,2166246,13849
2020-10-28,Delaware,10,24392,143,688,2,344939,1798,24392,143,320547,1655
2020-10-28,District of Columbia,11,16973,67,644,0,505407,2869,16973,67,488434,2802
2020-10-28,Florida,12,790418,4115,16570,66,6030177,38539,780220,4005,5249957,34534
2020-10-28,Georgia,13,367126,1628,7692,31,3495407,20516,355025,1653,3140382,18863
2020-10-28,Guam,66,5435,48,77,1,65664,619,4466,48,61198,571
2020-10-28,Hawaii,15,14975,55,212,-2,14978,64,14978,64,,0
2020-10-28,Idaho,16,62197,915,600,12,382784,2252,60923,882,321861,1370
2020-10-28,Illinois,17,395204,6116,9912,52,7463755,70752,393808,6110,7069947,64642
2020-10-28,Indiana,18,171566,2570,4227,33,1657090,10548,169112,2548,1487978,8000
2020-10-28,Iowa,19,120911,2059,1691,11,873362,4342,113042,1781,760320,2561
2020-10-28,Kansas,20,83485,2724,1007,28,633033,7102,82045,3369,550988,3733
2020-10-28,Kentucky,21,103685,1985,1509,16,1847286,10598,101494,1857,1745792,8741
2020-10-28,Louisiana,22,185822,1098,5890,18,2738401,15124,185822,1098,2552579,14026
2020-10-28,Maine,23,6387,76,146,0,603303,7517,6387,76,596916,7441
2020-10-28,Maryland,24,142918,681,4115,7,1905952,7858,142425,684,1763527,7174
2020-10-28,Massachusetts,25,154218,1181,9924,36,2688340,18689,154218,1181,2534122,17508
2020-10-28,Michigan,26,185818,3534,7606,21,4748002,54532,185934,3590,4562068,50942
2020-10-28,Minnesota,27,139497,1908,2440,19,1801504,9426,139444,1908,1662060,7518
2020-10-28,Mississippi,28,117617,1000,3302,19,881604,35443,117617,1000,763987,34443
2020-10-28,Missouri,29,181877,2420,2940,28,1481236,6831,174632,1915,1306604,4916
2020-10-28,Montana,30,30051,629,326,17,484470,3148,29966,620,454504,2528
2020-10-28,Nebraska,31,66545,1169,629,6,577023,4263,65376,877,511647,3386
2020-10-28,Nevada,32,97824,686,1767,10,798250,3329,97479,571,700771,2758
2020-10-28,New Hampshire,33,10641,111,478,3,336791,1707,10641,110,326150,1597
2020-10-28,New Jersey,34,234790,1670,16324,18,4534005,39147,243391,2015,4290614,37132
2020-10-28,New Mexico,35,43826,657,991,11,1141186,11767,43826,657,1097360,11110
2020-10-28,New York,36,505416,2029,33107,15,14075518,129660,500677,2031,13574841,127629
2020-10-28,North Carolina,37,266566,2232,4275,39,3923042,32278,266136,2253,3656906,30025
2020-10-28,North Dakota,38,39912,777,493,12,287744,1369,40127,818,247617,551
2020-10-28,Northern Mariana Islands,69,92,0,2,0,16085,0,92,0,15993,0
2020-10-28,Ohio,39,205347,2607,5256,17,4314037,31433,205347,2607,4108690,28826
2020-10-28,Oklahoma,40,119152,743,1286,13,1575866,11390,119152,743,1456714,10647
2020-10-28,Oregon,41,43228,407,673,8,836995,6711,42808,372,794187,6339
2020-10-28,Pennsylvania,42,205852,2332,8789,29,2469920,16951,200674,2228,2269246,14723
2020-10-28,Puerto Rico,72,63587,90,813,5,338499,66,32527,66,305972,0
2020-10-28,Rhode Island,44,31944,499,1192,4,426355,2886,31944,499,394411,2387
2020-10-28,South Carolina,45,173491,912,3876,34,1753781,8755,173491,912,1580290,7843
2020-10-28,South Dakota,46,42000,1270,384,9,251296,2131,42000,1270,209296,861
2020-10-28,Tennessee,47,250269,2581,3209,33,3608613,22372,254220,2446,3354393,19926
2020-10-28,Texas,48,932245,7770,18251,96,8237976,87362,879994,5627,7357982,81735
2020-10-28,Utah,49,108863,1617,588,9,1019962,6567,108803,1575,911159,4992
2020-10-28,Vermont,50,2120,7,58,0,185577,535,2138,11,183439,524
2020-10-28,Virgin Islands,78,1353,2,21,0,23945,286,1353,2,22592,284
2020-10-28,Virginia,51,176754,1345,3616,16,2575759,20174,176754,1345,2399005,18829
2020-10-28,Washington,53,109865,899,2454,16,2366753,-9395,108185,1133,2258568,-10528
2020-10-28,West Virginia,54,23064,358,436,4,748959,5222,23064,358,725895,4864
2020-10-28,Wisconsin,55,221578,4131,1953,57,2016720,10133,221559,4130,1795161,6003
2020-10-28,Wyoming,56,12146,340,77,0,125832,340,12146,340,113686,0
2020-10-29,Alabama,01,189149,1443,2914,3,1355047,7415,189149,1443,1165898,5972
2020-10-29,Alaska,02,15417,364,72,5,584268,3669,14481,350,569787,3319
2020-10-29,Arizona,04,242510,1251,5920,14,1751307,14328,242480,1315,1508827,13013
2020-10-29,Arkansas,05,109712,1072,1894,19,1333414,12583,109712,1072,1223702,11511
2020-10-29,California,06,926893,4213,17567,26,18323771,100175,912904,4191,17410867,95984
2020-10-29,Colorado,08,102665,2051,2295,18,1203209,11351,102014,1806,1101195,9545
2020-10-29,Connecticut,09,70446,1319,4609,5,2257892,22519,70446,1319,2187446,21200
2020-10-29,Delaware,10,24553,161,689,1,346423,1484,24553,161,321870,1323
2020-10-29,District of Columbia,11,17074,101,645,1,509864,4457,17074,101,492790,4356
2020-10-29,Florida,12,794616,4198,16647,77,6068498,38321,784331,4111,5284167,34210
2020-10-29,Georgia,13,368840,1714,7737,45,3516162,20755,356848,1823,3159314,18932
2020-10-29,Guam,66,5518,83,79,2,66385,721,4549,83,61836,638
2020-10-29,Hawaii,15,15046,71,214,2,15039,61,15039,61,,0
2020-10-29,Idaho,16,63195,998,618,18,385806,3022,61785,862,324021,2160
2020-10-29,Illinois,17,401622,6418,9963,51,7546811,83056,400171,6363,7146640,76693
2020-10-29,Indiana,18,175190,3624,4260,33,1671093,14003,172730,3618,1498363,10385
2020-10-29,Iowa,19,123232,2321,1705,14,878864,5502,114982,1940,763882,3562
2020-10-29,Kansas,20,83838,353,1008,1,633033,0,82045,0,550988,0
2020-10-29,Kentucky,21,105517,1832,1524,15,1857453,10167,103305,1811,1754148,8356
2020-10-29,Louisiana,22,186216,394,5908,18,2751797,13396,186216,394,2565581,13002
2020-10-29,Maine,23,6467,80,146,0,611912,8609,6467,80,605445,8529
2020-10-29,Maryland,24,143875,957,4127,12,1916848,10896,143387,962,1773461,9934
2020-10-29,Massachusetts,25,155564,1346,9951,27,2706776,18436,155564,1346,2551212,17090
2020-10-29,Michigan,26,189926,4108,7651,45,4800717,52715,190043,4109,4610674,48606
2020-10-29,Minnesota,27,142364,2867,2472,32,1820395,18891,142311,2867,1678084,16024
2020-10-29,Mississippi,28,118587,970,3310,8,922851,41247,118587,970,804264,40277
2020-10-29,Missouri,29,184847,2970,2978,38,1490617,9381,177693,3061,1312924,6320
2020-10-29,Montana,30,30932,881,339,13,487607,3137,30853,887,456754,2250
2020-10-29,Nebraska,31,68150,1605,641,12,580729,3706,66545,1169,514184,2537
2020-10-29,Nevada,32,98814,990,1770,3,798618,368,98554,1075,700064,-707
2020-10-29,New Hampshire,33,10768,127,482,4,339260,2469,10768,127,328492,2342
2020-10-29,New Jersey,34,236340,1550,16332,8,4583348,49343,245364,1973,4337984,47370
2020-10-29,New Mexico,35,44904,1078,994,3,1153185,11999,44904,1078,1108281,10921
2020-10-29,New York,36,507913,2497,33128,21,14243871,168353,503176,2499,13740695,165854
2020-10-29,North Carolina,37,269419,2853,4307,32,3961343,38301,269021,2885,3692322,35416
2020-10-29,North Dakota,38,41135,1223,504,11,289745,2001,41355,1228,248390,773
2020-10-29,Northern Mariana Islands,69,92,0,2,0,16085,0,92,0,15993,0
2020-10-29,Ohio,39,208937,3590,5275,19,4365090,51053,208937,3590,4156153,47463
2020-10-29,Oklahoma,40,120193,1041,1306,20,1586185,10319,120193,1041,1465992,9278
2020-10-29,Oregon,41,43793,565,674,1,841049,4054,43228,420,797821,3634
2020-10-29,Pennsylvania,42,208087,2235,8828,39,2485704,15784,202876,2202,2282828,13582
2020-10-29,Puerto Rico,72,64798,1211,814,1,339251,752,33279,752,305972,0
2020-10-29,Rhode Island,44,32312,368,1195,3,429340,2985,32312,368,397028,2617
2020-10-29,South Carolina,45,174591,1100,3889,13,1773742,19961,174591,1100,1599151,18861
2020-10-29,South Dakota,46,43000,1000,403,19,253514,2218,43000,1000,210514,1218
2020-10-29,Tennessee,47,252727,2458,3229,20,3637643,29030,256880,2660,3380763,26370
2020-10-29,Texas,48,939355,7110,18372,121,8318780,80804,886820,6826,7431960,73978
2020-10-29,Utah,49,110666,1803,598,10,1029872,9910,110640,1837,919232,8073
2020-10-29,Vermont,50,2141,21,58,0,186570,993,2154,16,184416,977
2020-10-29,Virgin Islands,78,1353,0,21,0,23945,0,1353,0,22592,0
2020-10-29,Virginia,51,178183,1429,3636,20,2596604,20845,178183,1429,2418421,19416
2020-10-29,Washington,53,110748,883,2463,9,2387849,21096,109260,1075,2278589,20021
2020-10-29,West Virginia,54,23466,402,443,7,759646,10687,23466,402,736180,10285
2020-10-29,Wisconsin,55,226712,5134,2008,55,2030170,13450,226705,5146,1803465,8304
2020-10-29,Wyoming,56,12507,361,87,10,129462,3630,12507,361,116955,3269
2020-10-30,Alabama,01,190496,1347,2932,18,1363465,8418,190496,1347,1172969,7071
2020-10-30,Alaska,02,15803,386,76,4,586323,2055,14858,377,571465,1678
2020-10-30,Arizona,04,244099,1589,5934,14,1764784,13477,244045,1565,1520739,11912
2020-10-30,Arkansas,05,110874,1162,1900,6,1345040,11626,110874,1162,1234166,10464
2020-10-30,California,06,931826,4933,17627,60,18444523,120752,916918,4014,17527605,116738
2020-10-30,Colorado,08,104927,2262,2302,7,1214467,11258,104426,2412,1110041,8846
2020-10-30,Connecticut,09,71207,761,4616,7,2288584,30692,71207,761,2217377,29931
2020-10-30,Delaware,10,24751,198,704,15,348527,2104,24751,198,323776,1906
2020-10-30,District of Columbia,11,17144,70,646,1,514130,4266,17144,70,496986,4196
2020-10-30,Florida,12,800208,5592,16719,72,6073881,5383,789714,5383,5284167,0
2020-10-30,Georgia,13,370157,1317,7768,31,3559307,43145,358225,1377,3201082,41768
2020-10-30,Guam,66,5597,79,80,1,67029,644,4628,79,62401,565
2020-10-30,Hawaii,15,15145,99,215,1,15116,77,15116,77,,0
2020-10-30,Idaho,16,64175,980,627,9,388785,2979,62746,961,326039,2018
2020-10-30,Illinois,17,410141,8519,10012,49,7643468,96657,408660,8489,7234808,88168
2020-10-30,Indiana,18,178372,3182,4286,26,1684783,13690,175893,3163,1508890,10527
2020-10-30,Iowa,19,125973,2741,1714,9,884252,5388,117185,2203,767067,3185
2020-10-30,Kansas,20,86768,2930,1029,21,642782,9749,85181,3136,557601,6613
2020-10-30,Kentucky,21,107620,2103,1543,19,1892860,35407,105242,1937,1787618,33470
2020-10-30,Louisiana,22,186649,433,5919,11,2763671,11874,186649,433,2577022,11441
2020-10-30,Maine,23,6570,103,146,0,623413,11501,6570,103,616843,11398
2020-10-30,Maryland,24,144800,925,4137,10,1926518,9670,144314,927,1782204,8743
2020-10-30,Massachusetts,25,157146,1582,9975,24,2727118,20342,157146,1582,2569972,18760
2020-10-30,Michigan,26,193360,3434,7664,13,4862083,61366,193388,3345,4668695,58021
2020-10-30,Minnesota,27,145519,3155,2491,19,1836799,16404,145465,3154,1691334,13250
2020-10-30,Mississippi,28,119336,749,3328,18,923600,749,119336,749,804264,0
2020-10-30,Missouri,29,187830,2983,3014,36,1499282,8665,180200,2507,1319082,6158
2020-10-30,Montana,30,31995,1063,368,29,492629,5022,31916,1063,460713,3959
2020-10-30,Nebraska,31,69645,1495,646,5,586098,5369,68150,1605,517948,3764
2020-10-30,Nevada,32,100038,1224,1777,7,803585,4967,99786,1232,703799,3735
2020-10-30,New Hampshire,33,10884,116,482,0,339484,224,10884,116,328600,108
2020-10-30,New Jersey,34,238316,1976,16339,7,4585746,2398,247762,2398,4337984,0
2020-10-30,New Mexico,35,45909,1005,1007,13,1161887,8702,45909,1005,1115978,7697
2020-10-30,New York,36,510171,2258,33143,15,14390756,146885,505431,2255,13885325,144630
2020-10-30,North Carolina,37,272231,2812,4354,47,4005791,44448,271830,2809,3733961,41639
2020-10-30,North Dakota,38,42488,1353,517,13,292188,2443,42733,1378,249455,1065
2020-10-30,Northern Mariana Islands,69,92,0,2,0,16085,0,92,0,15993,0
2020-10-30,Ohio,39,212782,3845,5291,16,4413936,48846,212782,3845,4201154,45001
2020-10-30,Oklahoma,40,121495,1302,1326,20,1601775,15590,121495,1302,1480280,14288
2020-10-30,Oregon,41,44388,595,677,3,848795,7746,43793,565,805002,7181
2020-10-30,Pennsylvania,42,210586,2499,8860,32,2503500,17796,205517,2641,2297983,15155
2020-10-30,Puerto Rico,72,65743,945,820,6,339825,574,33853,574,305972,0
2020-10-30,Rhode Island,44,32874,562,1201,6,432876,3536,32874,562,400002,2974
2020-10-30,South Carolina,45,175594,1003,3896,7,1788360,14618,175594,1003,1612766,13615
2020-10-30,South Dakota,46,44559,1559,415,12,256656,3142,44559,1559,212097,1583
2020-10-30,Tennessee,47,255332,2605,3307,78,3662089,24446,259488,2608,3402601,21838
2020-10-30,Texas,48,946023,6668,18477,105,8400469,81689,893451,6631,7507018,75058
2020-10-30,Utah,49,112932,2266,601,3,1039515,9643,112932,2292,926583,7351
2020-10-30,Vermont,50,2155,14,58,0,187145,575,2173,19,184972,556
2020-10-30,Virgin Islands,78,1362,9,21,0,24219,274,1362,9,22857,265
2020-10-30,Virginia,51,179639,1456,3643,7,2619752,23148,179639,1456,2440113,21692
2020-10-30,Washington,53,111893,1145,2468,5,2410157,22308,110362,1102,2299795,21206
2020-10-30,West Virginia,54,23990,524,451,8,769302,9656,23990,524,745312,9132
2020-10-30,Wisconsin,55,232092,5380,2034,26,2049123,18953,232062,5357,1817061,13596
2020-10-30,Wyoming,56,13028,521,87,0,129983,521,13028,521,116955,0
2020-10-31,Alabama,01,192285,1789,2967,35,1374243,10778,192285,1789,1181958,8989
2020-10-31,Alaska,02,16247,444,77,1,604207,17884,15312,454,588895,17430
2020-10-31,Arizona,04,245962,1863,5979,45,1777369,12585,245946,1901,1531423,10684
2020-10-31,Arkansas,05,112190,1316,1925,25,1355680,10640,112190,1316,1243490,9324
2020-10-31,California,06,935248,3422,17661,34,18602317,157794,922005,5087,17680312,152707
2020-10-31,Colorado,08,107844,2917,2309,7,1229406,14939,107350,2924,1122056,12015
2020-10-31,Connecticut,09,71207,0,4616,0,2288584,0,71207,0,2217377,0
2020-10-31,Delaware,10,24951,200,708,4,350728,2201,24951,200,325777,2001
2020-10-31,District of Columbia,11,17266,122,646,0,514252,122,17266,122,496986,0
2020-10-31,Florida,12,802539,2331,16760,41,6126792,52911,791997,2283,5334795,50628
2020-10-31,Georgia,13,372631,2474,7790,22,3586394,27087,360790,2565,3225604,24522
2020-10-31,Guam,66,5650,53,80,0,67452,423,4681,53,62771,370
2020-10-31,Hawaii,15,15207,62,218,3,15216,100,15216,100,,0
2020-10-31,Idaho,16,64797,622,630,3,391890,3105,63810,1064,328080,2041
2020-10-31,Illinois,17,416557,6416,10030,18,7736104,92636,416559,7899,7319545,84737
2020-10-31,Indiana,18,181837,3465,4332,46,1699008,14225,179358,3465,1519650,10760
2020-10-31,Iowa,19,128798,2825,1716,2,890432,6180,119755,2570,770677,3610
2020-10-31,Kansas,20,86771,3,1029,0,642782,0,85181,0,557601,0
2020-10-31,Kentucky,21,109244,1624,1551,8,1912810,19950,107219,1977,1805591,17973
2020-10-31,Louisiana,22,186649,0,5919,0,2763671,0,186649,0,2577022,0
2020-10-31,Maine,23,6668,98,147,1,623511,98,6668,98,616843,0
2020-10-31,Maryland,24,145593,793,4147,10,1938672,12154,145281,967,1793391,11187
2020-10-31,Massachusetts,25,158576,1430,9991,16,2745378,18260,158576,1430,2586802,16830
2020-10-31,Michigan,26,197164,3804,7699,35,4911592,49509,197406,4018,4714186,45491
2020-10-31,Minnesota,27,148526,3007,2511,20,1854258,17459,148472,3007,1705786,14452
2020-10-31,Mississippi,28,120160,824,3334,6,924424,824,120160,824,804264,0
2020-10-31,Missouri,29,189925,2095,3090,76,1510155,10873,183186,2986,1326969,7887
2020-10-31,Montana,30,32801,806,377,9,498915,6286,32801,885,466114,5401
2020-10-31,Nebraska,31,70732,1087,652,6,591018,4920,69645,1495,521373,3425
2020-10-31,Nevada,32,100844,806,1779,2,808487,4902,100763,977,707724,3925
2020-10-31,New Hampshire,33,11084,200,483,1,345932,6448,11084,200,334848,6248
2020-10-31,New Jersey,34,239679,1363,16350,11,4667733,81987,249513,1751,4418220,80236
2020-10-31,New Mexico,35,46490,581,1018,11,1172720,10833,46490,581,1126230,10252
2020-10-31,New York,36,512223,2052,33152,9,14527718,136962,507480,2049,14020238,134913
2020-10-31,North Carolina,37,274805,2574,4400,46,4055156,49365,274635,2805,3780521,46560
2020-10-31,North Dakota,38,43921,1433,529,12,294342,2154,44194,1461,250148,693
2020-10-31,Northern Mariana Islands,69,92,0,2,0,16085,0,92,0,15993,0
2020-10-31,Ohio,39,215697,2915,5301,10,4471680,57744,215697,2915,4255983,54829
2020-10-31,Oklahoma,40,122762,1267,1337,11,1617394,15619,122762,1267,1494632,14352
2020-10-31,Oregon,41,44923,535,690,13,854938,6143,44389,596,810549,5547
2020-10-31,Pennsylvania,42,212816,2230,8883,23,2522661,19161,208027,2510,2314634,16651
2020-10-31,Puerto Rico,72,66128,385,822,2,340110,285,34138,285,305972,0
2020-10-31,Rhode Island,44,32874,0,1201,0,436561,3685,33408,534,403153,3151
2020-10-31,South Carolina,45,176612,1018,3935,39,1802050,13690,176612,1018,1625438,12672
2020-10-31,South Dakota,46,45992,1433,425,10,259532,2876,45992,1433,213540,1443
2020-10-31,Tennessee,47,256923,1591,3322,15,3671773,9684,260672,1184,3411101,8500
2020-10-31,Texas,48,953451,7428,18549,72,8479525,79056,900596,7145,7578929,71911
2020-10-31,Utah,49,114670,1738,604,3,1046819,7304,114656,1724,932163,5580
2020-10-31,Vermont,50,2179,24,58,0,188152,1007,2195,22,185957,985
2020-10-31,Virgin Islands,78,1376,14,21,0,24430,211,1376,14,23054,197
2020-10-31,Virginia,51,181190,1551,3654,11,2639539,19787,181190,1551,2458349,18236
2020-10-31,Washington,53,112580,687,2468,0,2431419,21262,111607,1245,2319812,20017
2020-10-31,West Virginia,54,24460,470,457,6,778494,9192,24460,470,754034,8722
2020-10-31,Wisconsin,55,237870,5778,2092,58,2064506,15383,237870,5808,1826636,9575
2020-10-31,Wyoming,56,13298,270,87,0,130560,577,13298,270,117262,307
2020-11-01,Alabama,01,193985,1700,2973,6,1381326,7083,193985,1700,1187341,5383
2020-11-01,Alaska,02,16597,350,78,1,604207,0,15663,351,588544,-351
2020-11-01,Arizona,04,247484,1522,5981,2,1791644,14275,247473,1527,1544171,12748
2020-11-01,Arkansas,05,113057,867,1958,33,1355680,0,112190,0,1243490,0
2020-11-01,California,06,938883,3635,17671,10,18743315,140998,926534,4529,17816781,136469
2020-11-01,Colorado,08,110640,2796,2312,3,1243467,14061,109910,2560,1133557,11501
2020-11-01,Connecticut,09,71207,0,4616,0,2288584,0,71207,0,2217377,0
2020-11-01,Delaware,10,25126,175,710,2,352348,1620,25126,175,327222,1445
2020-11-01,District of Columbia,11,17369,103,646,0,525246,10994,17369,103,507877,10891
2020-11-01,Florida,12,807404,4865,16788,28,6175891,49099,796802,4805,5379089,44294
2020-11-01,Georgia,13,373700,1069,7792,2,3587586,1192,361982,1192,3225604,0
2020-11-01,Guam,66,5659,9,80,0,67563,111,4690,9,62873,102
2020-11-01,Hawaii,15,15287,80,218,0,15284,68,15284,68,,0
2020-11-01,Idaho,16,65272,475,631,1,394191,2301,64608,798,329583,1503
2020-11-01,Illinois,17,424860,8303,10091,61,7814562,78458,423539,6980,7391023,71478
2020-11-01,Indiana,18,184589,2752,4364,32,1709944,10936,182108,2750,1527836,8186
2020-11-01,Iowa,19,131097,2299,1733,17,897175,6743,121967,2212,775208,4531
2020-11-01,Kansas,20,86809,38,1029,0,642782,0,85181,0,557601,0
2020-11-01,Kentucky,21,110600,1356,1554,3,1914233,1423,108642,1423,1805591,0
2020-11-01,Louisiana,22,187720,1071,5926,7,2783118,19447,187720,1071,2595398,18376
2020-11-01,Maine,23,6715,47,147,0,623558,47,6715,47,616843,0
2020-11-01,Maryland,24,146627,1034,4152,5,1949180,10508,146145,864,1803035,9644
2020-11-01,Massachusetts,25,159707,1131,10013,22,2762094,16716,159707,1131,2602387,15585
2020-11-01,Michigan,26,197501,337,7700,1,4911592,0,197406,0,4714186,0
2020-11-01,Minnesota,27,150726,2200,2529,18,1869845,15587,150672,2200,1719173,13387
2020-11-01,Mississippi,28,120500,340,3348,14,924764,340,120500,340,804264,0
2020-11-01,Missouri,29,192141,2216,3091,1,1518716,8561,185535,2349,1333181,6212
2020-11-01,Montana,30,33495,694,378,1,501704,2789,33495,694,468209,2095
2020-11-01,Nebraska,31,71666,934,658,6,594432,3414,70732,1087,523700,2327
2020-11-01,Nevada,32,101594,750,1783,4,813190,4703,101479,716,711711,3987
2020-11-01,New Hampshire,33,11214,130,483,0,348010,2078,11214,130,336796,1948
2020-11-01,New Jersey,34,241422,1743,16354,4,4669859,2126,251639,2126,4418220,0
2020-11-01,New Mexico,35,47232,742,1026,8,1182514,9794,47232,742,1135282,9052
2020-11-01,New York,36,514482,2259,33174,22,14676653,148935,509735,2255,14166918,146680
2020-11-01,North Carolina,37,276706,1901,4405,5,4095365,40209,276692,2057,3818673,38152
2020-11-01,North Dakota,38,45048,1127,536,7,296094,1752,45344,1150,250750,602
2020-11-01,Northern Mariana Islands,69,96,4,2,0,16089,4,96,4,15993,0
2020-11-01,Ohio,39,219000,3303,5303,2,4524758,53078,219000,3303,4305758,49775
2020-11-01,Oklahoma,40,124111,1349,1345,8,1618743,1349,124111,1349,1494632,0
2020-11-01,Oregon,41,45419,496,691,1,861949,7011,44921,532,817028,6479
2020-11-01,Pennsylvania,42,214500,1684,8888,5,2537746,15085,209936,1909,2327810,13176
2020-11-01,Puerto Rico,72,66661,533,832,10,340513,403,34541,403,305972,0
2020-11-01,Rhode Island,44,32874,0,1201,0,439334,2773,33888,480,405446,2293
2020-11-01,South Carolina,45,178023,1411,3936,1,1827352,25302,178023,1411,1649329,23891
2020-11-01,South Dakota,46,47324,1332,437,12,262165,2633,47324,1332,214841,1301
2020-11-01,Tennessee,47,257658,735,3322,0,3683173,11400,261426,754,3421747,10646
2020-11-01,Texas,48,957789,4338,18582,33,8585378,105853,972330,71734,7613048,34119
2020-11-01,Utah,49,116510,1840,614,10,1053391,6572,116510,1854,936881,4718
2020-11-01,Vermont,50,2196,17,58,0,188584,432,2212,17,186372,415
2020-11-01,Virgin Islands,78,1376,0,21,0,24430,0,1376,0,23054,0
2020-11-01,Virginia,51,182392,1202,3655,1,2661376,21837,182392,1202,2478984,20635
2020-11-01,Washington,53,113109,529,2468,0,2455375,23956,112754,1147,2342621,22809
2020-11-01,West Virginia,54,24883,423,457,0,787586,9092,24883,423,762703,8669
2020-11-01,Wisconsin,55,241423,3553,2110,18,2082628,18122,241423,3553,1841205,14569
2020-11-01,Wyoming,56,13723,425,87,0,130985,425,13723,425,117262,0
2020-11-02,Alabama,01,194892,907,2973,0,1385328,4002,194892,907,1190436,3095
2020-11-02,Alaska,02,16948,351,79,1,620170,15963,16007,344,604163,15619
2020-11-02,Arizona,04,248293,809,5982,1,1798521,6877,248139,666,1550382,6211
2020-11-02,Arkansas,05,113641,584,1985,27,1372367,16687,113641,1451,1258726,15236
2020-11-02,California,06,944141,5258,17700,29,18912501,169186,930628,4094,17981873,165092
2020-11-02,Colorado,08,112821,2181,2320,8,1256328,12861,112147,2237,1144181,10624
2020-11-02,Connecticut,09,73858,2651,4627,11,2367994,79410,73858,2651,2294136,76759
2020-11-02,Delaware,10,25311,185,710,0,354670,2322,25311,185,329359,2137
2020-11-02,District of Columbia,11,17438,69,647,1,528174,2928,17438,69,510736,2859
2020-11-02,Florida,12,812055,4651,16833,45,6200385,24494,801371,4569,5399014,19925
2020-11-02,Georgia,13,377261,3561,7810,18,3596700,9114,362921,939,3233779,8175
2020-11-02,Guam,66,5662,3,80,0,67664,101,4693,3,62971,98
2020-11-02,Hawaii,15,15359,72,218,0,15367,83,15367,83,,0
2020-11-02,Idaho,16,66249,977,641,10,396267,2076,65088,480,331179,1596
2020-11-02,Illinois,17,431281,6421,10115,24,7882680,68118,429761,6222,7452919,61896
2020-11-02,Indiana,18,187665,3076,4390,26,1722842,12898,185185,3077,1537657,9821
2020-11-02,Iowa,19,132697,1600,1755,22,900994,3819,123372,1405,777622,2414
2020-11-02,Kansas,20,90613,3804,1046,17,655267,12485,89227,4046,566040,8439
2020-11-02,Kentucky,21,111816,1216,1565,11,1943582,29349,109670,1028,1833912,28321
2020-11-02,Louisiana,22,187995,275,5934,8,2788484,5366,187995,275,2600489,5091
2020-11-02,Maine,23,6799,84,148,1,644435,20877,6799,84,637636,20793
2020-11-02,Maryland,24,147477,850,4155,3,1960445,11265,146995,850,1813450,10415
2020-11-02,Massachusetts,25,160549,842,10023,10,2776247,14153,160549,842,2615698,13311
2020-11-02,Michigan,26,204135,6634,7716,16,5008299,96707,204326,6920,4803973,89787
2020-11-02,Minnesota,27,153674,2948,2538,9,1892909,23064,153620,2948,1739289,20116
2020-11-02,Mississippi,28,120865,365,3348,0,958073,33309,120865,365,837208,32944
2020-11-02,Missouri,29,195938,3797,3101,10,1528098,9382,188186,2651,1339912,6731
2020-11-02,Montana,30,34317,822,387,9,508931,7227,34252,757,474679,6470
2020-11-02,Nebraska,31,72631,965,659,1,597204,2772,71666,934,525538,1838
2020-11-02,Nevada,32,102243,649,1785,2,816433,3243,102114,635,714319,2608
2020-11-02,New Hampshire,33,11320,106,483,0,349092,1082,11320,106,337772,976
2020-11-02,New Jersey,34,242790,1368,16357,3,4734234,64375,253434,1795,4480800,62580
2020-11-02,New Mexico,35,48104,872,1036,10,1191327,8813,48104,872,1143223,7941
2020-11-02,New York,36,516114,1632,33187,13,14772754,96101,511368,1633,14261386,94468
2020-11-02,North Carolina,37,278477,1771,4413,8,4127596,32231,278028,1336,3849568,30895
2020-11-02,North Dakota,38,46020,972,545,9,297743,1649,46311,967,251432,682
2020-11-02,Northern Mariana Islands,69,96,0,2,0,16089,0,96,0,15993,0
2020-11-02,Ohio,39,221909,2909,5340,37,4564903,40145,221909,2909,4342994,37236
2020-11-02,Oklahoma,40,125195,1084,1354,9,1619827,1084,125195,1084,1494632,0
2020-11-02,Oregon,41,45978,559,694,3,867792,5843,45429,508,822363,5335
2020-11-02,Pennsylvania,42,217243,2743,8893,5,2550660,12914,211996,2060,2338664,10854
2020-11-02,Puerto Rico,72,68172,1511,839,7,341377,864,35405,864,305972,0
2020-11-02,Rhode Island,44,34120,1246,1210,9,440626,1292,34120,232,406506,1060
2020-11-02,South Carolina,45,178917,894,3946,10,1842038,14686,178917,894,1663121,13792
2020-11-02,South Dakota,46,47850,526,438,1,263137,972,47850,526,215287,446
2020-11-02,Tennessee,47,260275,2617,3347,25,3720657,37484,264587,3161,3456070,34323
2020-11-02,Texas,48,965780,7991,18626,44,8612713,27335,977785,5455,7634928,21880
2020-11-02,Utah,49,117767,1257,614,0,1061170,7779,117706,1196,943464,6583
2020-11-02,Vermont,50,2219,23,58,0,188852,268,2235,23,186617,245
2020-11-02,Virgin Islands,78,1376,0,21,0,24519,89,1378,2,23141,87
2020-11-02,Virginia,51,183418,1026,3658,3,2677061,15685,183418,1026,2493643,14659
2020-11-02,Washington,53,114787,1678,2484,16,2474372,18997,113541,787,2360831,18210
2020-11-02,West Virginia,54,25235,352,458,1,794491,6905,25235,352,769256,6553
2020-11-02,Wisconsin,55,244974,3551,2117,7,2091546,8918,244928,3505,1846618,5413
2020-11-02,Wyoming,56,14167,444,87,0,134018,3033,14167,444,119851,2589
2020-11-03,Alabama,01,195929,1037,2987,14,1392351,7023,195929,1037,1196422,5986
2020-11-03,Alaska,02,17339,391,79,0,624755,4585,16390,383,608365,4202
2020-11-03,Arizona,04,249841,1548,6022,40,1809271,10750,249818,1679,1559453,9071
2020-11-03,Arkansas,05,114519,878,2003,18,1378181,5814,114519,878,1263662,4936
2020-11-03,California,06,949383,5242,17751,51,19074921,162420,934672,4044,18140249,158376
2020-11-03,Colorado,08,115364,2543,2337,17,1267145,10817,114709,2562,1152436,8255
2020-11-03,Connecticut,09,74843,985,4635,8,2367994,0,73858,0,2294136,0
2020-11-03,Delaware,10,25426,115,712,2,355667,997,25426,115,330241,882
2020-11-03,District of Columbia,11,17524,86,647,0,533419,5245,17524,86,515895,5159
2020-11-03,Florida,12,816692,4637,16889,56,6225760,25375,805924,4553,5419836,20822
2020-11-03,Georgia,13,378894,1633,7837,27,3618830,22130,364589,1668,3254241,20462
2020-11-03,Guam,66,5781,119,81,1,69028,1364,4812,119,64216,1245
2020-11-03,Hawaii,15,15441,82,218,0,15444,77,15444,77,,0
2020-11-03,Idaho,16,67504,1255,649,8,398739,2472,65845,757,332894,1715
2020-11-03,Illinois,17,437879,6598,10177,62,7965115,82435,436277,6516,7528838,75919
2020-11-03,Indiana,18,190555,2890,4439,49,1733575,10733,188066,2881,1545509,7852
2020-11-03,Iowa,19,134576,1879,1780,25,903136,2142,124464,1092,778672,1050
2020-11-03,Kansas,20,91072,459,1051,5,655267,0,89227,0,566040,0
2020-11-03,Kentucky,21,113457,1641,1578,13,1951791,8209,111379,1709,1840412,6500
2020-11-03,Louisiana,22,189148,1153,5951,17,2817860,29376,189148,1153,2628712,28223
2020-11-03,Maine,23,6926,127,148,0,647961,3526,6926,127,641035,3399
2020-11-03,Maryland,24,148249,772,4162,7,1967900,7455,147766,771,1820134,6684
2020-11-03,Massachusetts,25,161585,1036,10035,12,2790437,14190,161585,1036,2628852,13154
2020-11-03,Michigan,26,207799,3664,7758,42,5050490,42191,207763,3437,4842727,38754
2020-11-03,Minnesota,27,157150,3476,2553,15,1900013,7104,157096,3476,1742917,3628
2020-11-03,Mississippi,28,121509,644,3384,36,958717,644,121509,644,837208,0
2020-11-03,Missouri,29,198312,2374,3136,35,1539263,11165,190424,2238,1348839,8927
2020-11-03,Montana,30,35222,905,400,13,512524,3593,35159,907,477365,2686
2020-11-03,Nebraska,31,74060,1429,662,3,600064,2860,72620,954,527444,1906
2020-11-03,Nevada,32,103305,1062,1807,22,819896,3463,103025,911,716871,2552
2020-11-03,New Hampshire,33,11448,128,483,0,351147,2055,11448,128,339699,1927
2020-11-03,New Jersey,34,244614,1824,16371,14,4779673,45439,255839,2405,4523834,43034
2020-11-03,New Mexico,35,49240,1136,1045,9,1202347,11020,49240,1136,1153107,9884
2020-11-03,New York,36,518431,2317,33198,11,14900623,127869,513689,2321,14386934,125548
2020-11-03,North Carolina,37,280657,2180,4481,68,4157478,29882,280377,2349,3877101,27533
2020-11-03,North Dakota,38,47192,1172,561,16,299835,2092,47532,1221,252303,871
2020-11-03,Northern Mariana Islands,69,96,0,2,0,16089,0,96,0,15993,0
2020-11-03,Ohio,39,226138,4229,5373,33,4604715,39812,226138,4229,4378577,35583
2020-11-03,Oklahoma,40,126526,1331,1375,21,1647339,27512,126526,1331,1520813,26181
2020-11-03,Oregon,41,46460,482,701,7,871900,4108,45978,549,825922,3559
2020-11-03,Pennsylvania,42,220111,2868,8926,33,2569217,18557,214871,2875,2354346,15682
2020-11-03,Puerto Rico,72,68943,771,842,3,341722,345,35750,345,305972,0
2020-11-03,Rhode Island,44,34543,423,1212,2,443524,2898,34543,423,408981,2475
2020-11-03,South Carolina,45,179952,1035,3968,22,1855123,13085,179952,1035,1675171,12050
2020-11-03,South Dakota,46,48854,1004,446,8,265210,2073,48854,1004,216356,1069
2020-11-03,Tennessee,47,262053,1778,3419,72,3734564,13907,266357,1770,3468207,12137
2020-11-03,Texas,48,974292,8512,18722,96,8712370,99657,988450,10665,7723920,88992
2020-11-03,Utah,49,119375,1608,620,6,1068439,7269,119375,1669,949064,5600
2020-11-03,Vermont,50,2237,18,58,0,189137,285,2257,22,186880,263
2020-11-03,Virgin Islands,78,1385,9,22,1,24565,46,1385,7,23180,39
2020-11-03,Virginia,51,184679,1261,3666,8,2699771,22710,184679,1261,2515092,21449
2020-11-03,Washington,53,115608,821,2507,23,2474915,543,114084,543,2360831,0
2020-11-03,West Virginia,54,25593,358,469,11,800408,5917,25593,358,774815,5559
2020-11-03,Wisconsin,55,251227,6253,2179,62,2112994,21448,251032,6104,1861962,15344
2020-11-03,Wyoming,56,14619,452,93,6,135336,1318,14619,452,120717,866
2020-11-04,Alabama,01,197777,1848,3006,19,1401274,8923,197777,1848,1203497,7075
2020-11-04,Alaska,02,17750,411,79,0,627758,3003,16798,408,610960,2595
2020-11-04,Arizona,04,250853,1012,6059,37,1818497,9226,250633,815,1567864,8411
2020-11-04,Arkansas,05,115812,1293,2026,23,1389797,11616,115812,1293,1273985,10323
2020-11-04,California,06,954624,5241,17818,67,19181012,106091,940010,5338,18241002,100753
2020-11-04,Colorado,08,118356,2992,2366,29,1279847,12702,117637,2928,1162210,9774
2020-11-04,Connecticut,09,75373,530,4645,10,2401877,33883,75373,1515,2326504,32368
2020-11-04,Delaware,10,25534,108,712,0,356664,997,25534,108,331130,889
2020-11-04,District of Columbia,11,17601,77,647,0,537091,3672,17601,77,519490,3595
2020-11-04,Florida,12,821115,4423,16921,32,6247167,21407,810256,4332,5436911,17075
2020-11-04,Georgia,13,382113,3219,8303,466,3647278,28448,366452,1863,3280826,26585
2020-11-04,Guam,66,5872,91,84,3,69756,728,4903,91,64853,637
2020-11-04,Hawaii,15,15591,150,218,0,15531,87,15531,87,,0
2020-11-04,Idaho,16,68791,1287,665,16,401774,3035,67024,1179,334750,1856
2020-11-04,Illinois,17,445537,7658,10239,62,8036972,71857,443815,7538,7593157,64319
2020-11-04,Indiana,18,194261,3706,4464,25,1748496,14921,191764,3698,1556732,11223
2020-11-04,Iowa,19,137315,2739,1801,21,908054,4918,126740,2276,781314,2642
2020-11-04,Kansas,20,93967,2895,1087,36,663680,8413,92215,2988,571465,5425
2020-11-04,Kentucky,21,115426,1969,1593,15,1999654,47863,113009,1630,1886645,46233
2020-11-04,Louisiana,22,190164,1016,5975,24,2825919,8059,190164,1016,2635755,7043
2020-11-04,Maine,23,7077,151,150,2,657250,9289,7077,151,650173,9138
2020-11-04,Maryland,24,149232,983,4172,10,1979067,11167,148766,1000,1830301,10167
2020-11-04,Massachusetts,25,163299,1714,10062,27,2812539,22102,163299,1714,2649240,20388
2020-11-04,Michigan,26,212126,4327,7783,25,5093676,43186,212160,4397,4881516,38789
2020-11-04,Minnesota,27,160977,3827,2584,31,1920465,20452,160923,3827,1759542,16625
2020-11-04,Mississippi,28,122275,766,3397,13,959483,766,122275,766,837208,0
2020-11-04,Missouri,29,201515,3203,3166,30,1546955,7692,193023,2599,1353932,5093
2020-11-04,Montana,30,36012,790,404,4,517288,4764,35955,796,481333,3968
2020-11-04,Nebraska,31,75888,1828,673,11,603890,3826,74060,1440,529830,2386
2020-11-04,Nevada,32,104514,1209,1816,9,823543,3647,104093,1068,719450,2579
2020-11-04,New Hampshire,33,11563,115,484,1,352036,889,11563,115,340473,774
2020-11-04,New Jersey,34,247057,2443,16391,20,4782714,3041,258880,3041,4523834,0
2020-11-04,New Mexico,35,50251,1011,1059,14,1218805,16458,50251,1011,1168554,15447
2020-11-04,New York,36,520557,2126,33222,24,15034157,133534,515815,2126,14518342,131408
2020-11-04,North Carolina,37,283280,2623,4535,54,4184258,26780,282802,2425,3901456,24355
2020-11-04,North Dakota,38,48306,1114,573,12,301492,1657,48704,1172,252788,485
2020-11-04,Northern Mariana Islands,69,96,0,2,0,16089,0,96,0,15993,0
2020-11-04,Ohio,39,230209,4071,5428,55,4644416,39701,230209,4071,4414207,35630
2020-11-04,Oklahoma,40,127772,1246,1392,17,1657117,9778,127772,1246,1529345,8532
2020-11-04,Oregon,41,47049,589,707,6,877404,5504,46460,482,830944,5022
2020-11-04,Pennsylvania,42,222883,2772,8967,41,2591931,22714,217666,2795,2374265,19919
2020-11-04,Puerto Rico,72,69020,77,850,8,341779,57,35807,57,305972,0
2020-11-04,Rhode Island,44,35122,579,1214,2,447021,3497,35122,579,411899,2918
2020-11-04,South Carolina,45,180870,918,3985,17,1865888,10765,180870,918,1685018,9847
2020-11-04,South Dakota,46,49791,937,460,14,266796,1586,49791,937,217005,649
2020-11-04,Tennessee,47,265407,3354,3446,27,3760384,25820,269802,3445,3490582,22375
2020-11-04,Texas,48,984919,10627,18870,148,8810462,98092,998267,9817,7812195,88275
2020-11-04,Utah,49,121563,2188,625,5,1073952,5513,121485,2110,952467,3403
2020-11-04,Vermont,50,2267,30,58,0,190095,958,2288,31,187807,927
2020-11-04,Virgin Islands,78,1388,3,23,1,24746,181,1388,3,23358,178
2020-11-04,Virginia,51,185836,1157,3677,11,2715175,15404,185836,1157,2529339,14247
2020-11-04,Washington,53,117091,1483,2526,19,2500930,26015,115790,1706,2385140,24309
2020-11-04,West Virginia,54,25987,394,472,3,806208,5800,25987,394,780221,5406
2020-11-04,Wisconsin,55,257365,6138,2237,58,2129582,16588,257287,6255,1872295,10333
2020-11-04,Wyoming,56,15044,425,105,12,135761,425,15044,425,120717,0
2020-11-05,Alabama,01,199158,1381,3026,20,1408999,7725,199158,1381,1209841,6344
2020-11-05,Alaska,02,18064,314,79,0,781826,154068,17111,313,764715,153755
2020-11-05,Arizona,04,252843,1990,6087,28,1832929,14432,252768,2135,1580161,12297
2020-11-05,Arkansas,05,117360,1548,2037,11,1402973,13176,117360,1548,1285613,11628
2020-11-05,California,06,960884,6260,17866,48,19266363,85351,944576,4566,18321787,80785
2020-11-05,Colorado,08,122170,3814,2383,17,1294480,14633,121006,3369,1173474,11264
2020-11-05,Connecticut,09,77060,1687,4656,11,2459921,58044,77060,1687,2382861,56357
2020-11-05,Delaware,10,25753,219,716,4,358386,1722,25753,219,332633,1503
2020-11-05,District of Columbia,11,17682,81,650,3,540502,3411,17682,81,522820,3330
2020-11-05,Florida,12,827372,6257,16960,39,6291105,43938,816376,6120,5474729,37818
2020-11-05,Georgia,13,384531,2418,8359,56,3672160,24882,368368,1916,3303792,22966
2020-11-05,Guam,66,5973,101,84,0,70467,711,5004,101,65463,610
2020-11-05,Hawaii,15,15683,92,218,0,15686,155,15686,155,,0
2020-11-05,Idaho,16,70005,1214,673,8,404810,3036,68314,1290,336496,1746
2020-11-05,Illinois,17,455528,9991,10334,95,8122987,86015,453750,9935,7669237,76080
2020-11-05,Indiana,18,198684,4423,4511,47,1761947,13451,196176,4412,1565771,9039
2020-11-05,Iowa,19,142795,5480,1814,13,916404,8350,130732,3992,785672,4358
2020-11-05,Kansas,20,94427,460,1087,0,663680,0,92215,0,571465,0
2020-11-05,Kentucky,21,117654,2228,1611,18,2028170,28516,115277,2268,1912893,26248
2020-11-05,Louisiana,22,190845,681,5995,20,2847666,21747,190845,681,2656821,21066
2020-11-05,Maine,23,7260,183,150,0,667850,10600,7260,183,660590,10417
2020-11-05,Maryland,24,150424,1192,4182,10,1990023,10956,149964,1198,1840059,9758
2020-11-05,Massachusetts,25,165161,1862,10085,23,2837094,24555,165161,1862,2671933,22693
2020-11-05,Michigan,26,218136,6010,7833,50,5154882,61206,218263,6103,4936619,55103
2020-11-05,Minnesota,27,164919,3942,2609,25,1941496,21031,164865,3942,1776631,17089
2020-11-05,Mississippi,28,123887,1612,3405,8,961095,1612,123887,1612,837208,0
2020-11-05,Missouri,29,205036,3521,3197,31,1557001,10046,196576,3553,1360425,6493
2020-11-05,Montana,30,37024,1012,409,5,520024,2736,36968,1013,483056,1723
2020-11-05,Nebraska,31,78012,2124,678,5,608304,4414,75888,1828,532416,2586
2020-11-05,Nevada,32,105706,1192,1825,9,829573,6030,105360,1267,724213,4763
2020-11-05,New Hampshire,33,11808,245,486,2,357303,5267,11808,245,345495,5022
2020-11-05,New Jersey,34,249019,1962,16403,12,4832289,49575,261456,2576,4570833,46999
2020-11-05,New Mexico,35,51110,859,1082,23,1230205,11400,51110,859,1179095,10541
2020-11-05,New York,36,523559,3002,33247,25,15195176,161019,518812,2997,14676364,158022
2020-11-05,North Carolina,37,286210,2930,4572,37,4226942,42684,285661,2859,3941281,39825
2020-11-05,North Dakota,38,49842,1536,601,28,303409,1917,50276,1572,253133,345
2020-11-05,Northern Mariana Islands,69,96,0,2,0,16089,0,96,0,15993,0
2020-11-05,Ohio,39,235170,4961,5461,33,4695806,51390,235170,4961,4460636,46429
2020-11-05,Oklahoma,40,129873,2101,1413,21,1673557,16440,129873,2101,1543684,14339
2020-11-05,Oregon,41,47839,790,710,3,882954,5550,47049,589,835905,4961
2020-11-05,Pennsylvania,42,225698,2815,9009,42,2611902,19971,220566,2900,2391336,17071
2020-11-05,Puerto Rico,72,69416,396,855,5,342073,294,36101,294,305972,0
2020-11-05,Rhode Island,44,35750,628,1222,8,450428,3407,35750,628,414678,2779
2020-11-05,South Carolina,45,181639,769,3992,7,1873285,7397,181639,769,1691646,6628
2020-11-05,South Dakota,46,51151,1360,482,22,269136,2340,51151,1360,217985,980
2020-11-05,Tennessee,47,267557,2150,3474,28,3780132,19748,271771,1969,3508361,17779
2020-11-05,Texas,48,993894,8975,19000,130,8905822,95360,1008438,10171,7897384,85189
2020-11-05,Utah,49,124366,2803,632,7,1086344,12392,124292,2807,962052,9585
2020-11-05,Vermont,50,2303,36,58,0,191033,938,2326,38,188707,900
2020-11-05,Virgin Islands,78,1388,0,23,0,24904,158,1388,0,23516,158
2020-11-05,Virginia,51,187202,1366,3688,11,2733990,18815,187202,1366,2546788,17449
2020-11-05,Washington,53,118459,1368,2542,16,2525399,24469,117385,1595,2408014,22874
2020-11-05,West Virginia,54,26547,560,480,8,817092,10884,26547,560,790545,10324
2020-11-05,Wisconsin,55,263640,6275,2273,36,2145384,15802,263571,6284,1881813,9518
2020-11-05,Wyoming,56,15409,365,105,0,138213,2452,15409,365,122804,2087
2020-11-06,Alabama,01,200714,1556,3049,23,1417716,8717,200714,1556,1217002,7161
2020-11-06,Alaska,02,18589,525,79,0,781301,-525,17618,507,763683,-1032
2020-11-06,Arizona,04,254961,2118,6111,24,1848745,15816,254764,1996,1593981,13820
2020-11-06,Arkansas,05,119230,1870,2056,19,1417494,14521,119230,1870,1298264,12651
2020-11-06,California,06,967597,6713,17939,73,19396349,129986,951094,6518,18445255,123468
2020-11-06,Colorado,08,125397,3227,2404,21,1310846,16366,124469,3463,1186377,12903
2020-11-06,Connecticut,09,78125,1065,4671,15,2489604,29683,78125,1065,2411479,28618
2020-11-06,Delaware,10,26035,282,716,0,360881,2495,26035,282,334846,2213
2020-11-06,District of Columbia,11,17792,110,652,2,546323,5821,17792,110,528531,5711
2020-11-06,Florida,12,832617,5245,17013,53,6325976,34871,821526,5150,5504450,29721
2020-11-06,Georgia,13,387202,2671,8389,30,3691733,19573,370106,1738,3321627,17835
2020-11-06,Guam,66,6046,73,89,5,71104,637,5077,73,66027,564
2020-11-06,Hawaii,15,15816,133,218,0,15785,99,15785,99,,0
2020-11-06,Idaho,16,71496,1491,685,12,408235,3425,69579,1265,338656,2160
2020-11-06,Illinois,17,466884,11356,10412,78,8215129,92142,465540,11790,7749589,80352
2020-11-06,Indiana,18,203332,4648,4547,36,1777105,15158,200823,4647,1576282,10511
2020-11-06,Iowa,19,146267,3472,1828,14,922017,5613,133510,2778,788507,2835
2020-11-06,Kansas,20,99605,5178,1172,85,676320,12640,97633,5418,578687,7222
2020-11-06,Kentucky,21,119952,2298,1621,10,2196876,168706,117505,2228,2079371,166478
2020-11-06,Louisiana,22,191715,870,6016,21,2866476,18810,191715,870,2674761,17940
2020-11-06,Maine,23,7444,184,150,0,676065,8215,7444,184,668621,8031
2020-11-06,Maryland,24,151964,1540,4194,12,2003170,13147,151505,1541,1851665,11606
2020-11-06,Massachusetts,25,167274,2113,10123,38,2857859,20765,167274,2113,2690585,18652
2020-11-06,Michigan,26,222423,4287,7883,50,5207467,52585,222509,4246,4984958,48339
2020-11-06,Minnesota,27,170361,5442,2645,36,1963849,22353,170307,5442,1793542,16911
2020-11-06,Mississippi,28,124854,967,3419,14,962062,967,124854,967,837208,0
2020-11-06,Missouri,29,210054,5018,3217,20,1567231,10230,200507,3931,1366724,6299
2020-11-06,Montana,30,38012,988,420,11,523596,3572,37947,979,485649,2593
2020-11-06,Nebraska,31,80693,2681,705,27,614043,5739,78012,2124,536031,3615
2020-11-06,Nevada,32,107258,1552,1846,21,835414,5841,106922,1562,728492,4279
2020-11-06,New Hampshire,33,12012,204,488,2,359738,2435,12012,204,347726,2231
2020-11-06,New Jersey,34,251180,2161,16416,13,4878284,45995,264228,2772,4614056,43223
2020-11-06,New Mexico,35,52394,1284,1088,6,1238575,8370,52394,1284,1186181,7086
2020-11-06,New York,36,526767,3208,33267,20,15355881,160705,522021,3209,14833860,157496
2020-11-06,North Carolina,37,289124,2914,4608,36,4277376,50434,288569,2908,3988807,47526
2020-11-06,North Dakota,38,51607,1765,618,17,306144,2735,52081,1805,254063,930
2020-11-06,Northern Mariana Islands,69,98,2,2,0,16091,2,98,2,15993,0
2020-11-06,Ohio,39,240178,5008,5494,33,4700814,5008,240178,5008,4460636,0
2020-11-06,Oklahoma,40,131751,1878,1429,16,1689601,16044,131751,1878,1557850,14166
2020-11-06,Oregon,41,48608,769,716,6,889027,6073,47839,790,841188,5283
2020-11-06,Pennsylvania,42,229346,3648,9052,43,2632316,20414,223950,3384,2408366,17030
2020-11-06,Puerto Rico,72,70519,1103,862,7,342876,803,36904,803,305972,0
2020-11-06,Rhode Island,44,36380,630,1224,2,453647,3219,36380,630,417267,2589
2020-11-06,South Carolina,45,182872,1233,4005,13,1897097,23812,182872,1233,1714225,22579
2020-11-06,South Dakota,46,52639,1488,510,28,272190,3054,52639,1488,219551,1566
2020-11-06,Tennessee,47,269292,1735,3508,34,3791407,11275,273144,1373,3518263,9902
2020-11-06,Texas,48,1003908,10014,19125,125,9002976,97154,1017677,9239,7985299,87915
2020-11-06,Utah,49,127294,2928,649,17,1096628,10284,127279,2987,969349,7297
2020-11-06,Vermont,50,2326,23,58,0,191728,695,2354,28,189374,667
2020-11-06,Virgin Islands,78,1390,2,23,0,25118,214,1390,2,23728,212
2020-11-06,Virginia,51,188770,1568,3682,-6,2758354,24364,188770,1568,2569584,22796
2020-11-06,Washington,53,120123,1664,2552,10,2547781,22382,119257,1872,2428524,20510
2020-11-06,West Virginia,54,27087,540,487,7,827059,9967,27087,540,799972,9427
2020-11-06,Wisconsin,55,270074,6434,2340,67,2166439,21055,269982,6411,1896457,14644
2020-11-06,Wyoming,56,16405,996,105,0,140174,1961,16405,996,123769,965
2020-11-07,Alabama,01,202482,1768,3082,33,1427077,9361,202482,1768,1224595,7593
2020-11-07,Alaska,02,19194,605,79,0,780694,-607,18221,603,762473,-1210
2020-11-07,Arizona,04,257384,2423,6147,36,1865425,16680,257384,2620,1608041,14060
2020-11-07,Arkansas,05,120828,1598,2068,12,1429305,11811,120828,1598,1308477,10213
2020-11-07,California,06,972801,5204,17964,25,19565151,168802,956957,5863,18608194,162939
2020-11-07,Colorado,08,128611,3214,2417,13,1327974,17128,127967,3498,1200007,13630
2020-11-07,Connecticut,09,78125,0,4671,0,2489604,0,78125,0,2411479,0
2020-11-07,Delaware,10,26258,223,716,0,362931,2050,26258,223,336673,1827
2020-11-07,District of Columbia,11,17891,99,654,2,550585,4262,17891,99,532694,4163
2020-11-07,Florida,12,837069,4452,17099,86,6345029,19053,825906,4380,5519123,14673
2020-11-07,Georgia,13,389257,2055,8427,38,3715270,23537,371825,1719,3343445,21818
2020-11-07,Guam,66,6046,0,89,0,71507,403,5113,36,66394,367
2020-11-07,Hawaii,15,15939,123,219,1,15923,138,15923,138,,0
2020-11-07,Idaho,16,72528,1032,685,0,412887,4652,70909,1330,341978,3322
2020-11-07,Illinois,17,479061,12177,10498,86,8313547,98418,477978,12438,7835569,85980
2020-11-07,Indiana,18,208243,4911,4592,45,1794398,17293,205722,4899,1588676,12394
2020-11-07,Iowa,19,150639,4372,1842,14,928259,6242,137228,3718,791031,2524
2020-11-07,Kansas,20,99671,66,1166,-6,676320,0,97633,0,578687,0
2020-11-07,Kentucky,21,122021,2069,1640,19,2066810,-130066,119661,2156,1947149,-132222
2020-11-07,Louisiana,22,191715,0,6016,0,2866476,0,191715,0,2674761,0
2020-11-07,Maine,23,7603,159,152,2,676224,159,7603,159,668621,0
2020-11-07,Maryland,24,153198,1234,4201,7,2015314,12144,152915,1410,1862399,10734
2020-11-07,Massachusetts,25,169576,2302,10146,23,2881767,23908,169576,2302,2712191,21606
2020-11-07,Michigan,26,228706,6283,7943,60,5213961,6494,229003,6494,4984958,0
2020-11-07,Minnesota,27,175008,4647,2679,34,1983443,19594,174954,4647,1808489,14947
2020-11-07,Mississippi,28,125885,1031,3433,14,963093,1031,125885,1031,837208,0
2020-11-07,Missouri,29,213645,3591,3235,18,1578411,11180,205066,4559,1373345,6621
2020-11-07,Montana,30,38948,936,445,25,525176,1580,38948,1001,486228,579
2020-11-07,Nebraska,31,82395,1702,710,5,621532,7489,80693,2681,540839,4808
2020-11-07,Nevada,32,109326,2068,1851,5,842004,6590,108746,1824,733258,4766
2020-11-07,New Hampshire,33,12241,229,489,1,362794,3056,12241,229,350553,2827
2020-11-07,New Jersey,34,254382,3202,16425,9,4979076,100792,268028,3800,4711048,96992
2020-11-07,New Mexico,35,53671,1277,1104,16,1250724,12149,53671,1277,1197053,10872
2020-11-07,New York,36,530354,3587,33287,20,15519172,163291,525608,3587,14993564,159704
2020-11-07,North Carolina,37,291563,2439,4629,21,4324156,46780,291245,2676,4032911,44104
2020-11-07,North Dakota,38,53209,1602,633,15,308494,2350,53727,1646,254767,704
2020-11-07,Northern Mariana Islands,69,98,0,2,0,16091,0,98,0,15993,0
2020-11-07,Ohio,39,245727,5549,5506,12,4808908,108094,245727,5549,4563181,102545
2020-11-07,Oklahoma,40,136258,4507,1438,9,1703072,13471,131751,0,1571321,13471
2020-11-07,Oregon,41,49587,979,729,13,897602,8575,48608,769,848994,7806
2020-11-07,Pennsylvania,42,232582,3236,9089,37,2654106,21790,227985,4035,2426121,17755
2020-11-07,Puerto Rico,72,71532,1013,862,0,343539,663,37567,663,305972,0
2020-11-07,Rhode Island,44,36380,0,1224,0,460515,6868,37175,795,423340,6073
2020-11-07,South Carolina,45,184742,1870,4015,10,1944928,47831,184742,1870,1760186,45961
2020-11-07,South Dakota,46,53976,1337,523,13,274683,2493,53976,1337,220707,1156
2020-11-07,Tennessee,47,273603,4311,3556,48,3836617,45210,278215,5071,3558402,40139
2020-11-07,Texas,48,1009837,5929,19219,94,9095589,92613,1027237,9560,8068352,83053
2020-11-07,Utah,49,130238,2944,658,9,1107994,11366,130235,2956,977759,8410
2020-11-07,Vermont,50,2347,21,59,1,192522,794,2382,28,190140,766
2020-11-07,Virgin Islands,78,1405,15,23,0,25118,0,1390,0,23728,0
2020-11-07,Virginia,51,190873,2103,3704,22,2782039,23685,190873,2103,2591166,21582
2020-11-07,Washington,53,121220,1097,2552,0,2575397,27616,121381,2124,2454016,25492
2020-11-07,West Virginia,54,27742,655,502,15,837704,10645,27742,655,809962,9990
2020-11-07,Wisconsin,55,277568,7494,2385,45,2185823,19384,277503,7521,1908320,11863
2020-11-07,Wyoming,56,16597,192,105,0,140366,192,16597,192,123769,0
2020-11-08,Alabama,01,203687,1205,3084,2,1433504,6427,203687,1205,1229817,5222
2020-11-08,Alaska,02,19712,518,79,0,780174,-520,18732,511,761442,-1031
2020-11-08,Arizona,04,259299,1915,6164,17,1879328,13903,259264,1880,1620064,12023
2020-11-08,Arkansas,05,121866,1038,2085,17,1438805,9500,121866,1038,1316939,8462
2020-11-08,California,06,978844,6043,17975,11,19724628,159477,964639,7682,18759989,151795
2020-11-08,Colorado,08,131870,3259,2421,4,1341956,13982,130984,3017,1210972,10965
2020-11-08,Connecticut,09,78125,0,4671,0,2489604,0,78125,0,2411479,0
2020-11-08,Delaware,10,26603,345,718,2,365279,2348,26603,345,338676,2003
2020-11-08,District of Columbia,11,18001,110,654,0,555449,4864,18001,110,537448,4754
2020-11-08,Florida,12,843889,6820,17120,21,6389831,44802,832525,6619,5557306,38183
2020-11-08,Georgia,13,390617,1360,8428,1,3733960,18690,373078,1253,3360882,17437
2020-11-08,Guam,66,6046,0,89,0,71996,489,5233,120,66763,369
2020-11-08,Hawaii,15,16066,127,220,1,16051,128,16051,128,,0
2020-11-08,Idaho,16,73212,684,691,6,415721,2834,72312,1403,343409,1431
2020-11-08,Illinois,17,488980,9919,10548,50,8404304,90757,487987,10009,7916317,80748
2020-11-08,Indiana,18,212895,4652,4629,37,1809940,15542,210374,4652,1599566,10890
2020-11-08,Iowa,19,155583,4944,1845,3,935839,7580,140541,3313,795298,4267
2020-11-08,Kansas,20,99805,134,1166,0,676320,0,97633,0,578687,0
2020-11-08,Kentucky,21,123195,1174,1641,1,2067987,1177,120838,1177,1947149,0
2020-11-08,Louisiana,22,192981,1266,6036,20,2892957,26481,192981,1266,2699976,25215
2020-11-08,Maine,23,7693,90,152,0,676314,90,7693,90,668621,0
2020-11-08,Maryland,24,154451,1253,4212,11,2026292,10978,153996,1081,1872296,9897
2020-11-08,Massachusetts,25,171399,1823,10166,20,2901920,20153,171399,1823,2730521,18330
2020-11-08,Michigan,26,229085,379,7944,1,5213961,0,229003,0,4984958,0
2020-11-08,Minnesota,27,180916,5908,2710,31,2004582,21139,180862,5908,1823720,15231
2020-11-08,Mississippi,28,126689,804,3443,10,963897,804,126689,804,837208,0
2020-11-08,Missouri,29,216654,3009,3238,3,1599615,21204,209197,4131,1390418,17073
2020-11-08,Montana,30,39679,731,456,11,526591,1415,39679,731,486912,684
2020-11-08,Nebraska,31,83969,1574,710,0,626287,4755,82395,1702,543892,3053
2020-11-08,Nevada,32,110308,982,1852,1,846248,4244,110022,1276,736226,2968
2020-11-08,New Hampshire,33,12488,247,489,0,364038,1244,12488,247,351550,997
2020-11-08,New Jersey,34,256395,2013,16429,4,4981570,2494,270522,2494,4711048,0
2020-11-08,New Mexico,35,54881,1210,1118,14,1262482,11758,54881,1210,1207601,10548
2020-11-08,New York,36,533784,3430,33314,27,15664814,145642,529036,3428,15135778,142214
2020-11-08,North Carolina,37,293431,1868,4630,1,4365061,40905,293339,2094,4071722,38811
2020-11-08,North Dakota,38,54310,1101,644,11,310037,1543,54844,1117,255193,426
2020-11-08,Northern Mariana Islands,69,98,0,2,0,16091,0,98,0,15993,0
2020-11-08,Ohio,39,250268,4541,5517,11,4868460,59552,250268,4541,4618192,55011
2020-11-08,Oklahoma,40,136258,0,1438,0,1707579,4507,136258,4507,1571321,0
2020-11-08,Oregon,41,50448,861,730,1,903099,5497,49587,979,853512,4518
2020-11-08,Pennsylvania,42,235162,2580,9093,4,2672529,18423,230894,2909,2441635,15514
2020-11-08,Puerto Rico,72,71715,183,872,10,344072,533,38100,533,305972,0
2020-11-08,Rhode Island,44,36380,0,1224,0,463584,3069,37743,568,425841,2501
2020-11-08,South Carolina,45,185688,946,4036,21,1959102,14174,185688,946,1773414,13228
2020-11-08,South Dakota,46,55404,1428,536,13,277035,2352,55404,1428,221631,924
2020-11-08,Tennessee,47,277073,3470,3561,5,3873139,36522,281851,3636,3591288,32886
2020-11-08,Texas,48,1016772,6935,19256,37,9148490,52901,1034115,6878,8114375,46023
2020-11-08,Utah,49,132621,2383,659,1,1116732,8738,132621,2386,984111,6352
2020-11-08,Vermont,50,2392,45,59,0,193404,882,2436,54,190968,828
2020-11-08,Virgin Islands,78,1405,0,23,0,25417,299,1405,15,24012,284
2020-11-08,Virginia,51,192175,1302,3707,3,2803062,21023,192175,1302,2610887,19721
2020-11-08,Washington,53,122310,1090,2552,0,2600067,24670,123312,1931,2476755,22739
2020-11-08,West Virginia,54,28404,662,502,0,849461,11757,28404,662,821057,11095
2020-11-08,Wisconsin,55,281910,4342,2396,11,2198711,12888,281910,4407,1916801,8481
2020-11-08,Wyoming,56,17310,713,114,9,141079,713,17310,713,123769,0
2020-11-09,Alabama,01,204857,1170,3084,0,1437832,4328,204857,1170,1232975,3158
2020-11-09,Alaska,02,20185,473,79,0,767997,-12177,19196,464,748801,-12641
2020-11-09,Arizona,04,260646,1347,6164,0,1889905,10577,259699,435,1630206,10142
2020-11-09,Arkansas,05,122811,945,2108,23,1447466,8661,122811,945,1324655,7716
2020-11-09,California,06,985598,6754,18035,60,19918479,193851,971851,7212,18946628,186639
2020-11-09,Colorado,08,135747,3877,2438,17,1359195,17239,134537,3553,1224658,13686
2020-11-09,Connecticut,09,81463,3338,4698,27,2579578,89974,81463,3338,2498115,86636
2020-11-09,Delaware,10,26908,305,719,1,367580,2301,26908,305,340672,1996
2020-11-09,District of Columbia,11,18087,86,655,1,558814,3365,18087,86,540727,3279
2020-11-09,Florida,12,847813,3924,17178,58,6410130,20299,836370,3845,5573760,16454
2020-11-09,Georgia,13,392246,1629,8457,29,3749894,15934,374181,1103,3375713,14831
2020-11-09,Guam,66,6442,396,91,2,72954,958,5473,240,67481,718
2020-11-09,Hawaii,15,16124,58,220,0,16179,128,16179,128,,0
2020-11-09,Idaho,16,74713,1501,704,13,418504,2783,72961,649,345543,2134
2020-11-09,Illinois,17,500015,11035,10577,29,8469064,64760,498560,10573,7970504,54187
2020-11-09,Indiana,18,217028,4133,4664,35,1823029,13089,214509,4135,1608520,8954
2020-11-09,Iowa,19,159910,4327,1872,27,945621,9782,144922,4381,800699,5401
2020-11-09,Kansas,20,105298,5493,1181,15,689982,13662,103553,5920,586429,7742
2020-11-09,Kentucky,21,125332,2137,1655,14,2106069,38082,122567,1729,1983502,36353
2020-11-09,Louisiana,22,193372,391,6048,12,2898463,5506,193372,391,2705091,5115
2020-11-09,Maine,23,7888,195,153,1,698403,22089,7888,195,690515,21894
2020-11-09,Maryland,24,155824,1373,4221,9,2037645,11353,155371,1375,1882274,9978
2020-11-09,Massachusetts,25,172727,1328,10180,14,2916246,14326,172727,1328,2743519,12998
2020-11-09,Michigan,26,238136,9051,8008,64,5368310,154349,238308,9305,5130002,145044
2020-11-09,Minnesota,27,184842,3926,2729,19,2018855,14273,184788,3926,1834067,10347
2020-11-09,Mississippi,28,127205,516,3443,0,1001068,37171,127205,516,873863,36655
2020-11-09,Missouri,29,221874,5220,3241,3,1607875,8260,212441,3244,1395434,5016
2020-11-09,Montana,30,40118,439,463,7,540913,14322,40053,374,500860,13948
2020-11-09,Nebraska,31,85551,1582,714,4,630137,3850,83969,1574,546168,2276
2020-11-09,Nevada,32,111323,1015,1853,1,850941,4693,110982,960,739959,3733
2020-11-09,New Hampshire,33,12699,211,489,0,364810,772,12699,211,352111,561
2020-11-09,New Jersey,34,258453,2058,16440,11,5053709,72139,273075,2553,4780634,69586
2020-11-09,New Mexico,35,56289,1408,1130,12,1269523,7041,56289,1408,1213234,5633
2020-11-09,New York,36,536933,3149,33343,29,15776230,111416,532180,3144,15244050,108272
2020-11-09,North Carolina,37,295105,1674,4638,8,4399616,34555,294860,1521,4104756,33034
2020-11-09,North Dakota,38,55463,1153,649,5,311537,1500,55997,1153,255540,347
2020-11-09,Northern Mariana Islands,69,100,2,2,0,16093,2,100,2,15993,0
2020-11-09,Ohio,39,254974,4706,5524,7,4918126,49666,254974,4706,4663152,44960
2020-11-09,Oklahoma,40,138455,2197,1444,6,1709776,2197,138455,2197,1571321,0
2020-11-09,Oregon,41,51155,707,738,8,909301,6202,50448,861,858853,5341
2020-11-09,Pennsylvania,42,239724,4562,9098,5,2690152,17623,234296,3402,2455856,14221
2020-11-09,Puerto Rico,72,72196,481,882,10,344553,481,38581,481,305972,0
2020-11-09,Rhode Island,44,38009,1629,1233,9,465031,1447,38009,266,427022,1181
2020-11-09,South Carolina,45,186391,703,4041,5,1967225,8123,186391,703,1780834,7420
2020-11-09,South Dakota,46,56311,907,537,1,278803,1768,56311,907,222492,861
2020-11-09,Tennessee,47,282746,5673,3577,16,3928231,55092,287770,5919,3640461,49173
2020-11-09,Texas,48,1026570,9798,19298,42,9181210,32720,1038964,4849,8142246,27871
2020-11-09,Utah,49,134868,2247,661,2,1125403,8671,134868,2247,990535,6424
2020-11-09,Vermont,50,2415,23,59,0,193838,434,2461,25,191377,409
2020-11-09,Virgin Islands,78,1405,0,23,0,25417,0,1405,0,24012,0
2020-11-09,Virginia,51,193477,1302,3713,6,2819087,16025,193477,1302,2625610,14723
2020-11-09,Washington,53,124560,2250,2577,25,2619586,19519,124719,1407,2494867,18112
2020-11-09,West Virginia,54,28805,401,530,28,857085,7624,28805,401,828280,7223
2020-11-09,Wisconsin,55,286446,4536,2421,25,2212898,14187,286380,4470,1926518,9717
2020-11-09,Wyoming,56,18010,700,114,0,145158,4079,18010,700,127148,3379
2020-11-10,Alabama,01,206567,1710,3120,36,1437719,-113,206567,1710,1231152,-1823
2020-11-10,Alaska,02,20715,530,87,8,828140,60143,19734,538,808406,59605
2020-11-10,Arizona,04,263445,2799,6198,34,1905430,15525,263133,3434,1642297,12091
2020-11-10,Arkansas,05,124235,1424,2112,4,1456243,8777,124235,1424,1332008,7353
2020-11-10,California,06,994341,8743,18073,38,20094641,176162,977218,5367,19117423,170795
2020-11-10,Colorado,08,139246,3499,2469,31,1374786,15591,138427,3890,1236359,11701
2020-11-10,Connecticut,09,82987,1524,4707,9,2602262,22684,82987,1524,2519275,21160
2020-11-10,Delaware,10,27112,204,722,3,369131,1551,27112,204,342019,1347
2020-11-10,District of Columbia,11,18173,86,657,2,561833,3019,18173,86,543660,2933
2020-11-10,Florida,12,852166,4353,17247,69,6434241,24111,840652,4282,5593589,19829
2020-11-10,Georgia,13,396498,4252,8507,50,3772524,22630,376054,1873,3396470,20757
2020-11-10,Guam,66,6623,181,92,1,73859,905,5654,181,68205,724
2020-11-10,Hawaii,15,16193,69,221,1,16242,63,16242,63,,0
2020-11-10,Idaho,16,76010,1297,720,16,420811,2307,74227,1266,346584,1041
2020-11-10,Illinois,17,512688,12673,10658,81,8571019,101955,511183,12623,8059836,89332
2020-11-10,Indiana,18,221894,4866,4731,67,1837630,14601,219338,4829,1618292,9772
2020-11-10,Iowa,19,163827,3917,1898,26,950191,4570,147656,2734,802535,1836
2020-11-10,Kansas,20,105760,462,1181,0,689982,0,103553,0,586429,0
2020-11-10,Kentucky,21,127472,2140,1674,19,2126356,20287,124646,2079,2001710,18208
2020-11-10,Louisiana,22,194702,1330,6058,10,2924923,26460,194702,1330,2730221,25130
2020-11-10,Maine,23,8060,172,156,3,704431,6028,8060,172,696371,5856
2020-11-10,Maryland,24,157149,1325,4233,12,2047847,10202,156709,1338,1891138,8864
2020-11-10,Massachusetts,25,174881,2154,10201,21,2932097,15851,174881,2154,2757216,13697
2020-11-10,Michigan,26,245005,6869,8095,87,5427625,59315,245252,6944,5182373,52371
2020-11-10,Minnesota,27,189735,4893,2752,23,2033885,15030,189681,4893,1844204,10137
2020-11-10,Mississippi,28,128138,933,3480,37,1002001,933,128138,933,873863,0
2020-11-10,Missouri,29,226372,4498,3375,134,1599170,-8705,216697,4256,1382473,-12961
2020-11-10,Montana,30,41219,1101,468,5,544566,3653,41151,1098,503415,2555
2020-11-10,Nebraska,31,87733,2182,741,27,633716,3579,85551,1582,548165,1997
2020-11-10,Nevada,32,112602,1279,1863,10,854534,3593,112304,1322,742230,2271
2020-11-10,New Hampshire,33,12919,220,489,0,369399,4589,12919,220,356480,4369
2020-11-10,New Jersey,34,262230,3777,16461,21,5058144,4435,277510,4435,4780634,0
2020-11-10,New Mexico,35,57547,1258,1144,14,1281951,12428,57547,1258,1224404,11170
2020-11-10,New York,36,540897,3964,33373,30,15904266,128036,536145,3965,15368121,124071
2020-11-10,North Carolina,37,298089,2984,4685,47,4429912,30296,297442,2582,4132470,27714
2020-11-10,North Dakota,38,56357,894,679,30,312484,947,56944,947,255540,0
2020-11-10,Northern Mariana Islands,69,100,0,2,0,16567,474,100,0,16467,474
2020-11-10,Ohio,39,261482,6508,5547,23,4964229,46103,261482,6508,4702747,39595
2020-11-10,Oklahoma,40,140157,1702,1451,7,1733198,23422,140157,1702,1593041,21720
2020-11-10,Oregon,41,51909,754,741,3,914677,5376,51155,707,863522,4669
2020-11-10,Pennsylvania,42,244046,4322,9156,58,2709442,19290,238657,4361,2470785,14929
2020-11-10,Puerto Rico,72,72471,275,889,7,344828,275,38856,275,305972,0
2020-11-10,Rhode Island,44,38798,789,1237,4,467877,2846,38798,789,429079,2057
2020-11-10,South Carolina,45,187738,1347,4062,21,1988512,21287,187738,1347,1800774,19940
2020-11-10,South Dakota,46,57334,1023,540,3,280699,1896,57334,1023,223365,873
2020-11-10,Tennessee,47,284725,1979,3639,62,3943804,15573,289749,1979,3654055,13594
2020-11-10,Texas,48,1038214,11644,19423,125,9299045,117835,1051899,12935,8247146,104900
2020-11-10,Utah,49,137523,2655,672,11,1135628,10225,137385,2517,998243,7708
2020-11-10,Vermont,50,2462,47,59,0,194531,693,2513,52,192018,641
2020-11-10,Virgin Islands,78,1413,8,23,0,25487,70,1410,5,24077,65
2020-11-10,Virginia,51,194912,1435,3726,13,2837139,18052,194912,1435,2642227,16617
2020-11-10,Washington,53,126091,1531,2594,17,2634441,14855,125496,777,2508945,14078
2020-11-10,West Virginia,54,29316,511,546,16,864043,6958,29316,511,834727,6447
2020-11-10,Wisconsin,55,293862,7416,2497,76,2233256,20358,293812,7432,1939444,12926
2020-11-10,Wyoming,56,19242,1232,127,13,146390,1232,19242,1232,127148,0
2020-11-11,Alabama,01,208637,2070,3201,81,1453872,16153,208637,2070,1245235,14083
2020-11-11,Alaska,02,21211,496,90,3,834590,6450,20221,487,814369,5963
2020-11-11,Arizona,04,265195,1750,6228,30,1915235,9805,265163,2030,1650072,7775
2020-11-11,Arkansas,05,126197,1962,2126,14,1469248,13005,126197,1962,1343051,11043
2020-11-11,California,06,999498,5157,18109,36,20222093,127452,984682,7464,19237411,119988
2020-11-11,Colorado,08,143553,4307,2481,12,1395052,20266,142402,3975,1252650,16291
2020-11-11,Connecticut,09,84741,1754,4716,9,2639205,36943,84741,1754,2554464,35189
2020-11-11,Delaware,10,27342,230,724,2,370625,1494,27342,230,343283,1264
2020-11-11,District of Columbia,11,18379,206,657,0,567072,5239,18379,206,548693,5033
2020-11-11,Florida,12,858004,5838,17299,52,6466981,32740,846321,5669,5620660,27071
2020-11-11,Georgia,13,398769,2271,8582,75,3786046,13522,377694,1640,3408352,11882
2020-11-11,Guam,66,6724,101,92,0,74549,690,5755,101,68794,589
2020-11-11,Hawaii,15,16309,116,221,0,16320,78,16320,78,,0
2020-11-11,Idaho,16,77536,1526,738,18,424391,3580,75428,1201,348963,2379
2020-11-11,Illinois,17,525072,12384,10805,147,8664483,93464,523840,12657,8140643,80807
2020-11-11,Indiana,18,226935,5041,4762,31,1853700,16070,224374,5036,1629326,11034
2020-11-11,Iowa,19,168457,4630,1927,29,958353,8162,151953,4297,806400,3865
2020-11-11,Kansas,20,110977,5217,1215,34,703647,13665,109225,5672,594422,7993
2020-11-11,Kentucky,21,130308,2836,1689,15,2129054,2698,127344,2698,2001710,0
2020-11-11,Louisiana,22,194702,0,6058,0,2924923,0,194702,0,2730221,0
2020-11-11,Maine,23,8202,142,158,2,704573,142,8202,142,696371,0
2020-11-11,Maryland,24,158836,1687,4249,16,2060836,12989,158423,1714,1902413,11275
2020-11-11,Massachusetts,25,177541,2660,10222,21,2952714,20617,177541,2660,2775173,17957
2020-11-11,Michigan,26,251499,6494,8137,42,5482476,54851,251872,6620,5230604,48231
2020-11-11,Minnesota,27,194626,4891,2810,58,2045316,11431,194570,4889,1850746,6542
2020-11-11,Mississippi,28,129394,1256,3497,17,1003257,1256,129394,1256,873863,0
2020-11-11,Missouri,29,230003,3631,3411,36,1627919,28749,220768,4071,1407151,24678
2020-11-11,Montana,30,42132,913,475,7,547728,3162,42070,919,505658,2243
2020-11-11,Nebraska,31,89942,2209,741,0,639462,5746,87733,2182,551729,3564
2020-11-11,Nevada,32,113856,1254,1877,14,859319,4785,113411,1107,745908,3678
2020-11-11,New Hampshire,33,13148,229,492,3,372144,2745,13148,229,358996,2516
2020-11-11,New Jersey,34,265295,3065,16476,15,5102541,44397,281243,3733,4821298,40664
2020-11-11,New Mexico,35,59034,1487,1158,14,1317248,35297,59034,1487,1258214,33810
2020-11-11,New York,36,545718,4821,33398,25,16068566,164300,540965,4820,15527601,159480
2020-11-11,North Carolina,37,300725,2636,4723,38,4460288,30376,300561,3119,4159727,27257
2020-11-11,North Dakota,38,57378,1021,691,12,314274,1790,58040,1096,256234,694
2020-11-11,Northern Mariana Islands,69,100,0,2,0,16567,0,100,0,16467,0
2020-11-11,Ohio,39,267356,5874,5623,76,5009783,45554,267356,5874,4742427,39680
2020-11-11,Oklahoma,40,142334,2177,1470,19,1748137,14939,142334,2177,1605803,12762
2020-11-11,Oregon,41,52770,861,746,5,921216,6539,51909,754,869307,5785
2020-11-11,Pennsylvania,42,248144,4098,9217,61,2732129,22687,243368,4711,2488761,17976
2020-11-11,Puerto Rico,72,72735,264,901,12,345092,264,39120,264,305972,0
2020-11-11,Rhode Island,44,39776,978,1243,6,471284,3407,39776,978,431508,2429
2020-11-11,South Carolina,45,188995,1257,4076,14,2000709,12197,188995,1257,1811714,10940
2020-11-11,South Dakota,46,58696,1362,567,27,283120,2421,58696,1362,224424,1059
2020-11-11,Tennessee,47,288311,3586,3727,88,3974023,30219,293381,3632,3680642,26587
2020-11-11,Texas,48,1051071,12857,19544,121,9411043,111998,1065065,13166,8345978,98832
2020-11-11,Utah,49,139815,2292,678,6,1144013,8385,139720,2335,1004293,6050
2020-11-11,Vermont,50,2535,73,59,0,195392,861,2602,89,192790,772
2020-11-11,Virgin Islands,78,1413,0,23,0,25487,0,1410,0,24077,0
2020-11-11,Virginia,51,196506,1594,3741,15,2858627,21488,196506,1594,2662121,19894
2020-11-11,Washington,53,126886,795,2595,1,2652623,18182,128209,2713,2524414,15469
2020-11-11,West Virginia,54,30201,885,553,7,875117,11074,30201,885,844916,10189
2020-11-11,Wisconsin,55,301349,7487,2562,65,2251217,17961,301349,7537,1949868,10424
2020-11-11,Wyoming,56,19374,132,127,0,146613,223,19374,132,127239,91
2020-11-12,Alabama,01,210637,2000,3213,12,1455872,2000,210637,2000,1245235,0
2020-11-12,Alaska,02,21689,478,90,0,844666,10076,20702,481,823964,9595
2020-11-12,Arizona,04,266644,1449,6240,12,1930540,15305,266562,1399,1663978,13906
2020-11-12,Arkansas,05,128006,1809,2144,18,1482925,13677,128006,1809,1354919,11868
2020-11-12,California,06,1009187,9689,18141,32,20342072,119979,991609,6927,19350463,113052
2020-11-12,Colorado,08,149262,5709,2512,31,1400249,5197,147599,5197,1252650,0
2020-11-12,Connecticut,09,85899,1158,4726,10,2663481,24276,85899,1158,2577582,23118
2020-11-12,Delaware,10,27546,204,732,8,372234,1609,27546,204,344688,1405
2020-11-12,District of Columbia,11,18507,128,657,0,571530,4458,18507,128,553023,4330
2020-11-12,Florida,12,863611,5607,17371,72,6493713,26732,851825,5504,5641888,21228
2020-11-12,Georgia,13,401750,2981,8655,73,3807413,21367,380190,2496,3427223,18871
2020-11-12,Guam,66,6819,95,92,0,75449,900,5850,95,69599,805
2020-11-12,Hawaii,15,16403,94,221,0,16437,117,16437,117,,0
2020-11-12,Idaho,16,78877,1341,753,15,428367,3976,77121,1693,351246,2283
2020-11-12,Illinois,17,537860,12788,10855,50,8765100,100617,536542,12702,8228558,87915
2020-11-12,Indiana,18,233540,6605,4813,51,1876317,22617,230965,6591,1645352,16026
2020-11-12,Iowa,19,173401,4944,1947,20,964756,6403,155603,3650,809153,2753
2020-11-12,Kansas,20,111503,526,1215,0,700505,-3142,109225,0,591280,-3142
2020-11-12,Kentucky,21,132686,2378,1702,13,2167395,38341,129680,2336,2037715,36005
2020-11-12,Louisiana,22,198531,3829,6097,39,2958488,33565,198531,3829,2759957,29736
2020-11-12,Maine,23,8395,193,159,1,725560,20987,8395,193,717165,20794
2020-11-12,Maryland,24,160311,1475,4261,12,2071985,11149,159900,1477,1912085,9672
2020-11-12,Massachusetts,25,180189,2648,10242,20,2974611,21897,180189,2648,2794422,19249
2020-11-12,Michigan,26,258973,7474,8187,50,5549792,67316,259183,7311,5290609,60005
2020-11-12,Minnesota,27,201851,7225,2849,39,2070714,25398,201795,7225,1868919,18173
2020-11-12,Mississippi,28,130665,1271,3514,17,1004528,1271,130665,1271,873863,0
2020-11-12,Missouri,29,235341,5338,3441,30,1639564,11645,225371,4603,1414193,7042
2020-11-12,Montana,30,43084,952,478,3,557951,10223,43031,961,514920,9262
2020-11-12,Nebraska,31,92553,2611,768,27,644851,5389,89942,2209,554909,3180
2020-11-12,Nevada,32,115360,1504,1880,3,865363,6044,114880,1469,750483,4575
2020-11-12,New Hampshire,33,13470,322,495,3,376456,4312,13470,322,362986,3990
2020-11-12,New Jersey,34,268787,3492,16495,19,5143091,40550,285479,4236,4857612,36314
2020-11-12,New Mexico,35,60776,1742,1176,18,1330403,13155,60776,1742,1269627,11413
2020-11-12,New York,36,550516,4798,33424,26,16231193,162627,545762,4797,15685431,157830
2020-11-12,North Carolina,37,303931,3206,4730,7,4500774,40486,303454,2893,4197320,37593
2020-11-12,North Dakota,38,59179,1801,703,12,317096,2822,59875,1835,257221,987
2020-11-12,Northern Mariana Islands,69,100,0,2,0,16567,0,100,0,16467,0
2020-11-12,Ohio,39,274457,7101,5658,35,5066497,56714,274457,7101,4792040,49613
2020-11-12,Oklahoma,40,144691,2357,1481,11,1750494,2357,144691,2357,1605803,0
2020-11-12,Oregon,41,53879,1109,748,2,928343,7127,52770,861,875573,6266
2020-11-12,Pennsylvania,42,254167,6023,9272,55,2755505,23376,248856,5488,2506649,17888
2020-11-12,Puerto Rico,72,74067,1332,909,8,346424,1332,40452,1332,305972,0
2020-11-12,Rhode Island,44,40764,988,1250,7,474414,3130,40764,988,433650,2142
2020-11-12,South Carolina,45,190490,1495,4084,8,2020945,20236,190490,1495,1830455,18741
2020-11-12,South Dakota,46,60716,2020,567,0,286088,2968,60716,2020,225372,948
2020-11-12,Tennessee,47,291482,3171,3751,24,3995978,21955,296725,3344,3699253,18611
2020-11-12,Texas,48,1060798,9727,19705,161,9509989,98946,1075654,10589,8434335,88357
2020-11-12,Utah,49,143639,3824,689,11,1155716,11703,143639,3919,1012077,7784
2020-11-12,Vermont,50,2651,116,59,0,196748,1356,2727,125,194021,1231
2020-11-12,Virgin Islands,78,1413,0,23,0,25487,0,1410,0,24077,0
2020-11-12,Virginia,51,198027,1521,3758,17,2871201,12574,198027,1521,2673174,11053
2020-11-12,Washington,53,129672,2786,2619,24,2655007,2384,130593,2384,2524414,0
2020-11-12,West Virginia,54,30897,696,555,2,888299,13182,30897,696,857402,12486
2020-11-12,Wisconsin,55,309605,8256,2626,64,2274371,23154,309572,8223,1964799,14931
2020-11-12,Wyoming,56,20479,1105,127,0,149287,2674,20479,1105,128808,1569
2020-11-13,Alabama,01,213617,2980,3231,18,1474217,18345,213617,2980,1260600,15365
2020-11-13,Alaska,02,22282,593,91,1,844666,0,21286,584,823380,-584
2020-11-13,Arizona,04,270596,3952,6257,17,1949839,19299,269577,3015,1680262,16284
2020-11-13,Arkansas,05,130318,2312,2148,4,1497395,14470,130318,2312,1367077,12158
2020-11-13,California,06,1019052,9865,18218,77,20478500,136428,998502,6893,19479998,129535
2020-11-13,Colorado,08,155761,6499,2541,29,1423901,23652,154038,6439,1269863,17213
2020-11-13,Connecticut,09,88645,2746,4737,11,2706667,43186,88645,2746,2618022,40440
2020-11-13,Delaware,10,28016,470,734,2,375223,2989,28016,470,347207,2519
2020-11-13,District of Columbia,11,18666,159,657,0,577601,6071,18666,159,558935,5912
2020-11-13,Florida,12,870544,6933,17444,73,6522985,29272,858585,6760,5664400,22512
2020-11-13,Georgia,13,404577,2827,8678,23,3838550,31137,382505,2315,3456045,28822
2020-11-13,Guam,66,6893,74,93,1,76292,843,5924,74,70368,769
2020-11-13,Hawaii,15,16514,111,221,0,16534,97,16534,97,,0
2020-11-13,Idaho,16,80440,1563,756,3,431982,3615,78279,1158,353703,2457
2020-11-13,Illinois,17,553083,15223,10907,52,8871640,106540,551957,15415,8319683,91125
2020-11-13,Indiana,18,239139,5599,4863,50,1893070,16753,236565,5600,1656505,11153
2020-11-13,Iowa,19,178890,5489,1972,25,971644,6888,159635,4032,812009,2856
2020-11-13,Kansas,20,117282,5779,1256,41,706787,6282,115507,6282,591280,0
2020-11-13,Kentucky,21,135855,3169,1729,27,2196131,28736,132844,3164,2063287,25572
2020-11-13,Louisiana,22,201981,3450,6121,24,2992468,33980,201981,3450,2790487,30530
2020-11-13,Maine,23,8639,244,162,3,734410,8850,8639,244,725771,8606
2020-11-13,Maryland,24,162181,1870,4273,12,2084302,12317,161769,1869,1922533,10448
2020-11-13,Massachusetts,25,183095,2906,10265,23,2996729,22118,183095,2906,2813634,19212
2020-11-13,Michigan,26,268072,9099,8312,125,5623152,73360,268362,9179,5354790,64181
2020-11-13,Minnesota,27,207395,5544,2895,46,2095513,24799,207339,5544,1888174,19255
2020-11-13,Mississippi,28,131970,1305,3519,5,1005833,1305,131970,1305,873863,0
2020-11-13,Missouri,29,241236,5895,3452,11,1647747,8183,229376,4005,1418371,4178
2020-11-13,Montana,30,44297,1213,483,5,566544,8593,44244,1213,522300,7380
2020-11-13,Nebraska,31,94922,2369,789,21,650659,5808,92553,2611,558106,3197
2020-11-13,Nevada,32,117322,1962,1896,16,871005,5642,116737,1857,754268,3785
2020-11-13,New Hampshire,33,13929,459,498,3,380172,3716,13929,459,366243,3257
2020-11-13,New Jersey,34,272184,3397,16522,27,5188350,45259,289502,4023,4898848,41236
2020-11-13,New Mexico,35,62006,1230,1198,22,1348194,17791,62006,1230,1286188,16561
2020-11-13,New York,36,555917,5401,33452,28,16434914,203721,551163,5401,15883751,198320
2020-11-13,North Carolina,37,306498,2567,4749,19,4536767,35993,305233,1779,4231534,34214
2020-11-13,North Dakota,38,60608,1429,713,10,319501,2405,61365,1490,258136,915
2020-11-13,Northern Mariana Islands,69,100,0,2,0,16567,0,100,0,16467,0
2020-11-13,Ohio,39,282528,8071,5700,42,5132781,66284,282528,8071,4850253,58213
2020-11-13,Oklahoma,40,147358,2667,1493,12,1791023,40529,147358,2667,1643665,37862
2020-11-13,Oregon,41,54937,1058,759,11,935877,7534,53879,1109,881998,6425
2020-11-13,Pennsylvania,42,260001,5834,9306,34,2778371,22866,254387,5531,2523984,17335
2020-11-13,Puerto Rico,72,74734,667,914,5,347091,667,41119,667,305972,0
2020-11-13,Rhode Island,44,41529,765,1254,4,476930,2516,41529,765,435401,1751
2020-11-13,South Carolina,45,192101,1611,4101,17,2030994,10049,192101,1611,1838893,8438
2020-11-13,South Dakota,46,62327,1611,568,1,288661,2573,62327,1611,226334,962
2020-11-13,Tennessee,47,295135,3653,3814,63,4019449,23471,300458,3733,3718991,19738
2020-11-13,Texas,48,1073382,12584,19917,212,9606477,96488,1089078,13424,8517399,83064
2020-11-13,Utah,49,146155,2516,703,14,1164731,9015,145789,2150,1018942,6865
2020-11-13,Vermont,50,2743,92,59,0,197774,1026,2829,102,194945,924
2020-11-13,Virgin Islands,78,1426,13,23,0,25487,0,1410,0,24077,0
2020-11-13,Virginia,51,199262,1235,3785,27,2881795,10594,199262,1235,2682533,9359
2020-11-13,Washington,53,132183,2511,2634,15,2703570,48563,132756,2163,2570814,46400
2020-11-13,West Virginia,54,31639,742,565,10,902293,13994,31639,742,870654,13252
2020-11-13,Wisconsin,55,318023,8418,2694,68,2293535,19164,318023,8451,1975512,10713
2020-11-13,Wyoming,56,21341,862,127,0,151549,2262,21341,862,130208,1400
2020-11-14,Alabama,01,215843,2226,3246,15,1487103,12886,215843,2226,1271260,10660
2020-11-14,Alaska,02,23029,747,92,1,862264,17598,22020,734,840244,16864
2020-11-14,Arizona,04,273400,2804,6300,43,1968659,18820,273053,3476,1695606,15344
2020-11-14,Arkansas,05,132166,1848,2159,11,1497395,0,130318,0,1367077,0
2020-11-14,California,06,1027016,7964,18254,36,20671596,193096,1008377,9875,19663219,183221
2020-11-14,Colorado,08,160459,4698,2554,13,1444324,20423,159234,5196,1285090,15227
2020-11-14,Connecticut,09,88645,0,4737,0,2706667,0,88645,0,2618022,0
2020-11-14,Delaware,10,28395,379,736,2,377364,2141,28395,379,348969,1762
2020-11-14,District of Columbia,11,18814,148,658,1,583319,5718,18814,148,564505,5570
2020-11-14,Florida,12,875088,4544,17488,44,6554952,31967,862990,4405,5691962,27562
2020-11-14,Georgia,13,407596,3019,8729,51,3865939,27389,384997,2492,3480942,24897
2020-11-14,Guam,66,6893,0,93,0,76757,465,5965,41,70792,424
2020-11-14,Hawaii,15,16619,105,221,0,16652,118,16652,118,,0
2020-11-14,Idaho,16,81625,1185,763,7,435863,3881,79798,1519,356065,2362
2020-11-14,Illinois,17,564086,11003,11098,191,8986010,114370,562985,11028,8423025,103342
2020-11-14,Indiana,18,247466,8327,4888,25,1917951,24881,244887,8322,1673064,16559
2020-11-14,Iowa,19,183557,4667,1985,13,979886,8242,163728,4093,816158,4149
2020-11-14,Kansas,20,117728,446,1256,0,706787,0,115507,0,591280,0
2020-11-14,Kentucky,21,138854,2999,1739,10,2217321,21190,136137,3293,2081184,17897
2020-11-14,Louisiana,22,201981,0,6121,0,2992468,0,201981,0,2790487,0
2020-11-14,Maine,23,8791,152,163,1,734562,152,8791,152,725771,0
2020-11-14,Maryland,24,164239,2058,4293,20,2098169,13867,164090,2321,1934079,11546
2020-11-14,Massachusetts,25,186142,3047,10293,28,3024727,27998,186142,3047,2838585,24951
2020-11-14,Michigan,26,275393,7321,8375,63,5692584,69432,275792,7430,5416792,62002
2020-11-14,Minnesota,27,216084,8689,2930,35,2119079,23566,216028,8689,1903051,14877
2020-11-14,Mississippi,28,133340,1370,3540,21,1007203,1370,133340,1370,873863,0
2020-11-14,Missouri,29,248400,7164,3463,11,1661030,13283,235722,6346,1425308,6937
2020-11-14,Montana,30,45919,1622,519,36,569694,3150,45886,1642,523808,1508
2020-11-14,Nebraska,31,96834,1912,790,1,655959,5300,94922,2369,561037,2931
2020-11-14,Nevada,32,119228,1906,1908,12,877838,6833,119006,2269,758832,4564
2020-11-14,New Hampshire,33,14311,382,499,1,383661,3489,14311,382,369350,3107
2020-11-14,New Jersey,34,276537,4353,16548,26,5230463,42113,294472,4970,4935991,37143
2020-11-14,New Mexico,35,63171,1165,1208,10,1360452,12258,63171,1165,1297281,11093
2020-11-14,New York,36,561308,5391,33477,25,16619076,184162,556551,5388,16062525,178774
2020-11-14,North Carolina,37,309703,3205,4783,34,4591525,54758,309118,3885,4282407,50873
2020-11-14,North Dakota,38,62878,2270,732,19,323050,3549,63694,2329,259356,1220
2020-11-14,Northern Mariana Islands,69,100,0,2,0,16567,0,100,0,16467,0
2020-11-14,Ohio,39,290243,7715,5714,14,5195015,62234,290243,7715,4904772,54519
2020-11-14,Oklahoma,40,150205,2847,1516,23,1803804,12781,150205,2847,1653599,9934
2020-11-14,Oregon,41,56018,1081,760,1,943147,7270,54937,1058,888210,6212
2020-11-14,Pennsylvania,42,264396,4395,9353,47,2798085,19714,259938,5551,2538147,14163
2020-11-14,Puerto Rico,72,75387,653,921,7,347744,653,41772,653,305972,0
2020-11-14,Rhode Island,44,41529,0,1254,0,480477,3547,42763,1234,437714,2313
2020-11-14,South Carolina,45,194014,1913,4110,9,2072140,41146,194014,1913,1878126,39233
2020-11-14,South Dakota,46,64182,1855,621,53,291823,3162,64182,1855,227641,1307
2020-11-14,Tennessee,47,299597,4462,3839,25,4054301,34852,305120,4662,3749181,30190
2020-11-14,Texas,48,1083132,9750,20035,118,9705429,98952,1100479,11401,8604950,87551
2020-11-14,Utah,49,151141,4986,712,9,1180724,15993,151141,5352,1029583,10641
2020-11-14,Vermont,50,2843,100,59,0,198824,1050,2927,98,195897,952
2020-11-14,Virgin Islands,78,1434,8,23,0,26069,582,1434,24,24635,558
2020-11-14,Virginia,51,200799,1537,3799,14,2905317,23522,200799,1537,2704518,21985
2020-11-14,Washington,53,133612,1429,2638,4,2732255,28685,135666,2910,2596589,25775
2020-11-14,West Virginia,54,32792,1153,574,9,915656,13363,32792,1153,882864,12210
2020-11-14,Wisconsin,55,323604,5581,2748,54,2312924,19389,323604,5581,1989320,13808
2020-11-14,Wyoming,56,21881,540,144,17,152089,540,21881,540,130208,0
2020-11-15,Alabama,01,217822,1979,3248,2,1493737,6634,217822,1979,1275915,4655
2020-11-15,Alaska,02,23688,659,92,0,867382,5118,22662,642,844720,4476
2020-11-15,Arizona,04,275523,2123,6302,2,1981831,13172,275436,2383,1706395,10789
2020-11-15,Arkansas,05,133040,874,2183,24,1519751,22356,133040,2722,1386711,19634
2020-11-15,California,06,1035981,8965,18265,11,20866785,195189,1019345,10968,19847440,184221
2020-11-15,Colorado,08,164408,3949,2574,20,1462983,18659,163417,4183,1299566,14476
2020-11-15,Connecticut,09,88645,0,4737,0,2706667,0,88645,0,2618022,0
2020-11-15,Delaware,10,28803,408,736,0,379815,2451,28803,408,351012,2043
2020-11-15,District of Columbia,11,18977,163,660,2,588620,5301,18977,163,569643,5138
2020-11-15,Florida,12,885193,10105,17517,29,6599305,44353,872810,9820,5726495,34533
2020-11-15,Georgia,13,409504,1908,8730,1,3887286,21347,386949,1952,3500337,19395
2020-11-15,Guam,66,6893,0,93,0,77376,619,6121,156,71255,463
2020-11-15,Hawaii,15,16619,0,221,0,16759,107,16759,107,,0
2020-11-15,Idaho,16,82545,920,763,0,439714,3851,81317,1519,358397,2332
2020-11-15,Illinois,17,574722,10636,11170,72,9070841,84831,573616,10631,8497225,74200
2020-11-15,Indiana,18,254172,6706,4910,22,1938289,20338,251597,6710,1686692,13628
2020-11-15,Iowa,19,186314,2757,1989,4,988601,8715,167282,3554,821319,5161
2020-11-15,Kansas,20,117851,123,1256,0,706787,0,115507,0,591280,0
2020-11-15,Kentucky,21,140267,1413,1742,3,2218770,1449,137586,1449,2081184,0
2020-11-15,Louisiana,22,204513,2532,6132,11,3029596,37128,204513,2532,2825083,34596
2020-11-15,Maine,23,8944,153,165,2,734715,153,8944,153,725771,0
2020-11-15,Maryland,24,166317,2078,4302,9,2110466,12297,165930,1840,1944536,10457
2020-11-15,Massachusetts,25,188275,2133,10329,36,3042924,18197,188275,2133,2854649,16064
2020-11-15,Michigan,26,275892,499,8378,3,5692584,0,275792,0,5416792,0
2020-11-15,Minnesota,27,223637,7553,2961,31,2151282,32203,223581,7553,1927701,24650
2020-11-15,Mississippi,28,134309,969,3543,3,1008172,969,134309,969,873863,0
2020-11-15,Missouri,29,249608,1208,3463,0,1669473,8443,239451,3729,1430022,4714
2020-11-15,Montana,30,47158,1239,525,6,572561,2867,47158,1272,525403,1595
2020-11-15,Nebraska,31,98161,1327,791,1,661243,5284,96834,1912,564409,3372
2020-11-15,Nevada,32,120744,1516,1913,5,882523,4685,120183,1177,762340,3508
2020-11-15,New Hampshire,33,14671,360,499,0,387361,3700,14671,360,372690,3340
2020-11-15,New Jersey,34,281075,4538,16566,18,5359310,128847,299514,5042,5059796,123805
2020-11-15,New Mexico,35,64201,1030,1215,7,1372867,12415,64201,1030,1308666,11385
2020-11-15,New York,36,564952,3644,33508,31,16752278,133202,560200,3649,16192078,129553
2020-11-15,North Carolina,37,312406,2703,4830,47,4632609,41084,312235,3117,4320374,37967
2020-11-15,North Dakota,38,63802,924,742,10,324518,1468,64654,960,259864,508
2020-11-15,Northern Mariana Islands,69,100,0,2,0,16567,0,100,0,16467,0
2020-11-15,Ohio,39,298096,7853,5722,8,5262026,67011,298096,7853,4963930,59158
2020-11-15,Oklahoma,40,154128,3923,1528,12,1807727,3923,154128,3923,1653599,0
2020-11-15,Oregon,41,56880,862,762,2,951565,8418,56018,1081,895547,7337
2020-11-15,Pennsylvania,42,269043,4647,9385,32,2824633,26548,265137,5199,2559496,21349
2020-11-15,Puerto Rico,72,76094,707,935,14,348451,707,42479,707,305972,0
2020-11-15,Rhode Island,44,41529,0,1254,0,483583,3106,43442,679,440141,2427
2020-11-15,South Carolina,45,195507,1493,4112,2,2090589,18449,195507,1493,1895082,16956
2020-11-15,South Dakota,46,65381,1199,644,23,294114,2291,65381,1199,228733,1092
2020-11-15,Tennessee,47,305211,5614,3856,17,4100329,46028,310937,5817,3789392,40211
2020-11-15,Texas,48,1090500,7368,20110,75,9762352,56923,1108402,7923,8653950,49000
2020-11-15,Utah,49,153808,2667,718,6,1189268,8544,153808,2667,1035460,5877
2020-11-15,Vermont,50,2889,46,59,0,199534,710,2971,44,196563,666
2020-11-15,Virgin Islands,78,1434,0,23,0,26069,0,1434,0,24635,0
2020-11-15,Virginia,51,201960,1161,3800,1,2939243,33926,201960,1161,2737283,32765
2020-11-15,Washington,53,135365,1753,2638,0,2759327,27072,138276,2610,2621051,24462
2020-11-15,West Virginia,54,33659,867,582,8,926879,11223,33659,867,893220,10356
2020-11-15,Wisconsin,55,329924,6320,2759,11,2331163,18239,329924,6320,2001239,11919
2020-11-15,Wyoming,56,22494,613,144,0,152702,613,22494,613,130208,0
2020-11-16,Alabama,01,219232,1410,3249,1,1501190,7453,219232,1410,1281958,6043
2020-11-16,Alaska,02,24268,580,92,0,872347,4965,23240,578,849107,4387
2020-11-16,Arizona,04,277179,1656,6302,0,1995236,13405,276912,1476,1718324,11929
2020-11-16,Arkansas,05,134348,1308,2225,42,1531206,11455,134348,1308,1396858,10147
2020-11-16,California,06,1047360,11379,18304,39,21068894,202109,1029235,9890,20039659,192219
2020-11-16,Colorado,08,168890,4482,2605,31,1481306,18323,167713,4296,1313593,14027
2020-11-16,Connecticut,09,93284,4639,4759,22,2793152,86485,93284,4639,2699868,81846
2020-11-16,Delaware,10,29200,397,736,0,382909,3094,29200,397,353709,2697
2020-11-16,District of Columbia,11,19064,87,660,0,590352,1732,19064,87,571288,1645
2020-11-16,Florida,12,889856,4663,17558,41,6625477,26172,877340,4530,5748137,21642
2020-11-16,Georgia,13,410581,1077,8740,10,3900708,13422,387930,981,3512778,12441
2020-11-16,Guam,66,7144,251,99,6,78133,757,6175,54,71958,703
2020-11-16,Hawaii,15,16711,92,221,0,16853,94,16853,94,,0
2020-11-16,Idaho,16,83906,1361,773,10,442233,2519,82245,928,359988,1591
2020-11-16,Illinois,17,586569,11847,11217,47,9161453,90612,585248,11632,8576205,78980
2020-11-16,Indiana,18,259318,5146,4936,26,1952202,13913,256744,5147,1695458,8766
2020-11-16,Iowa,19,189597,3283,2023,34,992851,4250,169353,2071,823498,2179
2020-11-16,Kansas,20,124697,6846,1266,10,733756,26969,122741,7234,611015,19735
2020-11-16,Kentucky,21,142277,2010,1750,8,2265659,46889,139097,1511,2126562,45378
2020-11-16,Louisiana,22,205059,546,6139,7,3037236,7640,205059,546,2832177,7094
2020-11-16,Maine,23,9117,173,165,0,756172,21457,9117,173,747055,21284
2020-11-16,Maryland,24,168041,1724,4309,7,2123275,12809,167656,1726,1955619,11083
2020-11-16,Massachusetts,25,190439,2164,10340,11,3060081,17157,190439,2164,2869642,14993
2020-11-16,Michigan,26,288543,12651,8437,59,5808470,115886,288954,13162,5519516,102724
2020-11-16,Minnesota,27,231074,7437,2973,12,2176285,25003,231018,7437,1945267,17566
2020-11-16,Mississippi,28,134898,589,3545,2,1041889,33717,134898,589,906991,33128
2020-11-16,Missouri,29,255942,6334,3485,22,1678572,9099,243169,3718,1435403,5381
2020-11-16,Montana,30,48101,943,528,3,573334,773,48027,869,525307,-96
2020-11-16,Nebraska,31,101601,3440,805,14,664980,3737,98161,1327,566819,2410
2020-11-16,Nevada,32,122441,1697,1919,6,887159,4636,122097,1914,765062,2722
2020-11-16,New Hampshire,33,15029,358,500,1,390575,3214,15029,358,375546,2856
2020-11-16,New Jersey,34,283294,2219,16580,14,5362044,2734,302248,2734,5059796,0
2020-11-16,New Mexico,35,65454,1253,1236,21,1386121,13254,65454,1253,1320667,12001
2020-11-16,New York,36,568450,3498,33540,32,16876843,124565,563690,3490,16313153,121075
2020-11-16,North Carolina,37,315314,2908,4843,13,4659829,27220,314207,1972,4345622,25248
2020-11-16,North Dakota,38,64891,1089,749,7,326344,1826,65738,1084,260606,742
2020-11-16,Northern Mariana Islands,69,102,2,2,0,16569,2,102,2,16467,0
2020-11-16,Ohio,39,305364,7268,5742,20,5318839,56813,305364,7268,5013475,49545
2020-11-16,Oklahoma,40,156857,2729,1538,10,1810456,2729,156857,2729,1653599,0
2020-11-16,Oregon,41,57646,766,772,10,957979,6414,56880,862,901099,5552
2020-11-16,Pennsylvania,42,275257,6214,9399,14,2843234,18601,269613,4476,2573621,14125
2020-11-16,Puerto Rico,72,76631,537,942,7,348988,537,43016,537,305972,0
2020-11-16,Rhode Island,44,43923,2394,1270,16,485400,1817,43923,481,441477,1336
2020-11-16,South Carolina,45,196617,1110,4143,31,2105533,14944,196617,1110,1908916,13834
2020-11-16,South Dakota,46,66278,897,644,0,296147,2033,66278,897,229869,1136
2020-11-16,Tennessee,47,312710,7499,3884,28,4161846,61517,318888,7951,3842958,53566
2020-11-16,Texas,48,1101781,11281,20157,47,9801355,39003,1116230,7828,8685125,31175
2020-11-16,Utah,49,155779,1971,725,7,1198557,9289,155779,1971,1042778,7318
2020-11-16,Vermont,50,3008,119,59,0,200472,938,3095,124,197377,814
2020-11-16,Virgin Islands,78,1434,0,23,0,26069,0,1434,0,24635,0
2020-11-16,Virginia,51,204637,2677,3806,6,2957245,18002,204637,2677,2752608,15325
2020-11-16,Washington,53,138602,3237,2661,23,2788212,28885,140157,1881,2648055,27004
2020-11-16,West Virginia,54,34460,801,585,3,938911,12032,34460,801,904451,11231
2020-11-16,Wisconsin,55,334640,4716,2775,16,2343710,12547,334562,4638,2009148,7909
2020-11-16,Wyoming,56,23193,699,144,0,153401,699,23193,699,130208,0
2020-11-17,Alabama,01,220848,1616,3301,52,1508520,7330,220848,1616,1287672,5714
2020-11-17,Alaska,02,24909,641,94,2,878622,6275,23874,634,854748,5641
2020-11-17,Arizona,04,281284,4105,6320,18,2011792,16556,279896,2984,1731896,13572
2020-11-17,Arkansas,05,135902,1554,2245,20,1540028,8822,135902,1554,1404126,7268
2020-11-17,California,06,1058096,10736,18360,56,21259076,190182,1037978,8743,20221098,181439
2020-11-17,Colorado,08,173220,4330,2626,21,1500349,19043,172044,4331,1328305,14712
2020-11-17,Connecticut,09,94986,1702,4771,12,2826458,33306,94986,1702,2731472,31604
2020-11-17,Delaware,10,29552,352,739,3,385476,2567,29552,352,355924,2215
2020-11-17,District of Columbia,11,19309,245,660,0,596742,6390,19309,245,577433,6145
2020-11-17,Florida,12,897315,7459,17643,85,6663538,38061,884625,7285,5778913,30776
2020-11-17,Georgia,13,414821,4240,8778,38,3954422,53714,391466,3536,3562956,50178
2020-11-17,Guam,66,7203,59,101,2,78948,815,6234,59,72714,756
2020-11-17,Hawaii,15,16755,44,221,0,16905,52,16905,52,,0
2020-11-17,Idaho,16,85383,1477,803,30,445207,2974,83344,1099,361863,1875
2020-11-17,Illinois,17,599358,12789,11327,110,9255658,94205,597849,12601,8657809,81604
2020-11-17,Indiana,18,264810,5492,5025,89,1969088,16886,262207,5463,1706881,11423
2020-11-17,Iowa,19,193196,3599,2064,41,997034,4183,171545,2192,825489,1991
2020-11-17,Kansas,20,125668,971,1266,0,733756,0,122741,0,611015,0
2020-11-17,Kentucky,21,145220,2943,1787,37,2287167,21508,142008,2911,2145159,18597
2020-11-17,Louisiana,22,207685,2626,6156,17,3068330,31094,207685,2626,2860645,28468
2020-11-17,Maine,23,9363,246,166,1,764918,8746,9363,246,755555,8500
2020-11-17,Maryland,24,170193,2152,4335,26,2135601,12326,169805,2149,1965796,10177
2020-11-17,Massachusetts,25,192964,2525,10360,20,3078086,18005,192964,2525,2885122,15480
2020-11-17,Michigan,26,296436,7893,8513,76,5865787,57317,296840,7886,5568947,49431
2020-11-17,Minnesota,27,237005,5931,2999,26,2191193,14908,236949,5931,1954244,8977
2020-11-17,Mississippi,28,135803,905,3581,36,1042794,905,135803,905,906991,0
2020-11-17,Missouri,29,261105,5163,3552,67,1692549,13977,248886,5717,1443663,8260
2020-11-17,Montana,30,49496,1395,548,20,583828,10494,49398,1371,534430,9123
2020-11-17,Nebraska,31,103805,2204,827,22,674139,9159,101601,3440,572538,5719
2020-11-17,Nevada,32,124082,1641,1946,27,892492,5333,123794,1697,768698,3636
2020-11-17,New Hampshire,33,15303,274,502,2,392141,1566,15303,274,376838,1292
2020-11-17,New Jersey,34,287320,4026,16618,38,5396155,34111,306983,4735,5089172,29376
2020-11-17,New Mexico,35,67559,2105,1264,28,1398339,12218,67559,2105,1330780,10113
2020-11-17,New York,36,573544,5094,33576,36,17036695,159852,568778,5088,16467917,154764
2020-11-17,North Carolina,37,318537,3223,4881,38,4697561,37732,317495,3288,4380066,34444
2020-11-17,North Dakota,38,65973,1082,775,26,328240,1896,66867,1129,261373,767
2020-11-17,Northern Mariana Islands,69,103,1,2,0,16570,1,103,1,16467,0
2020-11-17,Ohio,39,312443,7079,5772,30,5364520,45681,312443,7079,5052077,38602
2020-11-17,Oklahoma,40,158408,1551,1544,6,1851019,40563,158408,1551,1692611,39012
2020-11-17,Oregon,41,58570,924,779,7,962982,5003,57646,766,905336,4237
2020-11-17,Pennsylvania,42,280978,5721,9433,34,2863980,20746,275513,5900,2588467,14846
2020-11-17,Puerto Rico,72,77200,569,951,9,349557,569,43585,569,305972,0
2020-11-17,Rhode Island,44,44528,605,1278,8,488250,2850,44528,605,443722,2245
2020-11-17,South Carolina,45,197900,1283,4156,13,2122323,16790,197900,1283,1924423,15507
2020-11-17,South Dakota,46,67284,1006,644,0,298359,2212,67284,1006,231075,1206
2020-11-17,Tennessee,47,314553,1843,3953,69,4176151,14305,320729,1841,3855422,12464
2020-11-17,Texas,48,1112681,10900,20278,121,9920871,119516,1129874,13644,8790997,105872
2020-11-17,Utah,49,159006,3227,734,9,1208117,9560,158957,3178,1049160,6382
2020-11-17,Vermont,50,3104,96,59,0,201487,1015,3201,106,198286,909
2020-11-17,Virgin Islands,78,1450,16,23,0,26433,364,1450,16,24983,348
2020-11-17,Virginia,51,206762,2125,3835,29,2982632,25387,206762,2125,2775870,23262
2020-11-17,Washington,53,140923,2321,2686,25,2805530,17318,141326,1169,2664204,16149
2020-11-17,West Virginia,54,35324,864,598,13,947444,8533,35324,864,912120,7669
2020-11-17,Wisconsin,55,342155,7515,2876,101,2366956,23246,342155,7593,2024801,15653
2020-11-17,Wyoming,56,24453,1260,155,11,152140,-1261,24453,1260,127687,-2521
2020-11-18,Alabama,01,223486,2638,3347,46,1517531,9011,223486,2638,1294045,6373
2020-11-18,Alaska,02,25454,545,94,0,885558,6936,24419,545,861139,6391
2020-11-18,Arizona,04,284554,3270,6365,45,2026755,14963,283102,3206,1743653,11757
2020-11-18,Arkansas,05,137617,1715,2275,30,1552919,12891,137617,1715,1415302,11176
2020-11-18,California,06,1069517,11421,18467,107,21418543,159467,1047789,9811,20370754,149656
2020-11-18,Colorado,08,178224,5004,2669,43,1520268,19919,176694,4650,1343574,15269
2020-11-18,Connecticut,09,97028,2042,4784,13,2860684,34226,97028,2042,2763656,32184
2020-11-18,Delaware,10,29755,203,742,3,386673,1197,29755,203,356918,994
2020-11-18,District of Columbia,11,19465,156,665,5,601412,4670,19465,156,581947,4514
2020-11-18,Florida,12,905240,7925,17730,87,6704999,41461,892352,7727,5812647,33734
2020-11-18,Georgia,13,417934,3113,8833,55,3975069,20647,393890,2424,3581179,18223
2020-11-18,Guam,66,7315,112,101,0,79060,112,6346,112,72714,0
2020-11-18,Hawaii,15,16817,62,222,1,16974,69,16974,69,,0
2020-11-18,Idaho,16,87020,1637,815,12,448393,3186,85125,1781,363268,1405
2020-11-18,Illinois,17,608056,8698,11488,161,9359227,103569,606771,8922,8752456,94647
2020-11-18,Indiana,18,270847,6037,5084,59,1989456,20368,268222,6015,1721234,14353
2020-11-18,Iowa,19,197532,4336,2102,38,1003986,6952,174839,3294,829147,3658
2020-11-18,Kansas,20,131051,5383,1326,60,748261,14505,128594,5853,619667,8652
2020-11-18,Kentucky,21,148069,2849,1816,29,2318785,31618,144753,2745,2174032,28873
2020-11-18,Louisiana,22,209914,2229,6184,28,3085849,17519,209914,2229,2875935,15290
2020-11-18,Maine,23,9519,156,170,4,775369,10451,9519,156,765850,10295
2020-11-18,Maryland,24,172204,2011,4351,16,2149335,13734,171823,2018,1977512,11716
2020-11-18,Massachusetts,25,195868,2904,10407,47,3101308,23222,195868,2904,2905440,20318
2020-11-18,Michigan,26,302541,6105,8576,63,5922691,56904,303058,6218,5619633,50686
2020-11-18,Minnesota,27,242099,5094,3066,67,2207809,16616,242043,5094,1965766,11522
2020-11-18,Mississippi,28,137396,1593,3601,20,1044387,1593,137396,1593,906991,0
2020-11-18,Missouri,29,266079,4974,3591,39,1702476,9927,253473,4587,1449003,5340
2020-11-18,Montana,30,50650,1154,568,20,591406,7578,50582,1184,540824,6394
2020-11-18,Nebraska,31,106617,2812,838,11,678985,4846,103805,2204,575180,2642
2020-11-18,Nevada,32,126106,2024,1947,1,895771,3279,125459,1665,770312,1614
2020-11-18,New Hampshire,33,15749,446,504,2,394838,2697,15749,446,379089,2251
2020-11-18,New Jersey,34,291374,4054,16655,37,5488328,92173,311742,4759,5176586,87414
2020-11-18,New Mexico,35,70452,2893,1290,26,1409823,11484,70451,2892,1339372,8592
2020-11-18,New York,36,578826,5282,33607,31,17191129,154434,574072,5294,16617057,149140
2020-11-18,North Carolina,37,322258,3721,4927,46,4731171,33610,320862,3367,4410309,30243
2020-11-18,North Dakota,38,67236,1263,791,16,329888,1648,68208,1341,261680,307
2020-11-18,Northern Mariana Islands,69,103,0,2,0,16570,0,103,0,16467,0
2020-11-18,Ohio,39,318828,6385,5827,55,5370905,6385,318828,6385,5052077,0
2020-11-18,Oklahoma,40,161425,3017,1570,26,1868941,17922,161425,3017,1707516,14905
2020-11-18,Oregon,41,59670,1100,791,12,969822,6840,58570,924,911252,5916
2020-11-18,Pennsylvania,42,287464,6486,9541,108,2890838,26858,281852,6339,2608986,20519
2020-11-18,Puerto Rico,72,77525,325,971,20,349882,325,43910,325,305972,0
2020-11-18,Rhode Island,44,45911,1383,1284,6,493071,4821,45911,1383,447160,3438
2020-11-18,South Carolina,45,199447,1547,4182,26,2138289,15966,199447,1547,1938842,14419
2020-11-18,South Dakota,46,68671,1387,674,30,300973,2614,68671,1387,232302,1227
2020-11-18,Tennessee,47,319021,4468,4005,52,4200984,24833,325201,4472,3875783,20361
2020-11-18,Texas,48,1125906,13225,20471,193,10039363,118492,1140861,10987,8898502,107505
2020-11-18,Utah,49,162091,3085,742,8,1218943,10826,162028,3071,1056915,7755
2020-11-18,Vermont,50,3161,57,60,1,202100,613,3255,54,198845,559
2020-11-18,Virgin Islands,78,1463,13,23,0,26698,265,1463,13,25235,252
2020-11-18,Virginia,51,208833,2071,3860,25,3003410,20778,208833,2071,2794577,18707
2020-11-18,Washington,53,142511,1588,2704,18,2823740,18210,144780,3454,2678960,14756
2020-11-18,West Virginia,54,36277,953,612,14,960384,12940,36277,953,924107,11987
2020-11-18,Wisconsin,55,350665,8510,2939,63,2387606,20650,350665,8510,2036941,12140
2020-11-18,Wyoming,56,25275,822,155,0,152962,822,25275,822,127687,0
2020-11-19,Alabama,01,225910,2424,3419,72,1533166,15635,225910,2424,1307256,13211
2020-11-19,Alaska,02,25946,492,95,1,898799,13241,24909,490,873890,12751
2020-11-19,Arizona,04,288807,4253,6384,19,2045295,18540,287225,4123,1758070,14417
2020-11-19,Arkansas,05,139855,2238,2297,22,1568140,15221,139855,2238,1428285,12983
2020-11-19,California,06,1082674,13157,18555,88,21552528,133985,1059267,11478,20493261,122507
2020-11-19,Colorado,08,184260,6036,2734,65,1546507,26239,182801,6107,1363706,20132
2020-11-19,Connecticut,09,99381,2353,4805,21,2897280,36596,99381,2353,2797899,34243
2020-11-19,Delaware,10,30153,398,742,0,389021,2348,30153,398,358868,1950
2020-11-19,District of Columbia,11,19678,213,667,2,607834,6422,19678,213,588156,6209
2020-11-19,Florida,12,914325,9085,17809,79,6755524,50525,901234,8882,5854290,41643
2020-11-19,Georgia,13,421381,3447,8867,34,4010676,35607,396641,2751,3614035,32856
2020-11-19,Guam,66,7385,70,102,1,79388,328,6416,70,72972,258
2020-11-19,Hawaii,15,16917,100,222,0,17081,107,17081,107,,0
2020-11-19,Idaho,16,88642,1622,838,23,452950,4557,86435,1310,366515,3247
2020-11-19,Illinois,17,622869,14813,11671,183,9472674,113447,621383,14612,8851291,98835
2020-11-19,Indiana,18,278142,7295,5143,59,2009763,20307,275503,7281,1734260,13026
2020-11-19,Iowa,19,201572,4040,2127,25,1011476,7490,178313,3474,833163,4016
2020-11-19,Kansas,20,131408,357,1326,0,748261,0,128594,0,619667,0
2020-11-19,Kentucky,21,151706,3637,1843,27,2355104,36319,148390,3637,2206714,32682
2020-11-19,Louisiana,22,211966,2052,6199,15,3111627,25778,211966,2052,2899661,23726
2020-11-19,Maine,23,9734,215,171,1,788349,12980,9734,215,778615,12765
2020-11-19,Maryland,24,175092,2888,4372,21,2169508,20173,174733,2910,1994775,17263
2020-11-19,Massachusetts,25,198550,2682,10435,28,3123408,22100,198550,2682,2924858,19418
2020-11-19,Michigan,26,310396,7855,8717,141,5992927,70236,311041,7983,5681886,62253
2020-11-19,Minnesota,27,249962,7863,3138,72,2236816,29007,249906,7863,1986910,21144
2020-11-19,Mississippi,28,138791,1395,3619,18,1045782,1395,138791,1395,906991,0
2020-11-19,Missouri,29,270387,4308,3618,27,1712709,10233,257822,4349,1454887,5884
2020-11-19,Montana,30,51872,1222,569,1,595829,4423,51818,1236,544011,3187
2020-11-19,Nebraska,31,109280,2663,863,25,685788,6803,106617,2812,579171,3991
2020-11-19,Nevada,32,128234,2128,1958,11,903173,7402,127875,2416,775298,4986
2020-11-19,New Hampshire,33,16277,528,506,2,397815,2977,16277,528,381538,2449
2020-11-19,New Jersey,34,295556,4182,16689,34,5493199,4871,316613,4871,5176586,0
2020-11-19,New Mexico,35,74116,3664,1302,12,1420797,10974,74116,3665,1346681,7309
2020-11-19,New York,36,584128,5302,33648,41,17386368,195239,579382,5310,16806986,189929
2020-11-19,North Carolina,37,325658,3400,4968,41,4786263,55092,325158,4296,4461105,50796
2020-11-19,North Dakota,38,68618,1382,801,10,332223,2335,69658,1450,262565,885
2020-11-19,Northern Mariana Islands,69,103,0,2,0,16570,0,103,0,16467,0
2020-11-19,Ohio,39,326615,7787,5890,63,5475735,104830,326615,7787,5149120,97043
2020-11-19,Oklahoma,40,164340,2915,1588,18,1890561,21620,164340,2915,1726221,18705
2020-11-19,Oregon,41,60874,1204,809,18,976850,7028,59669,1099,917181,5929
2020-11-19,Pennsylvania,42,294345,6881,9643,102,2918505,27667,288978,7126,2629527,20541
2020-11-19,Puerto Rico,72,78046,521,982,11,350403,521,44431,521,305972,0
2020-11-19,Rhode Island,44,46951,1040,1288,4,496789,3718,46951,1040,449838,2678
2020-11-19,South Carolina,45,201160,1713,4201,19,2162127,23838,201160,1713,1960967,22125
2020-11-19,South Dakota,46,69742,1071,705,31,303269,2296,69742,1071,233527,1225
2020-11-19,Tennessee,47,321832,2811,4082,77,4218632,17648,328088,2887,3890544,14761
2020-11-19,Texas,48,1139695,13789,20689,218,10158442,119079,1155130,14269,9003312,104810
2020-11-19,Utah,49,166040,3949,758,16,1233330,14387,165996,3968,1067334,10419
2020-11-19,Vermont,50,3310,149,61,1,205126,3026,3407,152,201719,2874
2020-11-19,Virgin Islands,78,1469,6,23,0,26940,242,1469,6,25471,236
2020-11-19,Virginia,51,210787,1954,3896,36,3028092,24682,210787,1954,2817305,22728
2020-11-19,Washington,53,144968,2457,2717,13,2848044,24304,147996,3216,2700048,21088
2020-11-19,West Virginia,54,37399,1122,623,11,977539,17155,37399,1122,940140,16033
2020-11-19,Wisconsin,55,358113,7448,3021,82,2407639,20033,358113,7448,2049526,12585
2020-11-19,Wyoming,56,26169,894,176,21,156299,3337,26169,894,130130,2443
2020-11-20,Alabama,01,228373,2463,3451,32,1545177,12011,228373,2463,1316804,9548
2020-11-20,Alaska,02,26403,457,95,0,904712,5913,25369,460,879343,5453
2020-11-20,Arizona,04,292880,4073,6427,43,2072188,26893,291696,4471,1780492,22422
2020-11-20,Arkansas,05,141916,2061,2321,24,1582006,13866,141916,2061,1440090,11805
2020-11-20,California,06,1096401,13727,18649,94,21730551,178023,1072272,13005,20658279,165018
2020-11-20,Colorado,08,190100,5840,2752,18,1572964,26457,188566,5765,1384398,20692
2020-11-20,Connecticut,09,101469,2088,4828,23,2929060,31780,101469,2088,2827591,29692
2020-11-20,Delaware,10,30816,663,746,4,393282,4261,30816,663,362466,3598
2020-11-20,District of Columbia,11,19808,130,669,2,612204,4370,19808,130,592396,4240
2020-11-20,Florida,12,923410,9085,17888,79,6802690,47166,910065,8831,5892625,38335
2020-11-20,Georgia,13,424759,3378,8904,37,4043126,32450,399410,2769,3643716,29681
2020-11-20,Guam,66,7421,36,104,2,79788,400,6452,36,73336,364
2020-11-20,Hawaii,15,17029,112,222,0,17199,118,17199,118,,0
2020-11-20,Idaho,16,90346,1704,849,11,457120,4170,87978,1543,369142,2627
2020-11-20,Illinois,17,635823,12954,11814,143,9588698,116024,634395,13012,8954303,103012
2020-11-20,Indiana,18,284960,6818,5206,63,2030938,21175,282311,6808,1748627,14367
2020-11-20,Iowa,19,205918,4346,2159,32,1019474,7998,181790,3477,837684,4521
2020-11-20,Kansas,20,137224,5816,1410,84,763893,15632,134533,5939,629360,9693
2020-11-20,Kentucky,21,155625,3919,1862,19,2381856,26752,152206,3816,2229650,22936
2020-11-20,Louisiana,22,216709,4743,6233,34,3209377,97750,216709,4743,2992668,93007
2020-11-20,Maine,23,9958,224,173,2,795391,7042,9958,224,785433,6818
2020-11-20,Maryland,24,177239,2147,4398,26,2185431,15923,177086,2353,2008345,13570
2020-11-20,Massachusetts,25,200949,2399,10469,34,3148397,24989,200949,2399,2947448,22590
2020-11-20,Michigan,26,320621,10225,8776,59,6076686,83759,321181,10140,5755505,73619
2020-11-20,Minnesota,27,256756,6794,3206,68,2264278,27462,256700,6794,2007578,20668
2020-11-20,Mississippi,28,140429,1638,3642,23,1047420,1638,140429,1638,906991,0
2020-11-20,Missouri,29,275917,5530,3675,57,1724526,11817,262436,4614,1462090,7203
2020-11-20,Montana,30,53346,1474,575,6,601675,5846,53293,1475,548382,4371
2020-11-20,Nebraska,31,111661,2381,917,54,692154,6366,109280,2663,582874,3703
2020-11-20,Nevada,32,130102,1868,1987,29,906394,3221,129714,1839,776680,1382
2020-11-20,New Hampshire,33,16797,520,507,1,402248,4433,16797,520,385451,3913
2020-11-20,New Jersey,34,299182,3626,16712,23,5541268,48069,320938,4325,5220330,43744
2020-11-20,New Mexico,35,77098,2982,1327,25,1433609,12812,77098,2982,1356511,9830
2020-11-20,New York,36,589605,5477,33696,48,17591834,205466,584850,5468,17006984,199998
2020-11-20,North Carolina,37,330021,4363,5012,44,4819029,32766,328846,3688,4490183,29078
2020-11-20,North Dakota,38,70022,1404,824,23,334404,2181,71092,1434,263312,747
2020-11-20,Northern Mariana Islands,69,103,0,2,0,16570,0,103,0,16467,0
2020-11-20,Ohio,39,335423,8808,5955,65,5544189,68454,335423,8808,5208766,59646
2020-11-20,Oklahoma,40,167261,2921,1603,15,1907186,16625,167261,2921,1739925,13704
2020-11-20,Oregon,41,62176,1302,815,6,985292,8442,60873,1204,924419,7238
2020-11-20,Pennsylvania,42,301373,7028,9748,105,2944656,26151,295786,6808,2648870,19343
2020-11-20,Puerto Rico,72,78950,904,991,9,351307,904,45335,904,305972,0
2020-11-20,Rhode Island,44,48001,1050,1294,6,500932,4143,48001,1050,452931,3093
2020-11-20,South Carolina,45,203161,2001,4231,30,2192748,30621,203161,2001,1989587,28620
2020-11-20,South Dakota,46,71070,1328,741,36,306869,3600,71070,1328,235799,2272
2020-11-20,Tennessee,47,325282,3450,4156,74,4240548,21916,331532,3444,3909016,18472
2020-11-20,Texas,48,1153399,13704,20872,183,10279302,120860,1168925,13795,9110377,107065
2020-11-20,Utah,49,170644,4604,776,18,1247675,14345,170584,4588,1077091,9757
2020-11-20,Vermont,50,3459,149,62,1,206450,1324,3551,144,202899,1180
2020-11-20,Virgin Islands,78,1482,13,23,0,27091,151,1482,13,25609,138
2020-11-20,Virginia,51,213331,2544,3912,16,3056992,28900,213331,2544,2843661,26356
2020-11-20,Washington,53,147251,2283,2738,21,2870129,22085,151066,3070,2719063,19015
2020-11-20,West Virginia,54,38480,1081,639,16,994372,16833,38480,1081,955892,15752
2020-11-20,Wisconsin,55,365190,7077,3106,85,2427381,19742,365190,7077,2062191,12665
2020-11-20,Wyoming,56,27129,960,176,0,158917,2618,27129,960,131788,1658
2020-11-21,Alabama,01,230708,2335,3457,6,1555799,10622,230708,2335,1325091,8287
2020-11-21,Alaska,02,27079,676,95,0,918745,14033,26044,675,892701,13358
2020-11-21,Arizona,04,296997,4117,6459,32,2092097,19909,295334,3638,1796763,16271
2020-11-21,Arkansas,05,143821,1905,2337,16,1597546,15540,143821,1905,1453725,13635
2020-11-21,California,06,1109844,13443,18709,60,21971832,241281,1087714,15442,20884118,225839
2020-11-21,Colorado,08,195220,5120,2791,39,1598694,25730,194679,6113,1404015,19617
2020-11-21,Connecticut,09,101469,0,4828,0,2929060,0,101469,0,2827591,0
2020-11-21,Delaware,10,31321,505,746,0,396943,3661,31321,505,365622,3156
2020-11-21,District of Columbia,11,19961,153,670,1,618784,6580,19961,153,598823,6427
2020-11-21,Florida,12,931819,8409,17929,41,6850174,47484,918240,8175,5931934,39309
2020-11-21,Georgia,13,430687,5928,8940,36,4086142,43016,402435,3025,3683707,39991
2020-11-21,Guam,66,7421,0,104,0,79812,24,6476,24,73336,0
2020-11-21,Hawaii,15,17182,153,229,7,17361,162,17361,162,,0
2020-11-21,Idaho,16,91312,966,851,2,461195,4075,89764,1786,371431,2289
2020-11-21,Illinois,17,647474,11651,11967,153,9708982,120284,646286,11891,9062696,108393
2020-11-21,Indiana,18,291838,6878,5246,40,2053143,22205,289183,6872,1763960,15333
2020-11-21,Iowa,19,209203,3285,2191,32,1027073,7599,184968,3178,842105,4421
2020-11-21,Kansas,20,137295,71,1411,1,763893,0,134533,0,629360,0
2020-11-21,Kentucky,21,159035,3410,1886,24,2434836,52980,155908,3702,2278928,49278
2020-11-21,Louisiana,22,216709,0,6233,0,3209377,0,216709,0,2992668,0
2020-11-21,Maine,23,10123,165,174,1,795556,165,10123,165,785433,0
2020-11-21,Maryland,24,180125,2886,4415,17,2206289,20858,179971,2885,2026318,17973
2020-11-21,Massachusetts,25,204155,3206,10488,19,3181171,32774,204155,3206,2977016,29568
2020-11-21,Michigan,26,328178,7557,8874,98,6164253,87567,329021,7840,5835232,79727
2020-11-21,Minnesota,27,263008,6252,3257,51,2282358,18080,262952,6252,2019406,11828
2020-11-21,Mississippi,28,142401,1972,3657,15,1049392,1972,142401,1972,906991,0
2020-11-21,Missouri,29,279987,4070,3684,9,1727217,2691,267312,4876,1459905,-2185
2020-11-21,Montana,30,54542,1196,604,29,608502,6827,54542,1249,553960,5578
2020-11-21,Nebraska,31,113029,1368,929,12,698840,6686,111661,2381,587179,4305
2020-11-21,Nevada,32,132610,2508,2017,30,919379,12985,131733,2019,787646,10966
2020-11-21,New Hampshire,33,17281,484,508,1,403129,881,17281,484,385848,397
2020-11-21,New Jersey,34,303851,4669,16746,34,5591493,50225,326190,5252,5265303,44973
2020-11-21,New Mexico,35,79440,2342,1352,25,1444121,10512,79440,2342,1364681,8170
2020-11-21,New York,36,595581,5976,33737,41,17799741,207907,590822,5972,17208919,201935
2020-11-21,North Carolina,37,333074,3053,5035,23,4878076,59047,332261,3415,4545815,55632
2020-11-21,North Dakota,38,71546,1524,840,16,336812,2408,72664,1572,264148,836
2020-11-21,Northern Mariana Islands,69,103,0,2,0,16570,0,103,0,16467,0
2020-11-21,Ohio,39,343286,7863,5984,29,5609595,65406,343286,7863,5266309,57543
2020-11-21,Oklahoma,40,170924,3663,1624,21,1960569,53383,170924,3663,1789645,49720
2020-11-21,Oregon,41,63668,1492,822,7,993753,8461,62175,1302,931578,7159
2020-11-21,Pennsylvania,42,307247,5874,9862,114,2971240,26584,302564,6778,2668676,19806
2020-11-21,Puerto Rico,72,80049,1099,1012,21,352406,1099,46434,1099,305972,0
2020-11-21,Rhode Island,44,48001,0,1294,0,505662,4730,49406,1405,456256,3325
2020-11-21,South Carolina,45,205018,1857,4274,43,2225252,32504,205018,1857,2020234,30647
2020-11-21,South Dakota,46,72214,1144,777,36,309170,2301,72214,1144,236956,1157
2020-11-21,Tennessee,47,329490,4208,4163,7,4269060,28512,335887,4355,3933173,24157
2020-11-21,Texas,48,1164314,10915,21004,132,10402711,123409,1183847,14922,9218864,108487
2020-11-21,Utah,49,173987,3343,789,13,1259782,12107,173979,3395,1085803,8712
2020-11-21,Vermont,50,3546,87,63,1,209730,3280,3639,88,206091,3192
2020-11-21,Virgin Islands,78,1491,9,23,0,27267,176,1491,9,25776,167
2020-11-21,Virginia,51,215679,2348,3938,26,3093060,36068,215679,2348,2877381,33720
2020-11-21,Washington,53,148691,1440,2738,0,2892499,22370,154148,3082,2738351,19288
2020-11-21,West Virginia,54,39598,1118,658,19,1013043,18671,39598,1118,973445,17553
2020-11-21,Wisconsin,55,372219,7029,3155,49,2446079,18698,372219,7029,2073860,11669
2020-11-21,Wyoming,56,27410,281,176,0,159198,281,27410,281,131788,0
2020-11-22,Alabama,01,232506,1798,3457,0,1563307,7508,232506,1798,1330801,5710
2020-11-22,Alaska,02,27629,550,97,2,926361,7616,26587,543,899774,7073
2020-11-22,Arizona,04,299698,2701,6464,5,2112974,20877,299665,4331,1813309,16546
2020-11-22,Arkansas,05,145173,1352,2357,20,1611627,14081,145173,1352,1466454,12729
2020-11-22,California,06,1118652,8808,18726,17,22237309,265477,1102033,14319,21135276,251158
2020-11-22,Colorado,08,199296,4076,2811,20,1620879,22185,198600,3921,1422279,18264
2020-11-22,Connecticut,09,101469,0,4828,0,2929060,0,101469,0,2827591,0
2020-11-22,Delaware,10,31808,487,748,2,400436,3493,31808,487,368628,3006
2020-11-22,District of Columbia,11,20151,190,670,0,630532,11748,20151,190,610381,11558
2020-11-22,Florida,12,938406,6587,17990,61,6898401,48227,924614,6374,5973787,41853
2020-11-22,Georgia,13,432954,2267,8955,15,4112780,26638,404411,1976,3708369,24662
2020-11-22,Guam,66,7518,97,107,3,79885,73,6549,73,73336,0
2020-11-22,Hawaii,15,17302,120,231,2,17483,122,17483,122,,0
2020-11-22,Idaho,16,91935,623,852,1,464547,3352,90834,1070,373713,2282
2020-11-22,Illinois,17,657402,9928,12064,97,9801419,92437,656298,10012,9145121,82425
2020-11-22,Indiana,18,298021,6183,5305,59,2072690,19547,295357,6174,1777333,13373
2020-11-22,Iowa,19,211664,2461,2202,11,1033800,6727,187505,2537,846295,4190
2020-11-22,Kansas,20,137530,235,1410,-1,763893,0,134533,0,629360,0
2020-11-22,Kentucky,21,161222,2187,1887,1,2437028,2192,158100,2192,2278928,0
2020-11-22,Louisiana,22,220192,3483,6260,27,3251946,42569,220192,3483,3031754,39086
2020-11-22,Maine,23,10359,236,176,2,795792,236,10359,236,785433,0
2020-11-22,Maryland,24,182482,2357,4434,19,2225389,19100,182139,2168,2043250,16932
2020-11-22,Massachusetts,25,206850,2695,10512,24,3207055,25884,206850,2695,3000205,23189
2020-11-22,Michigan,26,328833,655,8874,0,6164253,0,329021,0,5835232,0
2020-11-22,Minnesota,27,270213,7205,3297,40,2318754,36396,270157,7205,2048597,29191
2020-11-22,Mississippi,28,143180,779,3676,19,1050171,779,143180,779,906991,0
2020-11-22,Missouri,29,283756,3769,3688,4,1739720,12503,271527,4215,1468193,8288
2020-11-22,Montana,30,55680,1138,607,3,613009,4507,55680,1138,557329,3369
2020-11-22,Nebraska,31,114061,1032,933,4,703689,4849,113029,1368,590660,3481
2020-11-22,Nevada,32,134761,2151,2022,5,925814,6435,133888,2155,791926,4280
2020-11-22,New Hampshire,33,17598,317,512,4,407025,3896,17598,317,389427,3579
2020-11-22,New Jersey,34,307819,3968,16761,15,5645773,54280,330631,4441,5315142,49839
2020-11-22,New Mexico,35,81896,2456,1385,33,1454997,10876,81896,2456,1373101,8420
2020-11-22,New York,36,600967,5386,33767,30,17996351,196610,596214,5392,17400137,191218
2020-11-22,North Carolina,37,336983,3909,5062,27,4947614,69538,336775,4514,4610839,65024
2020-11-22,North Dakota,38,72689,1143,846,6,339048,2236,73844,1180,265204,1056
2020-11-22,Northern Mariana Islands,69,104,1,2,0,16571,1,104,1,16467,0
2020-11-22,Ohio,39,351419,8133,5996,12,5672104,62509,351419,8133,5320685,54376
2020-11-22,Oklahoma,40,174330,3406,1634,10,1963975,3406,174330,3406,1789645,0
2020-11-22,Oregon,41,65170,1502,822,0,1001247,7494,63668,1493,937579,6001
2020-11-22,Pennsylvania,42,313788,6541,9901,39,3000624,29384,309639,7075,2690985,22309
2020-11-22,Puerto Rico,72,81074,1025,1017,5,353431,1025,47459,1025,305972,0
2020-11-22,Rhode Island,44,48001,0,1294,0,509556,3894,50144,738,459412,3156
2020-11-22,South Carolina,45,206295,1277,4283,9,2246568,21316,206295,1277,2040273,20039
2020-11-22,South Dakota,46,73065,851,819,42,311218,2048,73065,851,238153,1197
2020-11-22,Tennessee,47,333853,4363,4218,55,4305687,36627,340476,4589,3965211,32038
2020-11-22,Texas,48,1172848,8534,21083,79,10479272,76561,1193616,9769,9285656,66792
2020-11-22,Utah,49,177176,3189,793,4,1272248,12466,177176,3197,1095072,9269
2020-11-22,Vermont,50,3629,83,63,0,213237,3507,3727,88,209510,3419
2020-11-22,Virgin Islands,78,1504,13,23,0,27479,212,1504,13,25975,199
2020-11-22,Virginia,51,217796,2117,3938,0,3141191,48131,217796,2117,2923395,46014
2020-11-22,Washington,53,149703,1012,2738,0,2910448,17949,157341,3193,2753107,14756
2020-11-22,West Virginia,54,40478,880,662,4,1026969,13926,40478,880,986491,13046
2020-11-22,Wisconsin,55,376238,4019,3162,7,2461490,15411,376238,4019,2085252,11392
2020-11-22,Wyoming,56,28169,759,176,0,159957,759,28169,759,131788,0
2020-11-23,Alabama,01,234080,1574,3459,2,1571821,8514,234080,1574,1337741,6940
2020-11-23,Alaska,02,28128,499,97,0,933016,6655,27085,498,905931,6157
2020-11-23,Arizona,04,303188,3490,6465,1,2133623,20649,302324,2659,1831299,17990
2020-11-23,Arkansas,05,146190,1017,2387,30,1621958,10331,146190,1017,1475768,9314
2020-11-23,California,06,1136346,17694,18768,42,22457544,220235,1110370,8337,21347174,211898
2020-11-23,Colorado,08,203578,4282,2821,10,1640217,19338,202289,3689,1437928,15649
2020-11-23,Connecticut,09,106740,5271,4871,43,3038489,109429,106740,5271,2931749,104158
2020-11-23,Delaware,10,32211,403,752,4,402841,2405,32211,403,370630,2002
2020-11-23,District of Columbia,11,20290,139,672,2,639461,8929,20290,139,619171,8790
2020-11-23,Florida,12,944737,6331,18084,94,6928502,30101,930728,6114,5997774,23987
2020-11-23,Georgia,13,434916,1962,8972,17,4139509,26729,406220,1809,3733289,24920
2020-11-23,Guam,66,7571,53,107,0,80999,1114,6602,53,74397,1061
2020-11-23,Hawaii,15,17405,103,231,0,17596,113,17596,113,,0
2020-11-23,Idaho,16,93602,1667,869,17,467362,2815,91653,819,375709,1996
2020-11-23,Illinois,17,665865,8463,12141,77,9892981,91562,664620,8322,9228361,83240
2020-11-23,Indiana,18,303575,5554,5332,27,2090728,18038,300913,5556,1789815,12482
2020-11-23,Iowa,19,214792,3128,2222,20,1040373,6573,189856,2351,850517,4222
2020-11-23,Kansas,20,144831,7301,1462,52,784288,20395,142059,7526,642229,12869
2020-11-23,Kentucky,21,163767,2545,1906,19,2469063,32035,160232,2132,2308831,29903
2020-11-23,Louisiana,22,221160,968,6284,24,3262192,10246,221160,968,3041032,9278
2020-11-23,Maine,23,10544,185,177,1,825349,29557,10544,185,814805,29372
2020-11-23,Maryland,24,184140,1658,4448,14,2238492,13103,183797,1658,2054695,11445
2020-11-23,Massachusetts,25,208623,1773,10531,19,3222588,15533,208623,1773,3013965,13760
2020-11-23,Michigan,26,340223,11390,8937,63,6263536,99283,340964,11943,5922572,87340
2020-11-23,Minnesota,27,276556,6343,3321,24,2345719,26965,276500,6343,2069219,20622
2020-11-23,Mississippi,28,143879,699,3676,0,1091151,40980,143879,699,947272,40281
2020-11-23,Missouri,29,288308,4552,3697,9,1750096,10376,274897,3370,1475199,7006
2020-11-23,Montana,30,56428,748,615,8,617974,4965,56381,701,561593,4264
2020-11-23,Nebraska,31,115921,1860,958,25,706758,3069,114061,1032,592697,2037
2020-11-23,Nevada,32,136672,1911,2030,8,933588,7774,136227,2339,797361,5435
2020-11-23,New Hampshire,33,18042,444,512,0,409057,2032,18042,444,391015,1588
2020-11-23,New Jersey,34,311400,3581,16772,11,5700349,54576,334671,4040,5365678,50536
2020-11-23,New Mexico,35,84148,2252,1402,17,1464452,9455,84148,2252,1380304,7203
2020-11-23,New York,36,606878,5911,33804,37,18187840,191489,602120,5906,17585720,185583
2020-11-23,North Carolina,37,339672,2689,5076,14,4983768,36154,339194,2419,4644574,33735
2020-11-23,North Dakota,38,73403,714,852,6,340642,1594,74556,712,266086,882
2020-11-23,Northern Mariana Islands,69,104,0,2,0,16851,280,104,0,16747,280
2020-11-23,Ohio,39,363304,11885,6020,24,5683989,11885,363304,11885,5320685,0
2020-11-23,Oklahoma,40,177874,3544,1649,15,1967519,3544,177874,3544,1789645,0
2020-11-23,Oregon,41,66334,1164,830,8,1009614,8367,65170,1502,944444,6865
2020-11-23,Pennsylvania,42,320250,6462,9932,31,3019571,18947,314401,4762,2705170,14185
2020-11-23,Puerto Rico,72,81815,741,1032,15,354172,741,48200,741,305972,0
2020-11-23,Rhode Island,44,50573,2572,1309,15,511665,2109,50573,429,461092,1680
2020-11-23,South Carolina,45,207552,1257,4288,5,2267605,21037,207552,1257,2060053,19780
2020-11-23,South Dakota,46,73848,783,819,0,313297,2079,73848,783,239449,1296
2020-11-23,Tennessee,47,337637,3784,4254,36,4334644,28957,344550,4074,3990094,24883
2020-11-23,Texas,48,1184041,11193,21144,61,10535383,56111,1201257,7641,9334126,48470
2020-11-23,Utah,49,179420,2244,799,6,1279344,7096,179420,2244,1099924,4852
2020-11-23,Vermont,50,3714,85,63,0,214996,1759,3795,68,211201,1691
2020-11-23,Virgin Islands,78,1507,3,23,0,27479,0,1504,0,25975,0
2020-11-23,Virginia,51,221038,3242,3942,4,3183955,42764,221038,3242,2962917,39522
2020-11-23,Washington,53,155336,5633,2775,37,2912338,1890,159231,1890,2753107,0
2020-11-23,West Virginia,54,41114,636,667,5,1038846,11877,41114,636,997732,11241
2020-11-23,Wisconsin,55,379693,3455,3175,13,2474141,12651,379693,3455,2094448,9196
2020-11-23,Wyoming,56,29431,1262,202,26,161219,1262,29431,1262,131788,0
2020-11-24,Alabama,01,236865,2785,3472,13,1583882,12061,236865,2785,1347017,9276
2020-11-24,Alaska,02,28708,580,110,13,943401,10385,27669,584,915732,9801
2020-11-24,Arizona,04,307943,4755,6515,50,2148901,15278,306868,4544,1842033,10734
2020-11-24,Arkansas,05,148312,2122,2405,18,1635389,13431,148312,2122,1487077,11309
2020-11-24,California,06,1153005,16659,18875,107,22741363,283819,1125699,15329,21615664,268490
2020-11-24,Colorado,08,207882,4304,2868,47,1654599,14382,206439,4150,1448160,10232
2020-11-24,Connecticut,09,107280,540,4881,10,3051730,13241,107280,540,2944450,12701
2020-11-24,Delaware,10,32664,453,757,5,406207,3366,32664,453,373543,2913
2020-11-24,District of Columbia,11,20409,119,673,1,648922,9461,20409,119,628513,9342
2020-11-24,Florida,12,953292,8555,18156,72,6982425,53923,938830,8102,6043595,45821
2020-11-24,Georgia,13,438441,3525,8979,7,4173943,34434,408644,2424,3765299,32010
2020-11-24,Guam,66,7624,53,108,1,81600,601,6655,53,74945,548
2020-11-24,Hawaii,15,17461,56,231,0,17656,60,17656,60,,0
2020-11-24,Idaho,16,95588,1986,881,12,470788,3426,93090,1437,377698,1989
2020-11-24,Illinois,17,675543,9678,12294,153,9990304,97323,674089,9469,9316215,87854
2020-11-24,Indiana,18,309218,5643,5435,103,2107744,17016,306538,5625,1801206,11391
2020-11-24,Iowa,19,217786,2994,2271,49,1044789,4416,191152,1296,853637,3120
2020-11-24,Kansas,20,145272,441,1456,-6,784288,0,142059,0,642229,0
2020-11-24,Kentucky,21,166478,2711,1938,32,2498456,29393,162838,2606,2335618,26787
2020-11-24,Louisiana,22,224403,3243,6323,39,3296384,34192,224403,3243,3071981,30949
2020-11-24,Maine,23,10799,255,189,12,833554,8205,10799,255,822755,7950
2020-11-24,Maryland,24,185812,1672,4481,33,2252024,13532,185464,1667,2066560,11865
2020-11-24,Massachusetts,25,211199,2576,10551,20,3245573,22985,211199,2576,3034374,20409
2020-11-24,Michigan,26,347076,6853,9094,157,6334377,70841,347746,6782,5986631,64059
2020-11-24,Minnesota,27,282972,6416,3359,38,2370205,24486,282916,6416,2087289,18070
2020-11-24,Mississippi,28,144544,665,3729,53,1091816,665,144544,665,947272,0
2020-11-24,Missouri,29,292786,4478,3869,172,1759203,9107,278661,3764,1480542,5343
2020-11-24,Montana,30,57559,1131,630,15,622796,4822,57504,1123,565292,3699
2020-11-24,Nebraska,31,117682,1761,981,23,711971,5213,115921,1860,596050,3353
2020-11-24,Nevada,32,140572,3900,2053,23,943726,10138,139080,2853,804646,7285
2020-11-24,New Hampshire,33,18382,340,513,1,410630,1573,18382,340,392248,1233
2020-11-24,New Jersey,34,315675,4275,16819,47,5751358,51009,339642,4971,5411716,46038
2020-11-24,New Mexico,35,86247,2099,1430,28,1477284,12832,86247,2099,1391037,10733
2020-11-24,New York,36,611756,4878,33847,43,18352601,164761,607001,4881,17745600,159880
2020-11-24,North Carolina,37,343566,3894,5114,38,5028737,44969,342294,3100,4686443,41869
2020-11-24,North Dakota,38,74407,1004,889,37,342254,1612,75622,1066,266632,546
2020-11-24,Northern Mariana Islands,69,104,0,2,0,16851,0,104,0,16747,0
2020-11-24,Ohio,39,371908,8604,6118,98,5804292,120303,371908,8604,5432384,111699
2020-11-24,Oklahoma,40,180610,2736,1664,15,2011009,43490,180610,2736,1830399,40754
2020-11-24,Oregon,41,67337,1003,848,18,1016282,6668,66333,1163,949949,5505
2020-11-24,Pennsylvania,42,326615,6365,10014,82,3044438,24867,321070,6669,2723368,18198
2020-11-24,Puerto Rico,72,82163,348,1038,6,354520,348,48548,348,305972,0
2020-11-24,Rhode Island,44,51424,851,1325,16,515643,3978,51424,851,464219,3127
2020-11-24,South Carolina,45,209230,1678,4313,25,2287492,19887,209230,1678,2078262,18209
2020-11-24,South Dakota,46,74859,1011,821,2,315794,2497,74859,1011,240935,1486
2020-11-24,Tennessee,47,339059,1422,4325,71,4340462,5818,345854,1304,3994608,4514
2020-11-24,Texas,48,1204464,20423,21338,194,10685278,149895,1217837,16580,9467441,133315
2020-11-24,Utah,49,182121,2701,810,11,1291122,11778,182121,2701,1109001,9077
2020-11-24,Vermont,50,3762,48,64,1,216292,1296,3845,50,212447,1246
2020-11-24,Virgin Islands,78,1521,14,23,0,27734,255,1507,3,26227,252
2020-11-24,Virginia,51,223582,2544,3979,37,3210565,26610,223582,2544,2986983,24066
2020-11-24,Washington,53,158234,2898,2807,32,2913743,1405,160636,1405,2753107,0
2020-11-24,West Virginia,54,42083,969,682,15,1053635,14789,42083,969,1011552,13820
2020-11-24,Wisconsin,55,386441,6748,3295,120,2491197,17056,386441,6748,2104756,10308
2020-11-24,Wyoming,56,29959,528,202,0,161747,528,29959,528,131788,0
2020-11-25,Alabama,01,239318,2453,3532,60,1593279,9397,239318,2453,1353961,6944
2020-11-25,Alaska,02,29386,678,110,0,954276,10875,28339,670,925937,10205
2020-11-25,Arizona,04,311727,3784,6529,14,2166252,17351,310850,3982,1855402,13369
2020-11-25,Arkansas,05,150277,1965,2425,20,1650534,15145,150277,1965,1500257,13180
2020-11-25,California,06,1167149,14144,18982,107,22910351,168988,1144049,18350,21766302,150638
2020-11-25,Colorado,08,212416,4534,2930,62,1671722,17123,210630,4191,1461092,12932
2020-11-25,Connecticut,09,109152,1872,4926,45,3083113,31383,109152,1872,2973961,29511
2020-11-25,Delaware,10,32995,331,760,3,408654,2447,32995,331,375659,2116
2020-11-25,District of Columbia,11,20516,107,677,4,650235,1313,20516,107,629719,1206
2020-11-25,Florida,12,961668,8376,18253,97,7028635,46210,946956,8126,6081679,38084
2020-11-25,Georgia,13,441737,3296,9054,75,4195929,21986,411002,2358,3784927,19628
2020-11-25,Guam,66,7674,50,110,2,82709,1109,6705,50,76004,1059
2020-11-25,Hawaii,15,17561,100,233,2,17764,108,17764,108,,0
2020-11-25,Idaho,16,97007,1419,901,20,474042,3254,94730,1640,379312,1614
2020-11-25,Illinois,17,686855,11312,12465,171,10104537,114233,685467,11378,9419070,102855
2020-11-25,Indiana,18,315212,5994,5498,63,2126395,18651,312521,5983,1813874,12668
2020-11-25,Iowa,19,221288,3502,2312,41,1050640,5851,194395,3243,856245,2608
2020-11-25,Kansas,20,150515,5243,1503,47,799185,14897,147797,5738,651388,9159
2020-11-25,Kentucky,21,169822,3344,1975,37,2508849,10393,166139,3301,2342710,7092
2020-11-25,Louisiana,22,225638,1235,6350,27,3310705,14321,225638,1235,3085067,13086
2020-11-25,Maine,23,11027,228,190,1,841090,7536,11027,228,830063,7308
2020-11-25,Maryland,24,188509,2697,4518,37,2270660,18636,188161,2697,2082499,15939
2020-11-25,Massachusetts,25,214594,3395,10604,53,3275409,29836,214594,3395,3060815,26441
2020-11-25,Michigan,26,352052,4976,9168,74,6392563,58186,352433,4687,6040130,53499
2020-11-25,Minnesota,27,289362,6390,3434,75,2403190,32985,289303,6387,2113887,26598
2020-11-25,Mississippi,28,145636,1092,3745,16,1092908,1092,145636,1092,947272,0
2020-11-25,Missouri,29,297374,4588,3908,39,1770305,11102,282792,4131,1487513,6971
2020-11-25,Montana,30,58620,1061,653,23,627851,5055,58565,1061,569286,3994
2020-11-25,Nebraska,31,120076,2394,1004,23,716768,4797,117682,1761,599086,3036
2020-11-25,Nevada,32,142951,2379,2077,24,950716,6990,142239,3159,808477,3831
2020-11-25,New Hampshire,33,18776,394,514,1,414088,3458,18776,394,395312,3064
2020-11-25,New Jersey,34,319734,4059,16886,67,5853831,102473,344397,4755,5509434,97718
2020-11-25,New Mexico,35,88102,1855,1451,21,1487840,10556,88102,1855,1399738,8701
2020-11-25,New York,36,618023,6267,33890,43,18525686,173085,613266,6265,17912420,166820
2020-11-25,North Carolina,37,348102,4536,5177,63,5084569,55832,346506,4212,4738063,51620
2020-11-25,North Dakota,38,75484,1077,893,4,344165,1911,76806,1184,267359,727
2020-11-25,Northern Mariana Islands,69,104,0,2,0,16851,0,104,0,16747,0
2020-11-25,Ohio,39,382743,10835,6274,156,5856888,52596,382743,10835,5474145,41761
2020-11-25,Oklahoma,40,184342,3732,1680,16,2032905,21896,184342,3732,1848563,18164
2020-11-25,Oregon,41,68504,1167,871,23,1024582,8300,67333,1000,957249,7300
2020-11-25,Pennsylvania,42,333571,6956,10162,148,3071050,26612,327829,6759,2743221,19853
2020-11-25,Puerto Rico,72,82340,177,1052,14,354697,177,48725,177,305972,0
2020-11-25,Rhode Island,44,52317,893,1335,10,515106,-537,52317,893,462789,-1430
2020-11-25,South Carolina,45,210905,1675,4317,4,2308163,20671,210905,1675,2097258,18996
2020-11-25,South Dakota,46,76142,1283,849,28,318354,2560,76142,1283,242212,1277
2020-11-25,Tennessee,47,341456,2397,4415,90,4354895,14433,347972,2118,4006923,12315
2020-11-25,Texas,48,1219392,14928,21536,198,10819214,133936,1236648,18811,9582566,115125
2020-11-25,Utah,49,183960,1839,834,24,1297873,6751,183902,1781,1113971,4970
2020-11-25,Vermont,50,3827,65,64,0,218195,1903,3938,93,214257,1810
2020-11-25,Virgin Islands,78,1521,0,23,0,28036,302,1521,14,26515,288
2020-11-25,Virginia,51,226300,2718,4008,29,3237740,27175,226300,2718,3011440,24457
2020-11-25,Washington,53,161207,2973,2825,18,2917421,3678,164314,3678,2753107,0
2020-11-25,West Virginia,54,43050,967,695,13,1069343,15708,43050,967,1026293,14741
2020-11-25,Wisconsin,55,392443,6002,3363,68,2508987,17790,392438,5997,2116549,11793
2020-11-25,Wyoming,56,30761,802,215,13,162549,802,30761,802,131788,0
2020-11-26,Alabama,01,241957,2639,3572,40,1603144,9865,241957,2639,1361187,7226
2020-11-26,Alaska,02,29940,554,113,3,969573,15297,28892,553,940681,14744
2020-11-26,Arizona,04,314326,2599,6568,39,2188188,21936,314326,3476,1873862,18460
2020-11-26,Arkansas,05,152625,2348,2436,11,1665827,15293,152625,2348,1513202,12945
2020-11-26,California,06,1176137,8988,19025,43,23096745,186394,1158689,14640,21938056,171754
2020-11-26,Colorado,08,217655,5239,2977,47,1699645,27923,216683,6053,1482962,21870
2020-11-26,Connecticut,09,109152,0,4926,0,3083113,0,109152,0,2973961,0
2020-11-26,Delaware,10,33579,584,761,1,412412,3758,33579,584,378833,3174
2020-11-26,District of Columbia,11,20736,220,677,0,663201,12966,20736,220,642465,12746
2020-11-26,Florida,12,961668,0,18253,0,7028635,0,946956,0,6081679,0
2020-11-26,Georgia,13,445204,3467,9089,35,4226691,30762,413909,2907,3812782,27855
2020-11-26,Guam,66,7717,43,112,2,82752,43,6748,43,76004,0
2020-11-26,Hawaii,15,17678,117,235,2,17881,117,17881,117,,0
2020-11-26,Idaho,16,97007,0,901,0,478886,4844,96503,1773,382383,3071
2020-11-26,Illinois,17,698364,11509,12609,144,10212093,107556,697489,12022,9514604,95534
2020-11-26,Indiana,18,321595,6383,5561,63,2145727,19332,318894,6373,1826833,12959
2020-11-26,Iowa,19,223323,2035,2349,37,1057718,7078,197086,2691,860632,4387
2020-11-26,Kansas,20,150522,7,1503,0,799185,0,147797,0,651388,0
2020-11-26,Kentucky,21,170081,259,1983,8,2508849,0,166139,0,2342710,0
2020-11-26,Louisiana,22,225638,0,6350,0,3310705,0,225638,0,3085067,0
2020-11-26,Maine,23,11265,238,190,0,841328,238,11265,238,830063,0
2020-11-26,Maryland,24,190635,2126,4547,29,2287167,16507,190480,2319,2096687,14188
2020-11-26,Massachusetts,25,214594,0,10604,0,3275409,0,214594,0,3060815,0
2020-11-26,Michigan,26,352342,290,9169,1,6392563,0,352433,0,6040130,0
2020-11-26,Minnesota,27,289362,0,3434,0,2403190,0,289303,0,2113887,0
2020-11-26,Mississippi,28,147382,1746,3763,18,1094654,1746,147382,1746,947272,0
2020-11-26,Missouri,29,300825,3451,3932,24,1782717,12412,287263,4471,1495454,7941
2020-11-26,Montana,30,59682,1062,658,5,631927,4076,59682,1117,572245,2959
2020-11-26,Nebraska,31,122952,2876,1008,4,723010,6242,120076,2394,602934,3848
2020-11-26,Nevada,32,144794,1843,2093,16,959193,8477,144781,2542,814412,5935
2020-11-26,New Hampshire,33,18776,0,514,0,414088,0,18776,0,395312,0
2020-11-26,New Jersey,34,324207,4473,16925,39,5858991,5160,349557,5160,5509434,0
2020-11-26,New Mexico,35,89796,1694,1469,18,1504856,17016,89796,1694,1415060,15322
2020-11-26,New York,36,624961,6938,33959,69,18743407,217721,620199,6933,18123208,210788
2020-11-26,North Carolina,37,348148,46,5177,0,5084569,0,346506,0,4738063,0
2020-11-26,North Dakota,38,76448,964,903,10,346125,1960,77813,1007,268312,953
2020-11-26,Northern Mariana Islands,69,104,0,2,0,16851,0,104,0,16747,0
2020-11-26,Ohio,39,382743,0,6274,0,5856888,0,382743,0,5474145,0
2020-11-26,Oklahoma,40,184342,0,1680,0,2057810,24905,184342,0,1873468,24905
2020-11-26,Oregon,41,70006,1502,884,13,1028972,4390,68503,1170,960469,3220
2020-11-26,Pennsylvania,42,340998,7427,10271,109,3101483,30433,336254,8425,2765229,22008
2020-11-26,Puerto Rico,72,82841,501,1069,17,355198,501,49226,501,305972,0
2020-11-26,Rhode Island,44,52317,0,1335,0,518855,3749,53491,1174,465364,2575
2020-11-26,South Carolina,45,210905,0,4317,0,2308163,0,210905,0,2097258,0
2020-11-26,South Dakota,46,76142,0,849,0,318354,0,76142,0,242212,0
2020-11-26,Tennessee,47,345371,3915,4468,53,4391717,36822,352376,4404,4039341,32418
2020-11-26,Texas,48,1223896,4504,21709,173,10935976,116762,1251345,14697,9684631,102065
2020-11-26,Utah,49,184382,422,834,0,1297873,0,183902,0,1113971,0
2020-11-26,Vermont,50,3827,0,64,0,219897,1702,4017,79,215880,1623
2020-11-26,Virgin Islands,78,1521,0,23,0,28036,0,1521,0,26515,0
2020-11-26,Virginia,51,228900,2600,4029,21,3261387,23647,228900,2600,3032487,21047
2020-11-26,Washington,53,161911,704,2825,0,2920578,3157,167471,3157,2753107,0
2020-11-26,West Virginia,54,44180,1130,712,17,1085099,15756,44180,1130,1040919,14626
2020-11-26,Wisconsin,55,398104,5661,3431,68,2523306,14319,398104,5666,2125202,8653
2020-11-26,Wyoming,56,30761,0,215,0,162549,0,30761,0,131788,0
2020-11-27,Alabama,01,242874,917,3572,0,1608114,4970,242874,917,1365240,4053
2020-11-27,Alaska,02,30612,672,113,0,990773,21200,29554,662,961219,20538
2020-11-27,Arizona,04,318695,4369,6588,20,2213289,25101,318638,4312,1894651,20789
2020-11-27,Arkansas,05,153677,1052,2436,0,1674767,8940,153677,1052,1521090,7888
2020-11-27,California,06,1193071,16934,19100,75,23315918,219173,1171324,12635,22144594,206538
2020-11-27,Colorado,08,222544,4889,2998,21,1717407,17762,220953,4270,1496454,13492
2020-11-27,Connecticut,09,112581,3429,4961,35,3154617,71504,112581,3429,3042036,68075
2020-11-27,Delaware,10,34170,591,763,2,416059,3647,34170,591,381889,3056
2020-11-27,District of Columbia,11,20937,201,677,0,672439,9238,20937,201,651502,9037
2020-11-27,Florida,12,979012,17344,18362,109,7130836,102201,963751,16795,6167085,85406
2020-11-27,Georgia,13,447942,2738,9130,41,4258413,31722,416303,2394,3842110,29328
2020-11-27,Guam,66,7737,20,113,1,83201,449,6768,20,76433,429
2020-11-27,Hawaii,15,17796,118,238,3,18006,125,18006,125,,0
2020-11-27,Idaho,16,99148,2141,914,13,478886,0,96503,0,382383,0
2020-11-27,Illinois,17,706123,7759,12705,96,10289223,77130,705063,7574,9584160,69556
2020-11-27,Indiana,18,327234,5639,5594,33,2162110,16383,324537,5643,1837573,10740
2020-11-27,Iowa,19,225065,1742,2360,11,1060478,2760,198222,1136,862256,1624
2020-11-27,Kansas,20,155245,4723,1529,26,812424,13239,153021,5224,659403,8015
2020-11-27,Kentucky,21,174684,4603,2009,26,2558059,49210,171755,5616,2386304,43594
2020-11-27,Louisiana,22,230602,4964,6391,41,3378743,68038,230602,4964,3148141,63074
2020-11-27,Maine,23,11265,0,190,0,841328,0,11265,0,830063,0
2020-11-27,Maryland,24,193205,2570,4569,22,2305545,18378,192858,2378,2112687,16000
2020-11-27,Massachusetts,25,219252,4658,10635,31,3309180,33771,219252,4658,3089928,29113
2020-11-27,Michigan,26,369022,16680,9352,183,6513757,121194,369801,17368,6143956,103826
2020-11-27,Minnesota,27,295060,5698,3535,101,2426221,23031,295001,5698,2131220,17333
2020-11-27,Mississippi,28,148387,1005,3769,6,1095659,1005,148387,1005,947272,0
2020-11-27,Missouri,29,304234,3409,3943,11,1791413,8696,290536,3273,1500877,5423
2020-11-27,Montana,30,59796,114,658,0,642514,10587,59796,114,582718,10473
2020-11-27,Nebraska,31,124068,1116,1014,6,731641,8631,122952,2876,608689,5755
2020-11-27,Nevada,32,147145,2351,2103,10,965745,6552,146317,1536,819428,5016
2020-11-27,New Hampshire,33,19313,537,517,3,416331,2243,19313,537,397018,1706
2020-11-27,New Jersey,34,328302,4095,16942,17,5863488,4497,354054,4497,5509434,0
2020-11-27,New Mexico,35,91852,2056,1504,35,1521747,16891,91852,2056,1429895,14835
2020-11-27,New York,36,633140,8179,34004,45,18962849,219442,628375,8176,18334474,211266
2020-11-27,North Carolina,37,355664,7516,5240,63,5192822,108253,354514,8008,4838308,100245
2020-11-27,North Dakota,38,77238,790,908,5,347403,1278,78564,751,268839,527
2020-11-27,Northern Mariana Islands,69,104,0,2,0,16851,0,104,0,16747,0
2020-11-27,Ohio,39,399808,17065,6346,72,5919541,62653,399808,17065,5519733,45588
2020-11-27,Oklahoma,40,187567,3225,1704,24,2061035,3225,187567,3225,1873468,0
2020-11-27,Oregon,41,70833,827,890,6,1030663,1691,70006,1503,960657,188
2020-11-27,Pennsylvania,42,349360,8362,10295,24,3129689,28206,343614,7360,2786075,20846
2020-11-27,Puerto Rico,72,84293,1452,1076,7,356650,1452,50678,1452,305972,0
2020-11-27,Rhode Island,44,53954,1637,1346,11,520851,1996,53954,463,466897,1533
2020-11-27,South Carolina,45,213120,2215,4346,29,2339037,30874,213120,2215,2125917,28659
2020-11-27,South Dakota,46,78280,2138,888,39,323484,5130,78280,2138,245204,2992
2020-11-27,Tennessee,47,349506,4135,4475,7,4426634,34917,356716,4340,4069918,30577
2020-11-27,Texas,48,1228649,4753,21762,53,10949176,13200,1255332,3987,9693844,9213
2020-11-27,Utah,49,190044,5662,849,15,1318355,20482,190044,6142,1128311,14340
2020-11-27,Vermont,50,4005,178,67,3,220964,1067,4115,98,216849,969
2020-11-27,Virgin Islands,78,1521,0,23,0,28036,0,1521,0,26515,0
2020-11-27,Virginia,51,230444,1544,4044,15,3294522,33135,230444,1544,3064078,31591
2020-11-27,Washington,53,165230,3319,2828,3,2923514,2936,170407,2936,2753107,0
2020-11-27,West Virginia,54,45046,866,712,0,1102054,16955,45046,866,1057008,16089
2020-11-27,Wisconsin,55,399557,1453,3444,13,2533226,9920,399526,1422,2133700,8498
2020-11-27,Wyoming,56,31773,1012,215,0,170677,8128,31773,1012,138904,7116
2020-11-28,Alabama,01,244993,2119,3572,0,1614785,6671,244993,2119,1369792,4552
2020-11-28,Alaska,02,31279,667,115,2,999054,8281,30204,650,968850,7631
2020-11-28,Arizona,04,322774,4079,6624,36,2227793,14504,322774,4136,1905019,10368
2020-11-28,Arkansas,05,155026,1349,2449,13,1684540,9773,155026,1349,1529514,8424
2020-11-28,California,06,1206278,13207,19132,32,23573182,257264,1183320,11996,22389862,245268
2020-11-28,Colorado,08,226567,4023,3012,14,1735542,18135,225283,4330,1510259,13805
2020-11-28,Connecticut,09,112581,0,4961,0,3154617,0,112581,0,3042036,0
2020-11-28,Delaware,10,34670,500,763,0,419244,3185,34670,500,384574,2685
2020-11-28,District of Columbia,11,21308,371,678,1,685338,12899,21308,371,664030,12528
2020-11-28,Florida,12,985289,6277,18441,79,7167102,36266,969813,6062,6197289,30204
2020-11-28,Georgia,13,450627,2685,9173,43,4289024,30611,418936,2633,3870088,27978
2020-11-28,Guam,66,7751,14,113,0,83215,14,6782,14,76433,0
2020-11-28,Hawaii,15,17871,75,238,0,18082,76,18082,76,,0
2020-11-28,Idaho,16,99984,836,919,5,483659,4773,98500,1997,385159,2776
2020-11-28,Illinois,17,714070,7947,12852,147,10368278,79055,712936,7873,9655342,71182
2020-11-28,Indiana,18,331725,4491,5663,69,2174751,12641,329008,4471,1845743,8170
2020-11-28,Iowa,19,227181,2116,2375,15,1063681,3203,199683,1461,863998,1742
2020-11-28,Kansas,20,155265,20,1529,0,812424,0,153021,0,659403,0
2020-11-28,Kentucky,21,177453,2769,2028,19,2578361,20302,174182,2427,2404179,17875
2020-11-28,Louisiana,22,230602,0,6391,0,3378743,0,230602,0,3148141,0
2020-11-28,Maine,23,11288,23,191,1,841351,23,11288,23,830063,0
2020-11-28,Maryland,24,194603,1398,4602,33,2317570,12025,194448,1590,2123122,10435
2020-11-28,Massachusetts,25,222469,3217,10676,41,3327434,18254,222469,3217,3104965,15037
2020-11-28,Michigan,26,377279,8257,9461,109,6574441,60684,378152,8351,6196289,52333
2020-11-28,Minnesota,27,304082,9022,3580,45,2474553,48332,304023,9022,2170530,39310
2020-11-28,Mississippi,28,149940,1553,3779,10,1097212,1553,149940,1553,947272,0
2020-11-28,Missouri,29,306526,2292,3950,7,1797533,6120,292740,2204,1504793,3916
2020-11-28,Montana,30,60845,1049,670,12,645393,2879,60845,1049,584548,1830
2020-11-28,Nebraska,31,125323,1255,1018,4,734480,2839,124066,1114,610414,1725
2020-11-28,Nevada,32,149613,2468,2123,20,973116,7371,149229,2912,823887,4459
2020-11-28,New Hampshire,33,20002,689,523,6,419199,2868,20002,689,399197,2179
2020-11-28,New Jersey,34,332104,3802,16965,23,5971893,108405,358584,4530,5613309,103875
2020-11-28,New Mexico,35,93982,2130,1527,23,1536202,14455,93982,2130,1442220,12325
2020-11-28,New York,36,639200,6060,34049,45,19115204,152355,634438,6063,18480766,146292
2020-11-28,North Carolina,37,358654,2990,5249,9,5244854,52032,357958,3444,4886896,48588
2020-11-28,North Dakota,38,77941,703,921,13,348805,1402,79359,795,269446,607
2020-11-28,Northern Mariana Islands,69,104,0,2,0,16851,0,104,0,16747,0
2020-11-28,Ohio,39,406703,6895,6378,32,6028709,109168,406703,6895,5622006,102273
2020-11-28,Oklahoma,40,193824,6257,1717,13,2067292,6257,193824,6257,1873468,0
2020-11-28,Oregon,41,72506,1673,899,9,1031436,773,70832,826,960604,-53
2020-11-28,Pennsylvania,42,356243,6883,10337,42,3156131,26442,351667,8053,2804464,18389
2020-11-28,Puerto Rico,72,85196,903,1083,7,357553,903,51581,903,305972,0
2020-11-28,Rhode Island,44,53954,0,1346,0,523428,2577,55017,1063,468411,1514
2020-11-28,South Carolina,45,214911,1791,4346,0,2370233,31196,214911,1791,2155322,29405
2020-11-28,South Dakota,46,79099,819,942,54,325376,1892,79099,819,246277,1073
2020-11-28,Tennessee,47,355885,6379,4489,14,4470321,43687,363466,6750,4106855,36937
2020-11-28,Texas,48,1234675,6026,21847,85,11021226,72050,1259657,4325,9761569,67725
2020-11-28,Utah,49,192087,2043,863,14,1325093,6738,192087,2043,1133006,4695
2020-11-28,Vermont,50,4033,28,67,0,221496,532,4155,40,217341,492
2020-11-28,Virgin Islands,78,1540,19,23,0,28272,236,1538,17,26734,219
2020-11-28,Virginia,51,233617,3173,4054,10,3320656,26134,233617,3173,3087039,22961
2020-11-28,Washington,53,166736,1506,2828,0,2924044,530,170937,530,2753107,0
2020-11-28,West Virginia,54,45845,799,718,6,1115015,12961,45845,799,1069170,12162
2020-11-28,Wisconsin,55,404999,5442,3474,30,2543109,9883,404999,5473,2138110,4410
2020-11-28,Wyoming,56,31929,156,215,0,170833,156,31929,156,138904,0
2020-11-29,Alabama,01,247229,2236,3577,5,1620999,6214,247229,2236,1373770,3978
2020-11-29,Alaska,02,31896,617,115,0,1006180,7126,30816,612,975364,6514
2020-11-29,Arizona,04,325995,3221,6635,11,2246314,18521,325995,3221,1920319,15300
2020-11-29,Arkansas,05,156247,1221,2470,21,1694985,10445,156247,1221,1538738,9224
2020-11-29,California,06,1219496,13218,19151,19,23807501,234319,1198934,15614,22608567,218705
2020-11-29,Colorado,08,230057,3490,3025,13,1748078,12536,228772,3489,1519306,9047
2020-11-29,Connecticut,09,112581,0,4961,0,3154617,0,112581,0,3042036,0
2020-11-29,Delaware,10,35251,581,770,7,422384,3140,35251,581,387133,2559
2020-11-29,District of Columbia,11,21448,140,680,2,690342,5004,21448,140,668894,4864
2020-11-29,Florida,12,992652,7363,18499,58,7204335,37233,976944,7131,6227391,30102
2020-11-29,Georgia,13,452322,1695,9189,16,4302927,13903,420601,1665,3882326,12238
2020-11-29,Guam,66,7787,36,113,0,83251,36,6818,36,76433,0
2020-11-29,Hawaii,15,17925,54,242,4,18138,56,18138,56,,0
2020-11-29,Idaho,16,100758,774,925,6,486067,2408,99660,1160,386407,1248
2020-11-29,Illinois,17,721487,7417,12895,43,10431018,62740,720114,7178,9710904,55562
2020-11-29,Indiana,18,336027,4302,5685,22,2188928,14177,333312,4304,1855616,9873
2020-11-29,Iowa,19,228690,1509,2399,24,1067985,4304,201267,1584,866718,2720
2020-11-29,Kansas,20,155377,112,1529,0,812424,0,153021,0,659403,0
2020-11-29,Kentucky,21,180164,2711,2039,11,2581104,2743,176925,2743,2404179,0
2020-11-29,Louisiana,22,232245,1643,6407,16,3402706,23963,232245,1643,3170461,22320
2020-11-29,Maine,23,11508,220,191,0,841571,220,11508,220,830063,0
2020-11-29,Maryland,24,196727,2124,4625,23,2332839,15269,196447,1999,2136392,13270
2020-11-29,Massachusetts,25,224964,2495,10722,46,3345687,18253,224964,2495,3120723,15758
2020-11-29,Michigan,26,377596,317,9461,0,6574441,0,378152,0,6196289,0
2020-11-29,Minnesota,27,313028,8946,3637,57,2519056,44503,312969,8946,2206087,35557
2020-11-29,Mississippi,28,151785,1845,3806,27,1099057,1845,151785,1845,947272,0
2020-11-29,Missouri,29,309420,2894,3956,6,1805036,7503,295933,3193,1509103,4310
2020-11-29,Montana,30,61801,956,672,2,650223,4830,61801,956,588422,3874
2020-11-29,Nebraska,31,126491,1168,1022,4,737852,3372,125323,1257,612529,2115
2020-11-29,Nevada,32,150825,1212,2140,17,975296,2180,150527,1298,824769,882
2020-11-29,New Hampshire,33,20480,478,526,3,422690,3491,20480,478,402210,3013
2020-11-29,New Jersey,34,335943,3839,16978,13,5976392,4499,363083,4499,5613309,0
2020-11-29,New Mexico,35,95417,1435,1540,13,1547171,10969,95417,1435,1451754,9534
2020-11-29,New York,36,645932,6732,34101,52,19272524,157320,641161,6723,18631363,150597
2020-11-29,North Carolina,37,362124,3470,5279,30,5286488,41634,361778,3820,4924710,37814
2020-11-29,North Dakota,38,78664,723,926,5,350365,1560,80084,725,270281,835
2020-11-29,Northern Mariana Islands,69,104,0,2,0,16851,0,104,0,16747,0
2020-11-29,Ohio,39,414432,7729,6399,21,6083485,54776,414432,7729,5669053,47047
2020-11-29,Oklahoma,40,195545,1721,1736,19,2069013,1721,195545,1721,1873468,0
2020-11-29,Oregon,41,74120,1614,907,8,1033150,1714,72506,1674,960644,40
2020-11-29,Pennsylvania,42,361387,5144,10406,69,3176073,19942,357196,5529,2818877,14413
2020-11-29,Puerto Rico,72,85317,121,1094,11,357674,121,51702,121,305972,0
2020-11-29,Rhode Island,44,53954,0,1346,0,527158,3730,56072,1055,471086,2675
2020-11-29,South Carolina,45,216129,1218,4353,7,2386587,16354,216129,1218,2170458,15136
2020-11-29,South Dakota,46,79900,801,943,1,327744,2368,79900,801,247844,1567
2020-11-29,Tennessee,47,358809,2924,4500,11,4489451,19130,366518,3052,4122933,16078
2020-11-29,Texas,48,1247065,12390,21900,53,11075304,54078,1266707,7050,9808597,47028
2020-11-29,Utah,49,193809,1722,868,5,1330584,5491,193809,1722,1136775,3769
2020-11-29,Vermont,50,4100,67,67,0,222914,1418,4225,70,218689,1348
2020-11-29,Virgin Islands,78,1544,4,23,0,28327,55,1544,6,26783,49
2020-11-29,Virginia,51,235942,2325,4058,4,3335502,14846,235942,2325,3099560,12521
2020-11-29,Washington,53,168333,1597,2828,0,2926668,2624,173561,2624,2753107,0
2020-11-29,West Virginia,54,46997,1152,729,11,1129226,14211,46997,1152,1082229,13059
2020-11-29,Wisconsin,55,409054,4055,3496,22,2552844,9735,409054,4055,2143790,5680
2020-11-29,Wyoming,56,32489,560,215,0,171393,560,32489,560,138904,0
2020-11-30,Alabama,01,249524,2295,3578,1,1625848,4849,249524,2295,1376324,2554
2020-11-30,Alaska,02,32407,511,115,0,1011396,5216,31323,507,980073,4709
2020-11-30,Arizona,04,327046,1051,6640,5,2263766,17452,326817,822,1936949,16630
2020-11-30,Arkansas,05,157359,1112,2502,32,1702760,7775,157359,1112,1545401,6663
2020-11-30,California,06,1237192,17696,19209,58,24025171,217670,1212968,14034,22812203,203636
2020-11-30,Colorado,08,234502,4445,3060,35,1764249,16171,232905,4133,1531344,12038
2020-11-30,Connecticut,09,117295,4714,5020,59,3261454,106837,117295,4714,3144159,102123
2020-11-30,Delaware,10,35654,403,772,2,424342,1958,35654,403,388688,1555
2020-11-30,District of Columbia,11,21552,104,680,0,695256,4914,21552,104,673704,4810
2020-11-30,Florida,12,999311,6659,18596,97,7239802,35467,983370,6426,6256432,29041
2020-11-30,Georgia,13,454328,2006,9198,9,4314448,11521,422133,1532,3892315,9989
2020-11-30,Guam,66,7821,34,113,0,84419,1168,6852,34,77567,1134
2020-11-30,Hawaii,15,18006,81,242,0,18223,85,18223,85,,0
2020-11-30,Idaho,16,102158,1400,937,12,488090,2023,100484,824,387606,1199
2020-11-30,Illinois,17,727825,6338,13015,120,10497998,66980,726304,6190,9771694,60790
2020-11-30,Indiana,18,341694,5667,5723,38,2204581,15653,338977,5665,1865604,9988
2020-11-30,Iowa,19,230634,1944,2426,27,1070816,2831,202410,1143,868406,1688
2020-11-30,Kansas,20,160428,5051,1560,31,822884,10460,157446,4425,665438,6035
2020-11-30,Kentucky,21,183255,3091,2065,26,2613737,32633,179041,2116,2434696,30517
2020-11-30,Louisiana,22,232414,169,6420,13,3403719,1013,232414,169,3171305,844
2020-11-30,Maine,23,11757,249,194,3,875799,34228,11757,249,864042,33979
2020-11-30,Maryland,24,198710,1983,4641,16,2344909,12070,198370,1923,2146539,10147
2020-11-30,Massachusetts,25,226132,1168,10748,26,3353346,7659,226132,1168,3127214,6491
2020-11-30,Michigan,26,388364,10768,9565,104,6677336,102895,388942,10790,6288394,92105
2020-11-30,Minnesota,27,318822,5794,3652,15,2536343,17287,318763,5794,2217580,11493
2020-11-30,Mississippi,28,153270,1485,3807,1,1135665,36608,153270,1485,982395,35123
2020-11-30,Missouri,29,314981,5561,3981,25,1813693,8657,299762,3829,1513931,4828
2020-11-30,Montana,30,62256,455,684,12,656021,5798,62198,397,593823,5401
2020-11-30,Nebraska,31,128433,1942,1039,17,740367,2515,126466,1143,613901,1372
2020-11-30,Nevada,32,152726,1901,2149,9,979849,4553,152169,1642,827680,2911
2020-11-30,New Hampshire,33,20994,514,526,0,425202,2512,20994,514,404208,1998
2020-11-30,New Jersey,34,339133,3190,16993,15,6116090,139698,366898,3815,5749192,135883
2020-11-30,New Mexico,35,97095,1678,1568,28,1558291,11120,97095,1678,1461196,9442
2020-11-30,New York,36,652748,6816,34150,49,19421498,148974,647980,6819,18773518,142155
2020-11-30,North Carolina,37,364968,2844,5296,17,5316284,29796,364512,2734,4951772,27062
2020-11-30,North Dakota,38,79258,594,933,7,351644,1279,80679,595,270965,684
2020-11-30,Northern Mariana Islands,69,106,2,2,0,16853,2,106,2,16747,0
2020-11-30,Ohio,39,421063,6631,6429,30,6128597,45112,421063,6631,5707534,38481
2020-11-30,Oklahoma,40,197745,2200,1743,7,2071213,2200,197745,2200,1873468,0
2020-11-30,Oregon,41,75454,1334,919,12,1042806,9656,74120,1614,968686,8042
2020-11-30,Pennsylvania,42,366971,5584,10439,33,3189513,13440,361464,4268,2828049,9172
2020-11-30,Puerto Rico,72,86160,843,1106,12,358517,843,52545,843,305972,0
2020-11-30,Rhode Island,44,56723,2769,1373,27,529884,2726,56723,651,473161,2075
2020-11-30,South Carolina,45,217487,1358,4381,28,2399463,12876,217487,1358,2181976,11518
2020-11-30,South Dakota,46,80464,564,946,3,328852,1108,80464,564,248388,544
2020-11-30,Tennessee,47,366412,7603,4546,46,4545436,55985,374493,7975,4170943,48010
2020-11-30,Texas,48,1262145,15080,21968,68,11121195,45891,1278432,11725,9842763,34166
2020-11-30,Utah,49,195744,1935,871,3,1335394,4810,195706,1897,1139688,2913
2020-11-30,Vermont,50,4172,72,69,2,223885,971,4296,71,219589,900
2020-11-30,Virgin Islands,78,1544,0,23,0,28327,0,1544,0,26783,0
2020-11-30,Virginia,51,237835,1893,4062,4,3352908,17406,237835,1893,3115073,15513
2020-11-30,Washington,53,172175,3842,2895,67,2928847,2179,175740,2179,2753107,0
2020-11-30,West Virginia,54,47842,845,735,6,1137951,8725,47842,845,1090109,7880
2020-11-30,Wisconsin,55,411730,2676,3504,8,2561726,8882,411730,2676,2149996,6206
2020-11-30,Wyoming,56,33305,816,215,0,174771,3378,33305,816,141466,2562
2020-12-01,Alabama,01,252900,3376,3638,60,1636705,10857,252900,3376,1383805,7481
2020-12-01,Alaska,02,32911,504,116,1,1018628,7232,31834,511,986794,6721
2020-12-01,Arizona,04,338254,11208,6692,52,2282215,18449,337139,10322,1945076,8127
2020-12-01,Arkansas,05,159309,1950,2512,10,1711564,8804,159309,1950,1552255,6854
2020-12-01,California,06,1253867,16675,19327,118,24161313,136142,1225189,12221,22936124,123921
2020-12-01,Colorado,08,238779,4277,3136,76,1778454,14205,237310,4405,1541144,9800
2020-12-01,Connecticut,09,118754,1459,5040,20,3286210,24756,118754,1459,3167456,23297
2020-12-01,Delaware,10,36343,689,777,5,427250,2908,36343,689,390907,2219
2020-12-01,District of Columbia,11,21685,133,685,5,697409,2153,21685,133,675724,2020
2020-12-01,Florida,12,1008158,8847,18678,82,7287819,48017,991910,8540,6295909,39477
2020-12-01,Georgia,13,458985,4657,9253,55,4338967,24519,424929,2796,3914038,21723
2020-12-01,Guam,66,7858,37,113,0,85038,619,6889,37,78149,582
2020-12-01,Hawaii,15,18049,43,242,0,18266,43,18266,43,,0
2020-12-01,Idaho,16,103642,1484,966,29,490103,2013,101698,1214,388405,799
2020-12-01,Illinois,17,740510,12685,13175,160,10614079,116081,738846,12542,9875233,103539
2020-12-01,Indiana,18,347097,5403,5864,141,2217258,12677,344373,5396,1872885,7281
2020-12-01,Iowa,19,233062,2428,2449,23,1072992,2176,203398,988,869594,1188
2020-12-01,Kansas,20,160718,290,1560,0,822884,0,157446,0,665438,0
2020-12-01,Kentucky,21,187285,4030,2097,32,2639892,26155,183168,4127,2456724,22028
2020-12-01,Louisiana,22,237740,5326,6455,35,3454451,50732,237740,5326,3216711,45406
2020-12-01,Maine,23,11976,219,214,20,881709,5910,11976,219,869733,5691
2020-12-01,Maryland,24,201479,2769,4673,32,2357711,12802,201135,2765,2156576,10037
2020-12-01,Massachusetts,25,229205,3073,10778,30,3371701,18355,229205,3073,3142496,15282
2020-12-01,Michigan,26,394838,6474,9758,193,6716589,39253,395453,6511,6321136,32742
2020-12-01,Minnesota,27,322371,3549,3674,22,2545927,9584,322312,3549,2223615,6035
2020-12-01,Mississippi,28,154411,1141,3836,29,1136806,1141,154411,1141,982395,0
2020-12-01,Missouri,29,317903,2922,4130,149,1819587,5894,302691,2929,1516896,2965
2020-12-01,Montana,30,63324,1068,700,16,660895,4874,63205,1007,597690,3867
2020-12-01,Nebraska,31,130212,1779,1086,47,744724,4357,128407,1941,616317,2416
2020-12-01,Nevada,32,155312,2586,2182,33,986756,6907,154867,2698,831889,4209
2020-12-01,New Hampshire,33,21766,772,528,2,428207,3005,21766,772,406441,2233
2020-12-01,New Jersey,34,343739,4606,17083,90,6121533,5443,372341,5443,5749192,0
2020-12-01,New Mexico,35,99419,2324,1589,21,1579759,21468,99419,2324,1480340,19144
2020-12-01,New York,36,660041,7293,34222,72,19568173,146675,655265,7285,18912908,139390
2020-12-01,North Carolina,37,368615,3647,5322,26,5344037,27753,367395,2883,4976642,24870
2020-12-01,North Dakota,38,79661,403,960,27,352328,684,81145,466,271183,218
2020-12-01,Northern Mariana Islands,69,106,0,2,0,17116,263,106,0,17010,263
2020-12-01,Ohio,39,430093,9030,6548,119,6182931,54334,430093,9030,5752838,45304
2020-12-01,Oklahoma,40,199482,1737,1758,15,2122950,51737,199482,1737,1923468,50000
2020-12-01,Oregon,41,76655,1201,938,19,1044117,1311,75431,1311,968686,0
2020-12-01,Pennsylvania,42,372688,5717,10614,175,3203585,14072,367140,5676,2836445,8396
2020-12-01,Puerto Rico,72,86935,775,1122,16,359292,775,53320,775,305972,0
2020-12-01,Rhode Island,44,57906,1183,1380,7,533713,3829,57906,1183,475807,2646
2020-12-01,South Carolina,45,218912,1425,4404,23,2417026,17563,218912,1425,2198114,16138
2020-12-01,South Dakota,46,80912,448,948,2,330533,1681,80912,448,249621,1233
2020-12-01,Tennessee,47,371980,5568,4584,38,4582233,36797,380186,5693,4202047,31104
2020-12-01,Texas,48,1275499,13354,22204,236,11258630,137435,1296972,18540,9961658,118895
2020-12-01,Utah,49,198260,2516,890,19,1342463,7069,198216,2510,1144247,4559
2020-12-01,Vermont,50,4239,67,72,3,225150,1265,4365,69,220785,1196
2020-12-01,Virgin Islands,78,1550,6,23,0,28578,251,1550,6,27028,245
2020-12-01,Virginia,51,240063,2228,4093,31,3368573,15665,240063,2228,3128510,13437
2020-12-01,Washington,53,174969,2794,2927,32,2930161,1314,177054,1314,2753107,0
2020-12-01,West Virginia,54,48818,976,758,23,1149027,11076,48818,976,1100209,10100
2020-12-01,Wisconsin,55,416365,4635,3628,124,2572775,11049,416365,4635,2156410,6414
2020-12-01,Wyoming,56,33805,500,230,15,175271,500,33805,500,141466,0
2020-12-02,Alabama,01,256828,3928,3711,73,1647179,10474,256828,3928,1390351,6546
2020-12-02,Alaska,02,33614,703,116,0,1024643,6015,32531,697,992112,5318
2020-12-02,Arizona,04,342925,4671,6755,63,2298866,16651,340979,3840,1957887,12811
2020-12-02,Arkansas,05,161521,2212,2522,10,1724082,12518,161521,2212,1562561,10306
2020-12-02,California,06,1272041,18174,19440,113,24299126,137813,1245948,20759,23053178,117054
2020-12-02,Colorado,08,243324,4545,3226,90,1789850,11396,241172,3862,1548678,7534
2020-12-02,Connecticut,09,121426,2672,5091,51,3327440,41230,121426,2672,3206014,38558
2020-12-02,Delaware,10,36698,355,779,2,428533,1283,36698,355,391835,928
2020-12-02,District of Columbia,11,21842,157,690,5,701485,4076,21842,157,679643,3919
2020-12-02,Florida,12,1018152,9994,18775,97,7338187,50368,1001800,9890,6336387,40478
2020-12-02,Georgia,13,464417,5432,9301,48,4362964,23997,428980,4051,3933984,19946
2020-12-02,Guam,66,7889,31,113,0,85486,448,6920,31,78566,417
2020-12-02,Hawaii,15,18117,68,242,0,18342,76,18342,76,,0
2020-12-02,Idaho,16,105250,1608,1002,36,493134,3031,103305,1607,389829,1424
2020-12-02,Illinois,17,750208,9698,13433,258,10699586,85507,748603,9757,9950983,75750
2020-12-02,Indiana,18,353722,6625,5973,109,2232102,14844,350970,6597,1881132,8247
2020-12-02,Iowa,19,236159,3097,2518,69,1078029,5037,205773,2375,872256,2662
2020-12-02,Kansas,20,164981,4263,1679,119,831182,8298,162061,4615,669121,3683
2020-12-02,Kentucky,21,191067,3782,2124,27,2652314,12422,186765,3597,2465549,8825
2020-12-02,Louisiana,22,241335,3595,6501,46,3518499,64048,241335,3595,3277164,60453
2020-12-02,Maine,23,12208,232,218,4,892341,10632,12208,232,880133,10400
2020-12-02,Maryland,24,203672,2193,4715,42,2371358,13647,203355,2220,2168003,11427
2020-12-02,Massachusetts,25,234232,5027,10824,46,3395423,23722,234232,5027,3161191,18695
2020-12-02,Michigan,26,402255,7417,9839,81,6762022,45433,402886,7433,6359136,38000
2020-12-02,Minnesota,27,327536,5165,3751,77,2563919,17992,327477,5165,2236442,12827
2020-12-02,Mississippi,28,156868,2457,3851,15,1139263,2457,156868,2457,982395,0
2020-12-02,Missouri,29,321411,3508,4185,55,1825375,5788,305370,2679,1520005,3109
2020-12-02,Montana,30,64399,1075,713,13,663581,2686,64340,1135,599241,1551
2020-12-02,Nebraska,31,132530,2318,1132,46,748366,3642,130194,1787,618172,1855
2020-12-02,Nevada,32,157586,2274,2225,43,991427,4671,156996,2129,834431,2542
2020-12-02,New Hampshire,33,22332,566,537,9,432028,3821,22332,566,409696,3255
2020-12-02,New Jersey,34,348042,4303,17145,62,6164877,43344,377496,5155,5787381,38189
2020-12-02,New Mexico,35,100963,1544,1629,40,1592222,12463,100963,1544,1491259,10919
2020-12-02,New York,36,669016,8975,34286,64,19761724,193551,664238,8973,19097486,184578
2020-12-02,North Carolina,37,372525,3910,5406,84,5378004,33967,371594,4199,5006410,29768
2020-12-02,North Dakota,38,80141,480,972,12,353213,885,81696,551,271517,334
2020-12-02,Northern Mariana Islands,69,106,0,2,0,17116,0,106,0,17010,0
2020-12-02,Ohio,39,437928,7835,6671,123,6217744,34813,437928,7835,5779816,26978
2020-12-02,Oklahoma,40,202341,2859,1812,54,2143079,20129,202341,2859,1940738,17270
2020-12-02,Oregon,41,78206,1551,962,24,2002330,958213,76654,1223,1925676,956990
2020-12-02,Pennsylvania,42,381342,8654,10803,189,3228055,24470,375431,8291,2852624,16179
2020-12-02,Puerto Rico,72,87323,388,1144,22,359680,388,53708,388,305972,0
2020-12-02,Rhode Island,44,59005,1099,1391,11,536906,3193,59005,1099,477901,2094
2020-12-02,South Carolina,45,220835,1923,4444,40,2432901,15875,220835,1923,2212066,13952
2020-12-02,South Dakota,46,82203,1291,995,47,332540,2007,82203,1291,250337,716
2020-12-02,Tennessee,47,375995,4015,4635,51,4605389,23156,384285,4099,4221104,19057
2020-12-02,Texas,48,1294064,18565,22422,218,11383051,124421,1316194,19222,10066857,105199
2020-12-02,Utah,49,202220,3960,906,16,1351342,8879,202220,4004,1149122,4875
2020-12-02,Vermont,50,4461,222,74,2,225930,780,4466,101,221464,679
2020-12-02,Virgin Islands,78,1589,39,23,0,28810,232,1563,13,27247,219
2020-12-02,Virginia,51,242480,2417,4113,20,3378990,10417,242480,2417,3136510,8000
2020-12-02,Washington,53,177929,2960,2979,52,2934863,4702,181756,4702,2753107,0
2020-12-02,West Virginia,54,49905,1087,778,20,1159681,10654,49905,1087,1109776,9567
2020-12-02,Wisconsin,55,420930,4565,3715,87,2583546,10771,420930,4565,2162616,6206
2020-12-02,Wyoming,56,34507,702,230,0,175973,702,34507,702,141466,0
2020-12-03,Alabama,01,260359,3531,3776,65,1660369,13190,260359,3531,1400010,9659
2020-12-03,Alaska,02,34377,763,124,8,1040505,15862,33291,760,1007214,15102
2020-12-03,Arizona,04,348134,5209,6834,79,2316257,17391,346421,5442,1969836,11949
2020-12-03,Arkansas,05,164310,2789,2555,33,1740989,16907,164310,2789,1576679,14118
2020-12-03,California,06,1293887,21846,19586,146,24474642,175516,1264539,18591,23210103,156925
2020-12-03,Colorado,08,248779,5455,3335,109,1808065,18215,247209,6037,1560856,12178
2020-12-03,Connecticut,09,126177,4751,5111,20,3394113,66673,126177,4751,3267936,61922
2020-12-03,Delaware,10,37456,758,779,0,431760,3227,37456,758,394304,2469
2020-12-03,District of Columbia,11,22164,322,692,2,709991,8506,22164,322,687827,8184
2020-12-03,Florida,12,1029022,10870,18873,98,7388737,50550,1012456,10656,6376281,39894
2020-12-03,Georgia,13,469955,5538,9377,76,4396665,33701,433353,4373,3963312,29328
2020-12-03,Guam,66,7911,22,113,0,85958,472,6942,22,79016,450
2020-12-03,Hawaii,15,18256,139,244,2,18484,142,18484,142,,0
2020-12-03,Idaho,16,106882,1632,1023,21,497009,3875,104734,1429,392275,2446
2020-12-03,Illinois,17,761209,11001,13650,217,10806364,106778,759562,10959,10046802,95819
2020-12-03,Indiana,18,362182,8460,6033,60,2252864,20762,359430,8460,1893434,12302
2020-12-03,Iowa,19,238722,2563,2603,85,1083485,5456,207969,2196,875516,3260
2020-12-03,Kansas,20,165613,632,1679,0,831182,0,162061,0,669121,0
2020-12-03,Kentucky,21,194851,3784,2185,61,2721444,69130,190601,3836,2530843,65294
2020-12-03,Louisiana,22,244078,2743,6524,23,3541901,23402,244078,2743,3297823,20659
2020-12-03,Maine,23,12554,346,220,2,901836,9495,12554,346,889282,9149
2020-12-03,Maryland,24,205716,2044,4764,49,2383341,11983,205399,2044,2177942,9939
2020-12-03,Massachusetts,25,240907,6675,10874,50,3427846,32423,240907,6675,3186939,25748
2020-12-03,Michigan,26,410379,8124,10031,192,6831799,69777,410843,7957,6420956,61820
2020-12-03,Minnesota,27,333685,6149,3843,92,2584374,20455,333626,6149,2250748,14306
2020-12-03,Mississippi,28,159036,2168,3879,28,1141431,2168,159036,2168,982395,0
2020-12-03,Missouri,29,325519,4108,4274,89,1834404,9029,309368,3998,1525036,5031
2020-12-03,Montana,30,65242,843,723,10,669081,5500,65122,782,603959,4718
2020-12-03,Nebraska,31,134710,2180,1174,42,752981,4615,132530,2336,620451,2279
2020-12-03,Nevada,32,160317,2731,2259,34,999188,7761,159532,2536,839656,5225
2020-12-03,New Hampshire,33,22925,593,544,7,435387,3359,22925,593,412462,2766
2020-12-03,New Jersey,34,352835,4793,17209,64,6208889,44012,383052,5556,5825837,38456
2020-12-03,New Mexico,35,102873,1910,1673,44,1604914,12692,102862,1899,1502052,10793
2020-12-03,New York,36,678869,9853,34346,60,19965164,203440,674093,9855,19291071,193585
2020-12-03,North Carolina,37,378370,5845,5454,48,5432699,54695,377231,5637,5055468,49058
2020-12-03,North Dakota,38,81111,970,983,11,355291,2078,82713,1017,272578,1061
2020-12-03,Northern Mariana Islands,69,106,0,2,0,17116,0,106,0,17010,0
2020-12-03,Ohio,39,446859,8931,6753,82,6270788,53044,446849,8921,5823939,44123
2020-12-03,Oklahoma,40,204048,1707,1836,24,2161489,18410,204048,1707,1957441,16703
2020-12-03,Oregon,41,79294,1088,974,12,2021942,19612,78160,1506,1943782,18106
2020-12-03,Pennsylvania,42,392610,11268,11008,205,3259394,31339,386837,11406,2872557,19933
2020-12-03,Puerto Rico,72,87720,397,1155,11,360077,397,54105,397,305972,0
2020-12-03,Rhode Island,44,60722,1717,1400,9,541476,4570,60722,1717,480754,2853
2020-12-03,South Carolina,45,223063,2228,4466,22,2449100,16199,223063,2228,2226037,13971
2020-12-03,South Dakota,46,83348,1145,1033,38,334697,2157,83348,1145,251349,1012
2020-12-03,Tennessee,47,379679,3684,4727,92,4625661,20272,388252,3967,4237409,16305
2020-12-03,Texas,48,1311988,17924,22645,223,11502540,119489,1333746,17552,10168794,101937
2020-12-03,Utah,49,206255,4035,918,12,1361891,10549,206165,3945,1155726,6604
2020-12-03,Vermont,50,4642,181,75,1,227768,1838,4690,224,223078,1614
2020-12-03,Virgin Islands,78,1589,0,23,0,29009,199,1589,26,27420,173
2020-12-03,Virginia,51,244503,2023,4147,34,3389736,10746,244503,2023,3145233,8723
2020-12-03,Washington,53,180125,2196,3040,61,2938264,3401,185157,3401,2753107,0
2020-12-03,West Virginia,54,51025,1120,789,11,1171602,11921,51025,1120,1120577,10801
2020-12-03,Wisconsin,55,426534,5604,3781,66,2596504,12958,426534,5604,2169970,7354
2020-12-03,Wyoming,56,35078,571,257,27,178355,2382,35078,571,143277,1811
2020-12-04,Alabama,01,264199,3840,3831,55,1671498,11129,264199,3840,1407299,7289
2020-12-04,Alaska,02,35138,761,135,11,1050369,9864,34041,750,1016328,9114
2020-12-04,Arizona,04,355054,6920,6885,51,2338378,22121,352101,5680,1986277,16441
2020-12-04,Arkansas,05,167137,2827,2586,31,1756913,15924,167137,2827,1589776,13097
2020-12-04,California,06,1318139,24252,19791,205,24675478,200836,1286557,22018,23388921,178818
2020-12-04,Colorado,08,252960,4181,3375,40,1826441,18376,252222,5013,1574219,13363
2020-12-04,Connecticut,09,127715,1538,5146,35,3422098,27985,127715,1538,3294383,26447
2020-12-04,Delaware,10,38398,942,782,3,435067,3307,38398,942,396669,2365
2020-12-04,District of Columbia,11,22480,316,693,1,718242,8251,22480,316,695762,7935
2020-12-04,Florida,12,1039199,10177,18993,120,7444184,55447,1022354,9898,6421830,45549
2020-12-04,Georgia,13,476181,6226,9443,66,4435020,38355,438300,4947,3996720,33408
2020-12-04,Guam,66,7928,17,114,1,86530,572,6959,17,79571,555
2020-12-04,Hawaii,15,18373,117,254,10,18605,121,18605,121,,0
2020-12-04,Idaho,16,108741,1859,1037,14,500908,3899,106455,1721,394453,2178
2020-12-04,Illinois,17,771696,10487,13808,158,10918998,112634,770088,10526,10148910,102108
2020-12-04,Indiana,18,370091,7909,6122,89,2272182,19318,367329,7899,1904853,11419
2020-12-04,Iowa,19,241531,2809,2665,62,1089561,6076,210236,2267,879325,3809
2020-12-04,Kansas,20,171513,5900,1786,107,845186,14004,168295,6234,676891,7770
2020-12-04,Kentucky,21,198506,3655,2216,31,2733708,12264,194193,3592,2539515,8672
2020-12-04,Louisiana,22,247177,3099,6548,24,3566534,24633,247177,3099,3319357,21534
2020-12-04,Maine,23,12844,290,224,4,913676,11840,12844,290,900832,11550
2020-12-04,Maryland,24,209512,3796,4790,26,2403287,19946,209191,3792,2194096,16154
2020-12-04,Massachusetts,25,246398,5491,10910,36,3454355,26509,246398,5491,3207957,21018
2020-12-04,Michigan,26,419704,9325,10113,82,6900160,68361,420268,9425,6479892,58936
2020-12-04,Minnesota,27,339032,5347,3904,61,2608190,23816,338973,5347,2269217,18469
2020-12-04,Mississippi,28,161516,2480,3916,37,1143911,2480,161516,2480,982395,0
2020-12-04,Missouri,29,330445,4926,4375,101,1844062,9658,313421,4053,1530641,5605
2020-12-04,Montana,30,66494,1252,728,5,675262,6181,66436,1314,608826,4867
2020-12-04,Nebraska,31,136349,1639,1199,25,757832,4851,134710,2180,623122,2671
2020-12-04,Nevada,32,163065,2748,2276,17,1004655,5467,162434,2902,842221,2565
2020-12-04,New Hampshire,33,23690,765,552,8,438396,3009,23690,765,414706,2244
2020-12-04,New Jersey,34,358498,5663,17255,46,6215315,6426,389478,6426,5825837,0
2020-12-04,New Mexico,35,104935,2062,1706,33,1620383,15469,104935,2073,1515448,13396
2020-12-04,New York,36,690143,11274,34409,63,20173461,208297,685364,11271,19488097,197026
2020-12-04,North Carolina,37,384165,5795,5505,51,5485287,52588,382534,5303,5102753,47285
2020-12-04,North Dakota,38,81955,844,995,12,356851,1560,83604,891,273247,669
2020-12-04,Northern Mariana Islands,69,106,0,2,0,17116,0,106,0,17010,0
2020-12-04,Ohio,39,456963,10104,6882,129,6349442,78654,456963,10114,5892479,68540
2020-12-04,Oklahoma,40,208875,4827,1860,24,2191644,30155,208875,4827,1982769,25328
2020-12-04,Oregon,41,81441,2147,1004,30,2043324,21382,79263,1103,1964061,20279
2020-12-04,Pennsylvania,42,404699,12089,11189,181,3291921,32527,398600,11763,2893321,20764
2020-12-04,Puerto Rico,72,88212,492,1172,17,360569,492,54597,492,305972,0
2020-12-04,Rhode Island,44,62137,1415,1413,13,545059,3583,62137,1415,482922,2168
2020-12-04,South Carolina,45,226013,2950,4496,30,2474899,25799,226013,2950,2248886,22849
2020-12-04,South Dakota,46,84398,1050,1064,31,336512,1815,84398,1050,252114,765
2020-12-04,Tennessee,47,383995,4316,4822,95,4651344,25683,392608,4356,4258736,21327
2020-12-04,Texas,48,1326103,14115,22890,245,11619285,116745,1350542,16796,10268743,99949
2020-12-04,Utah,49,209258,3003,926,8,1374502,12611,209170,3005,1165332,9606
2020-12-04,Vermont,50,4763,121,77,2,230109,2341,4763,73,225346,2268
2020-12-04,Virgin Islands,78,1613,24,23,0,29115,106,1613,24,27502,82
2020-12-04,Virginia,51,247380,2877,4160,13,3416416,26680,247380,2877,3169036,23803
2020-12-04,Washington,53,182758,2633,3062,22,2941576,3312,188469,3312,2753107,0
2020-12-04,West Virginia,54,52172,1147,799,10,1188605,17003,52172,1147,1136433,15856
2020-12-04,Wisconsin,55,432217,5683,3847,66,2612527,16023,432207,5673,2180320,10350
2020-12-04,Wyoming,56,35737,659,257,0,180313,1958,35737,659,144576,1299
2020-12-05,Alabama,01,267589,3390,3877,46,1682946,11448,267589,3390,1415357,8058
2020-12-05,Alaska,02,36083,945,136,1,1067231,16862,34963,922,1032268,15940
2020-12-05,Arizona,04,361186,6132,6940,55,2362052,23674,358900,6799,2003152,16875
2020-12-05,Arkansas,05,169382,2245,2620,34,1771117,14204,169382,2245,1601735,11959
2020-12-05,California,06,1343145,25006,19876,85,24901975,226497,1311625,25068,23590350,201429
2020-12-05,Colorado,08,258124,5164,3415,40,1831566,5125,257347,5125,1574219,0
2020-12-05,Connecticut,09,127715,0,5146,0,3422098,0,127715,0,3294383,0
2020-12-05,Delaware,10,39096,698,782,0,437610,2543,39096,698,398514,1845
2020-12-05,District of Columbia,11,22872,392,695,2,727387,9145,22872,392,704515,8753
2020-12-05,Florida,12,1049630,10431,19083,90,7496592,52408,1032552,10198,6464040,42210
2020-12-05,Georgia,13,481126,4945,9506,63,4466200,31180,442017,3717,4024183,27463
2020-12-05,Guam,66,7946,18,114,0,86548,18,6977,18,79571,0
2020-12-05,Hawaii,15,18484,111,259,5,18738,133,18738,133,,0
2020-12-05,Idaho,16,109764,1023,1037,0,504583,3675,108366,1911,396217,1764
2020-12-05,Illinois,17,781441,9745,14028,220,11021676,102678,779975,9887,10241701,92791
2020-12-05,Indiana,18,377790,7699,6207,85,2292178,19996,375019,7690,1917159,12306
2020-12-05,Iowa,19,243385,1854,2682,17,1094502,4941,211891,1655,882611,3286
2020-12-05,Kansas,20,171626,113,1786,0,845186,0,168295,0,676891,0
2020-12-05,Kentucky,21,202135,3629,2241,25,2766608,32900,198065,3872,2568543,29028
2020-12-05,Louisiana,22,247177,0,6548,0,3566534,0,247177,0,3319357,0
2020-12-05,Maine,23,13127,283,227,3,913959,283,13127,283,900832,0
2020-12-05,Maryland,24,212545,3033,4820,30,2423180,19893,212384,3193,2210796,16700
2020-12-05,Massachusetts,25,252017,5619,10953,43,3482924,28569,252017,5619,3230907,22950
2020-12-05,Michigan,26,425776,6072,10313,200,6965058,64898,426576,6308,6538482,58590
2020-12-05,Minnesota,27,345340,6308,3979,75,2626659,18469,345281,6308,2281378,12161
2020-12-05,Mississippi,28,163458,1942,3949,33,1145853,1942,163458,1942,982395,0
2020-12-05,Missouri,29,334637,4192,4412,37,1855990,11928,318422,5001,1537568,6927
2020-12-05,Montana,30,67092,598,734,6,682583,7321,67069,633,615514,6688
2020-12-05,Nebraska,31,138568,2219,1202,3,761879,4047,136325,1615,625554,2432
2020-12-05,Nevada,32,166187,3122,2309,33,1014896,10241,165628,3194,849268,7047
2020-12-05,New Hampshire,33,24138,448,559,7,442270,3874,24138,448,418132,3426
2020-12-05,New Jersey,34,363822,5324,17306,51,6314323,99008,395526,6048,5918797,92960
2020-12-05,New Mexico,35,106856,1921,1738,32,1634917,14534,106856,1921,1528061,12613
2020-12-05,New York,36,700902,10759,34488,79,20388862,215401,696125,10761,19692737,204640
2020-12-05,North Carolina,37,388760,4595,5547,42,5546614,61327,388552,6018,5158062,55309
2020-12-05,North Dakota,38,82510,555,1013,18,358233,1382,84219,615,274014,767
2020-12-05,Northern Mariana Islands,69,106,0,2,0,17116,0,106,0,17010,0
2020-12-05,Ohio,39,467432,10469,6947,65,6416665,67223,467432,10469,5949233,56754
2020-12-05,Oklahoma,40,213245,4370,1874,14,2222074,30430,213245,4370,2008829,26060
2020-12-05,Oregon,41,83243,1802,1027,23,2087054,43730,81437,2174,2005617,41556
2020-12-05,Pennsylvania,42,416073,11374,11331,142,3323124,31203,411484,12884,2911640,18319
2020-12-05,Puerto Rico,72,89147,935,1184,12,361504,935,55532,935,305972,0
2020-12-05,Rhode Island,44,62137,0,1413,0,550004,4945,63944,1807,486060,3138
2020-12-05,South Carolina,45,229235,3222,4517,21,2503921,29022,229235,3222,2274686,25800
2020-12-05,South Dakota,46,85304,906,1091,27,338369,1857,85304,906,253065,951
2020-12-05,Tennessee,47,388815,4820,4851,29,4675056,23712,397522,4914,4277534,18798
2020-12-05,Texas,48,1337296,11193,23111,221,11731196,111911,1364933,14391,10366263,97520
2020-12-05,Utah,49,212844,3586,939,13,1386715,12213,212844,3674,1173871,8539
2020-12-05,Vermont,50,4894,131,79,2,231751,1642,4894,131,226857,1511
2020-12-05,Virgin Islands,78,1613,0,23,0,29293,178,1633,20,27660,158
2020-12-05,Virginia,51,251173,3793,4197,37,3467011,50595,251173,3793,3215838,46802
2020-12-05,Washington,53,184079,1321,3065,3,3137463,195887,191607,3138,2945856,192749
2020-12-05,West Virginia,54,53572,1400,829,30,1215319,26714,53572,1400,1161747,25314
2020-12-05,Wisconsin,55,437918,5701,3938,91,2626867,14340,437918,5711,2188949,8629
2020-12-05,Wyoming,56,35941,204,257,0,180517,204,35941,204,144576,0
2020-12-06,Alabama,01,269877,2288,3889,12,1691003,8057,269877,2288,1421126,5769
2020-12-06,Alaska,02,36847,764,136,0,1077776,10545,35720,757,1042056,9788
2020-12-06,Arizona,04,364276,3090,6950,10,2383089,21037,364276,5376,2018813,15661
2020-12-06,Arkansas,05,170924,1542,2660,40,1785903,14786,170924,1542,1614979,13244
2020-12-06,California,06,1371940,28795,19937,61,25195046,293071,1341700,30075,23853346,262996
2020-12-06,Colorado,08,262460,4336,3437,22,1869410,37844,260581,3234,1608829,34610
2020-12-06,Connecticut,09,127715,0,5146,0,3422098,0,127715,0,3294383,0
2020-12-06,Delaware,10,39912,816,793,11,440766,3156,39912,816,400854,2340
2020-12-06,District of Columbia,11,23136,264,697,2,734633,7246,23136,264,711497,6982
2020-12-06,Florida,12,1058066,8436,19176,93,7545964,49372,1040727,8175,6505237,41197
2020-12-06,Georgia,13,483106,1980,9516,10,4476052,9852,443822,1805,4032230,8047
2020-12-06,Guam,66,7973,27,114,0,86575,27,7004,27,79571,0
2020-12-06,Hawaii,15,18581,97,260,1,18842,104,18842,104,,0
2020-12-06,Idaho,16,110553,789,1040,3,507732,3149,109705,1339,398027,1810
2020-12-06,Illinois,17,788922,7481,14127,99,11101214,79538,787573,7598,10313641,71940
2020-12-06,Indiana,18,384391,6601,6242,35,2309879,17701,381617,6598,1928262,11103
2020-12-06,Iowa,19,244689,1304,2717,35,1098589,4087,213390,1499,885199,2588
2020-12-06,Kansas,20,171635,9,1786,0,845186,0,168295,0,676891,0
2020-12-06,Kentucky,21,204772,2637,2250,9,2769175,2567,200632,2567,2568543,0
2020-12-06,Louisiana,22,251123,3946,6584,36,3608083,41549,251123,3946,3356960,37603
2020-12-06,Maine,23,13348,221,227,0,914180,221,13348,221,900832,0
2020-12-06,Maryland,24,215348,2803,4846,26,2440622,17442,215027,2643,2225595,14799
2020-12-06,Massachusetts,25,256844,4827,11004,51,3507572,24648,256844,4827,3250728,19821
2020-12-06,Michigan,26,426124,348,10313,0,6965058,0,426576,0,6538482,0
2020-12-06,Minnesota,27,350921,5581,4043,64,2651997,25338,350862,5581,2301135,19757
2020-12-06,Mississippi,28,164931,1473,3961,12,1147326,1473,164931,1473,982395,0
2020-12-06,Missouri,29,337927,3290,4420,8,1866524,10534,322298,3876,1544226,6658
2020-12-06,Montana,30,67875,783,736,2,688214,5631,67875,806,620339,4825
2020-12-06,Nebraska,31,139834,1266,1213,11,770307,8428,138568,2243,631739,6185
2020-12-06,Nevada,32,168758,2571,2318,9,1021786,6890,168139,2511,853647,4379
2020-12-06,New Hampshire,33,24771,633,564,5,445707,3437,24771,633,420936,2804
2020-12-06,New Jersey,34,369852,6030,17321,15,6320955,6632,402158,6632,5918797,0
2020-12-06,New Mexico,35,108088,1232,1749,11,1647976,13059,108088,1232,1539888,11827
2020-12-06,New York,36,710612,9710,34552,64,20594694,205832,705827,9702,19888867,196130
2020-12-06,North Carolina,37,395020,6260,5578,31,5611276,64662,394990,6438,5216286,58224
2020-12-06,North Dakota,38,82987,477,1019,6,359199,966,84707,488,274492,478
2020-12-06,Northern Mariana Islands,69,106,0,2,0,17116,0,106,0,17010,0
2020-12-06,Ohio,39,475024,7592,6960,13,6475710,59045,475024,7592,6000686,51453
2020-12-06,Oklahoma,40,216486,3241,1896,22,2225315,3241,216486,3241,2008829,0
2020-12-06,Oregon,41,84496,1253,1033,6,2088860,1806,83243,1806,2005617,0
2020-12-06,Pennsylvania,42,423828,7755,11389,58,3349150,26026,420114,8630,2929036,17396
2020-12-06,Puerto Rico,72,90286,1139,1191,7,362643,1139,56671,1139,305972,0
2020-12-06,Rhode Island,44,62137,0,1413,0,553947,3943,64974,1030,488973,2913
2020-12-06,South Carolina,45,232099,2864,4566,49,2528191,24270,232099,2864,2296092,21406
2020-12-06,South Dakota,46,85991,687,1110,19,339995,1626,85991,687,254004,939
2020-12-06,Tennessee,47,391393,2578,4888,37,4690522,15466,400594,3072,4289928,12394
2020-12-06,Texas,48,1346699,9403,23187,76,11790789,59593,1375313,10380,10415476,49213
2020-12-06,Utah,49,215407,2563,939,0,1395728,9013,215407,2563,1180321,6450
2020-12-06,Vermont,50,5015,121,79,0,233880,2129,5015,121,228865,2008
2020-12-06,Virgin Islands,78,1613,0,23,0,29293,0,1633,0,27660,0
2020-12-06,Virginia,51,255053,3880,4200,3,3523875,56864,255053,3880,3268822,52984
2020-12-06,Washington,53,185505,1426,3065,0,3152739,15276,194687,3080,2958052,12196
2020-12-06,West Virginia,54,54997,1425,838,9,1223363,8044,54997,1425,1168366,6619
2020-12-06,Wisconsin,55,441067,3149,3956,18,2637789,10922,441067,3149,2196722,7773
2020-12-06,Wyoming,56,36317,376,257,0,180893,376,36317,376,144576,0
2020-12-07,Alabama,01,272229,2352,3892,3,1698013,7010,272229,2352,1425784,4658
2020-12-07,Alaska,02,37350,503,139,3,1082140,4364,36196,476,1045944,3888
2020-12-07,Arizona,04,366364,2088,6950,0,2401547,18458,365843,1567,2035704,16891
2020-12-07,Arkansas,05,172042,1118,2713,53,1795940,10037,172042,1118,1623898,8919
2020-12-07,California,06,1399167,27227,20052,115,25493351,298305,1366435,24735,24126916,273570
2020-12-07,Colorado,08,266670,4210,3466,29,1884917,15507,264618,4037,1620299,11470
2020-12-07,Connecticut,09,135844,8129,5224,78,3545421,123323,135844,8129,3409577,115194
2020-12-07,Delaware,10,40711,799,793,0,444528,3762,40711,799,403817,2963
2020-12-07,District of Columbia,11,23319,183,701,4,739084,4451,23319,183,715765,4268
2020-12-07,Florida,12,1065777,7711,19281,105,7584453,38489,1048264,7537,6536189,30952
2020-12-07,Georgia,13,488225,5119,9559,43,4521060,45008,448683,4861,4072377,40147
2020-12-07,Guam,66,7988,15,114,0,88437,1862,7019,15,81418,1847
2020-12-07,Hawaii,15,18659,78,260,0,18923,81,18923,81,,0
2020-12-07,Idaho,16,112433,1880,1062,22,510221,2489,110510,805,399711,1684
2020-12-07,Illinois,17,797789,8867,14234,107,11178783,77569,796264,8691,10382519,68878
2020-12-07,Indiana,18,390048,5657,6284,42,2323969,14090,387278,5661,1936691,8429
2020-12-07,Iowa,19,245985,1296,2723,6,1100653,2064,214067,677,886586,1387
2020-12-07,Kansas,20,177389,5754,1856,70,861324,16138,174025,5730,687299,10408
2020-12-07,Kentucky,21,207043,2271,2276,26,2806992,37817,202592,1960,2604400,35857
2020-12-07,Louisiana,22,252136,1013,6607,23,3618824,10741,252136,1013,3366688,9728
2020-12-07,Maine,23,13775,427,227,0,936624,22444,13775,427,922849,22017
2020-12-07,Maryland,24,217647,2299,4865,19,2458029,17407,217329,2302,2240700,15105
2020-12-07,Massachusetts,25,259325,2481,11035,31,3521096,13524,259325,2481,3261771,11043
2020-12-07,Michigan,26,435681,9557,10415,102,7058720,93662,436400,9824,6622320,83838
2020-12-07,Minnesota,27,356211,5290,4064,21,2677739,25742,356152,5290,2321587,20452
2020-12-07,Mississippi,28,166194,1263,3961,0,1192494,45168,166194,1263,1026300,43905
2020-12-07,Missouri,29,342244,4317,4452,32,1874010,7486,324956,2658,1549054,4828
2020-12-07,Montana,30,68651,776,743,7,692763,4549,68591,716,624172,3833
2020-12-07,Nebraska,31,141284,1450,1244,31,773671,3364,139834,1266,633837,2098
2020-12-07,Nevada,32,171159,2401,2326,8,1028231,6445,170587,2448,857644,3997
2020-12-07,New Hampshire,33,25816,1045,566,2,449130,3423,25816,1045,423314,2378
2020-12-07,New Jersey,34,373415,3563,17336,15,6325092,4137,406295,4137,5918797,0
2020-12-07,New Mexico,35,109947,1859,1756,7,1660275,12299,109947,1859,1550328,10440
2020-12-07,New York,36,718991,8379,34637,85,20746981,152287,713129,7302,20033852,144985
2020-12-07,North Carolina,37,399796,4776,5598,20,5655815,44539,399362,4372,5256453,40167
2020-12-07,North Dakota,38,83348,361,1028,9,360031,832,85094,387,274937,445
2020-12-07,Northern Mariana Islands,69,109,3,2,0,17119,3,109,3,17010,0
2020-12-07,Ohio,39,484297,9273,7023,63,6527328,51618,484297,9273,6043031,42345
2020-12-07,Oklahoma,40,218389,1903,1911,15,2227218,1903,218389,1903,2008829,0
2020-12-07,Oregon,41,85803,1307,1049,16,2090113,1253,84496,1253,2005617,0
2020-12-07,Pennsylvania,42,432410,8582,11431,42,3369727,20577,426444,6330,2943283,14247
2020-12-07,Puerto Rico,72,91237,951,1202,11,363594,951,57622,951,305972,0
2020-12-07,Rhode Island,44,65818,3681,1448,35,556960,3013,65818,844,491142,2169
2020-12-07,South Carolina,45,234652,2553,4579,13,2554866,26675,234652,2553,2320214,24122
2020-12-07,South Dakota,46,86500,509,1110,0,341195,1200,86500,509,254695,691
2020-12-07,Tennessee,47,399323,7930,4953,65,4733652,43130,408730,8136,4324922,34994
2020-12-07,Texas,48,1361376,14677,23258,71,11831199,40410,1384804,9491,10446395,30919
2020-12-07,Utah,49,217638,2231,949,10,1403103,7375,217638,2231,1185465,5144
2020-12-07,Vermont,50,5080,65,81,2,235301,1421,5080,65,230221,1356
2020-12-07,Virgin Islands,78,1649,36,23,0,29663,370,1649,16,28014,354
2020-12-07,Virginia,51,258870,3817,4208,8,3554496,30621,258870,3817,3295626,26804
2020-12-07,Washington,53,191468,5963,3080,15,3162013,9274,196460,1773,2965553,7501
2020-12-07,West Virginia,54,56128,1131,841,3,1235583,12220,56128,1131,1179455,11089
2020-12-07,Wisconsin,55,443415,2348,3979,23,2645862,8073,443389,2322,2202473,5751
2020-12-07,Wyoming,56,36985,668,280,23,183251,2358,36985,668,146266,1690
2020-12-08,Alabama,01,276665,4436,3942,50,1711748,13735,276665,4436,1435083,9299
2020-12-08,Alaska,02,37923,573,139,0,1088978,6838,36758,562,1052220,6276
2020-12-08,Arizona,04,379662,13298,6985,35,2421060,19513,378157,12314,2042903,7199
2020-12-08,Arkansas,05,174325,2283,2752,39,1807211,11271,174325,2283,1632886,8988
2020-12-08,California,06,1425432,26265,20238,186,25789775,296424,1389707,23272,24400068,273152
2020-12-08,Colorado,08,270381,3711,3508,42,1899317,14400,268589,3971,1630728,10429
2020-12-08,Connecticut,09,138258,2414,5242,18,3573535,28114,138258,2414,3435277,25700
2020-12-08,Delaware,10,41464,753,803,10,447438,2910,41464,753,405974,2157
2020-12-08,District of Columbia,11,23589,270,701,0,745631,6547,23589,270,722042,6277
2020-12-08,Florida,12,1073762,7985,19377,96,7624426,39973,1056065,7801,6568361,32172
2020-12-08,Georgia,13,493558,5333,9582,23,4555443,34383,452369,3686,4103074,30697
2020-12-08,Guam,66,7995,7,114,0,88614,177,7026,7,81588,170
2020-12-08,Hawaii,15,18712,53,260,0,18976,53,18976,53,,0
2020-12-08,Idaho,16,114411,1978,1081,19,512851,2630,111893,1383,400958,1247
2020-12-08,Illinois,17,805794,8005,14392,158,11274608,95825,804174,7910,10470434,87915
2020-12-08,Indiana,18,395449,5401,6410,126,2338308,14339,392663,5385,1945645,8954
2020-12-08,Iowa,19,246237,252,2915,192,1102737,2084,214897,830,887840,1254
2020-12-08,Kansas,20,177780,391,1856,0,861324,0,174025,0,687299,0
2020-12-08,Kentucky,21,210232,3189,2328,52,2822478,15486,205668,3076,2616810,12410
2020-12-08,Louisiana,22,254562,2426,6652,45,3647386,28562,254562,2426,3392824,26136
2020-12-08,Maine,23,14049,274,239,12,942567,5943,14049,274,928518,5669
2020-12-08,Maryland,24,220279,2632,4916,51,2474475,16446,219961,2632,2254514,13814
2020-12-08,Massachusetts,25,263447,4122,11076,41,3540164,19068,263447,4122,3276717,14946
2020-12-08,Michigan,26,442504,6823,10620,205,7119253,60533,443076,6676,6676177,53857
2020-12-08,Minnesota,27,359262,3051,4086,22,2688011,10272,359203,3051,2328808,7221
2020-12-08,Mississippi,28,167926,1732,4017,56,1194226,1732,167926,1732,1026300,0
2020-12-08,Missouri,29,346161,3917,4594,142,1881501,7491,328206,3250,1553295,4241
2020-12-08,Montana,30,69465,814,763,20,696878,4115,69346,755,627532,3360
2020-12-08,Nebraska,31,142718,1434,1288,44,776493,2822,141127,1293,635366,1529
2020-12-08,Nevada,32,174050,2891,2368,42,1033130,4899,173281,2694,859849,2205
2020-12-08,New Hampshire,33,26623,807,566,0,452208,3078,26623,807,425585,2271
2020-12-08,New Jersey,34,378891,5476,17426,90,6384905,59813,412614,6319,5972291,53494
2020-12-08,New Mexico,35,111191,1244,1789,33,1669512,9237,111202,1255,1558310,7982
2020-12-08,New York,36,728010,9019,34723,86,20909445,162464,722464,9335,20186981,153129
2020-12-08,North Carolina,37,404520,4724,5642,44,5704900,49085,404032,4670,5300868,44415
2020-12-08,North Dakota,38,85688,2340,1064,36,360613,582,85676,582,274937,0
2020-12-08,Northern Mariana Islands,69,111,2,2,0,17121,2,111,2,17010,0
2020-12-08,Ohio,39,510018,25721,7103,80,6593404,66076,510018,25721,6083386,40355
2020-12-08,Oklahoma,40,220686,2297,1922,11,2259659,32441,220686,2297,2038973,30144
2020-12-08,Oregon,41,87082,1279,1082,33,2153661,63548,85788,1292,2067873,62256
2020-12-08,Pennsylvania,42,442528,10118,11592,161,3396338,26611,436614,10170,2959724,16441
2020-12-08,Puerto Rico,72,91931,694,1205,3,364288,694,58316,694,305972,0
2020-12-08,Rhode Island,44,67067,1249,1470,22,560886,3926,67067,1249,493819,2677
2020-12-08,South Carolina,45,236954,2302,4585,6,2581328,26462,236954,2302,2344374,24160
2020-12-08,South Dakota,46,87038,538,1111,1,342423,1228,87038,538,255385,690
2020-12-08,Tennessee,47,405149,5826,5051,98,4765211,31559,414749,6019,4350462,25540
2020-12-08,Texas,48,1375272,13896,23439,181,11954052,122853,1404646,19842,10549406,103011
2020-12-08,Utah,49,219971,2333,972,23,1409363,6260,219971,2333,1189392,3927
2020-12-08,Vermont,50,5180,100,85,4,235474,173,5180,100,230294,73
2020-12-08,Virgin Islands,78,1680,31,23,0,29841,178,1680,31,28161,147
2020-12-08,Virginia,51,262730,3860,4260,52,3579046,24550,262730,3860,3316316,20690
2020-12-08,Washington,53,194788,3320,3102,22,3177952,15939,197642,1182,2980310,14757
2020-12-08,West Virginia,54,57060,932,870,29,1245934,10351,57060,932,1188874,9419
2020-12-08,Wisconsin,55,448009,4594,4059,80,2655959,10097,448009,4620,2207950,5477
2020-12-08,Wyoming,56,37475,490,280,0,184614,1363,37475,490,147139,873
2020-12-09,Alabama,01,280187,3522,3985,43,1721812,10064,280187,3522,1441625,6542
2020-12-09,Alaska,02,38510,587,143,4,1099555,10577,37342,584,1062213,9993
2020-12-09,Arizona,04,384241,4579,7081,96,2432832,11772,382601,4444,2050231,7328
2020-12-09,Arkansas,05,176652,2327,2786,34,1824317,17106,176652,2327,1647665,14779
2020-12-09,California,06,1457214,31782,20466,228,26042071,252296,1420558,30851,24621513,221445
2020-12-09,Colorado,08,274354,3973,3671,163,1910906,11589,272346,3757,1638560,7832
2020-12-09,Connecticut,09,140548,2290,5285,43,3603855,30320,140548,2290,3463307,28030
2020-12-09,Delaware,10,42393,929,803,0,450786,3348,42393,929,408393,2419
2020-12-09,District of Columbia,11,23854,265,704,3,752507,6876,23854,265,728653,6611
2020-12-09,Florida,12,1083354,9592,19461,84,7671897,47471,1065476,9411,6606421,38060
2020-12-09,Georgia,13,499299,5741,9630,48,4578124,22681,456113,3744,4122011,18937
2020-12-09,Guam,66,8008,13,114,0,89195,581,7039,13,82156,568
2020-12-09,Hawaii,15,18785,73,264,4,19056,80,19056,80,,0
2020-12-09,Idaho,16,116677,2266,1124,43,510627,-2224,113905,2012,396722,-4236
2020-12-09,Illinois,17,813990,8196,14621,229,11367345,92737,812430,8256,10554915,84481
2020-12-09,Indiana,18,401219,5770,6506,96,2352854,14546,398417,5754,1954437,8792
2020-12-09,Iowa,19,248782,2545,3017,102,1107487,4750,216694,1797,890793,2953
2020-12-09,Kansas,20,183404,5624,1941,85,876052,14728,179803,5778,696249,8950
2020-12-09,Kentucky,21,212997,2765,2359,31,2829382,6904,209136,3468,2620246,3436
2020-12-09,Louisiana,22,258914,4352,6684,32,3679908,32522,258914,4352,3420994,28170
2020-12-09,Maine,23,14454,405,246,7,951213,8646,14454,405,936759,8241
2020-12-09,Maryland,24,222971,2692,4962,46,2490238,15763,222653,2692,2267585,13071
2020-12-09,Massachusetts,25,269412,5965,11166,90,3566445,26281,269412,5965,3297033,20316
2020-12-09,Michigan,26,447817,5313,10699,79,7166909,47656,448418,5342,6718491,42314
2020-12-09,Minnesota,27,363778,4516,4168,82,2704144,16133,363719,4516,2340425,11617
2020-12-09,Mississippi,28,170672,2746,4041,24,1196972,2746,170672,2746,1026300,0
2020-12-09,Missouri,29,349046,2885,4640,46,1887534,6033,330846,2640,1556688,3393
2020-12-09,Montana,30,70191,726,771,8,699468,2590,70133,787,629335,1803
2020-12-09,Nebraska,31,144087,1369,1305,17,780473,3980,142603,1476,637870,2504
2020-12-09,Nevada,32,176674,2624,2395,27,1039942,6812,176334,3053,863608,3759
2020-12-09,New Hampshire,33,27592,969,570,4,455858,3650,27592,969,428266,2681
2020-12-09,New Jersey,34,383354,4463,17542,116,6524772,139867,417733,5119,6107039,134748
2020-12-09,New Mexico,35,112950,1759,1823,34,1671260,1748,112950,1748,1558310,0
2020-12-09,New York,36,738947,10937,34799,76,21104040,194595,733064,10600,20370976,183995
2020-12-09,North Carolina,37,412140,7620,5704,62,5758894,53994,410527,6495,5348367,47499
2020-12-09,North Dakota,38,86149,461,1081,17,361358,745,86149,473,275209,272
2020-12-09,Northern Mariana Islands,69,113,2,2,0,17319,198,113,2,17206,196
2020-12-09,Ohio,39,520112,10094,7187,84,6643708,50304,520112,10094,6123596,40210
2020-12-09,Oklahoma,40,222993,2307,1945,23,2278911,19252,222993,2307,2055918,16945
2020-12-09,Oregon,41,88308,1226,1112,30,2175160,21499,87082,1294,2088078,20205
2020-12-09,Pennsylvania,42,451154,8626,11839,247,3417911,21573,445317,8703,2972594,12870
2020-12-09,Puerto Rico,72,92577,646,1219,14,364934,646,58962,646,305972,0
2020-12-09,Rhode Island,44,68299,1232,1484,14,566029,5143,68299,1232,497730,3911
2020-12-09,South Carolina,45,239444,2490,4612,27,2596781,15453,239444,2490,2357337,12963
2020-12-09,South Dakota,46,88023,985,1147,36,344472,2049,88023,985,256449,1064
2020-12-09,Tennessee,47,413043,7894,5113,62,4810238,45027,422962,8213,4387276,36814
2020-12-09,Texas,48,1390544,15272,23727,288,12037885,83833,1418252,13606,10619633,70227
2020-12-09,Utah,49,222545,2574,995,23,1417893,8530,222545,2574,1195348,5956
2020-12-09,Vermont,50,5285,105,86,1,236628,1154,5285,105,231343,1049
2020-12-09,Virgin Islands,78,1698,18,23,0,30204,363,1698,18,28506,345
2020-12-09,Virginia,51,267128,4398,4281,21,3607487,28441,267128,4398,3340359,24043
2020-12-09,Washington,53,197973,3185,3146,44,3211015,33063,201292,3650,3009723,29413
2020-12-09,West Virginia,54,58462,1402,901,31,1259831,13897,58462,1402,1201369,12495
2020-12-09,Wisconsin,55,452180,4171,4149,90,2668237,12278,452180,4171,2216057,8107
2020-12-09,Wyoming,56,37885,410,299,19,185419,805,37885,410,147534,395
2020-12-10,Alabama,01,284922,4735,4034,49,1734292,12480,284922,4735,1449370,7745
2020-12-10,Alaska,02,39146,636,148,5,1113360,13805,37962,620,1075398,13185
2020-12-10,Arizona,04,390047,5806,7173,92,2451811,18979,387529,4928,2064282,14051
2020-12-10,Arkansas,05,178854,2202,2820,34,1837779,13462,178854,2202,1658925,11260
2020-12-10,California,06,1491053,33839,20636,170,26324332,282261,1450235,29677,24874097,252584
2020-12-10,Colorado,08,278916,4562,3795,124,1926295,15389,276995,4649,1649300,10740
2020-12-10,Connecticut,09,142979,2431,5327,42,3640545,36690,142979,2431,3497566,34259
2020-12-10,Delaware,10,43036,643,806,3,453437,2651,43036,643,410401,2008
2020-12-10,District of Columbia,11,24098,244,708,4,757833,5326,24098,244,733735,5082
2020-12-10,Florida,12,1094689,11335,19590,129,7731735,59838,1076547,11071,6655188,48767
2020-12-10,Georgia,13,506802,7503,9683,53,4621841,43717,462175,6062,4159666,37655
2020-12-10,Guam,66,8021,13,116,2,89694,499,7052,13,82642,486
2020-12-10,Hawaii,15,18901,116,266,2,19179,123,19179,123,,0
2020-12-10,Idaho,16,118352,1675,1145,21,514491,3864,116203,2298,398288,1566
2020-12-10,Illinois,17,825136,11146,14852,231,11481848,114503,823531,11101,10658317,103402
2020-12-10,Indiana,18,407755,6536,6603,97,2369181,16327,404935,6518,1964246,9809
2020-12-10,Iowa,19,251027,2245,3116,99,1111940,4453,218377,1683,893563,2770
2020-12-10,Kansas,20,183750,346,1941,0,876052,0,179803,0,696249,0
2020-12-10,Kentucky,21,217112,4115,2387,28,2878401,49019,213450,4314,2664951,44705
2020-12-10,Louisiana,22,261329,2415,6724,40,3704865,24957,261329,2415,3443536,22542
2020-12-10,Maine,23,14861,407,246,0,961560,10347,14861,407,946699,9940
2020-12-10,Maryland,24,226173,3202,5012,50,2510206,19968,225855,3202,2284351,16766
2020-12-10,Massachusetts,25,274781,5369,11209,43,3590168,23723,274781,5369,3315387,18354
2020-12-10,Michigan,26,454180,6363,10895,196,7226999,60090,454720,6302,6772279,53788
2020-12-10,Minnesota,27,367277,3499,4257,89,2717840,13696,367218,3499,2350622,10197
2020-12-10,Mississippi,28,172955,2283,4083,42,1199255,2283,172955,2283,1026300,0
2020-12-10,Missouri,29,353082,4036,4690,50,1898753,11219,334704,3858,1564049,7361
2020-12-10,Montana,30,70954,763,786,15,702525,3057,70892,759,631633,2298
2020-12-10,Nebraska,31,145819,1732,1348,43,783697,3224,143924,1321,639773,1903
2020-12-10,Nevada,32,179409,2735,2448,53,1045846,5904,178527,2193,867319,3711
2020-12-10,New Hampshire,33,28273,681,584,14,460068,4210,28273,681,431795,3529
2020-12-10,New Jersey,34,388474,5120,17608,66,6574682,49910,423533,5800,6151149,44110
2020-12-10,New Mexico,35,114731,1781,1846,23,1692676,21416,114731,1781,1577945,19635
2020-12-10,New York,36,749204,10257,34884,85,21301446,197406,743242,10178,20558204,187228
2020-12-10,North Carolina,37,417951,5811,5752,48,5778458,19564,416083,5556,5362375,14008
2020-12-10,North Dakota,38,86713,564,1109,28,362737,1379,86707,558,276030,821
2020-12-10,Northern Mariana Islands,69,113,0,2,0,17319,0,113,0,17206,0
2020-12-10,Ohio,39,531850,11738,7298,111,6706714,63006,531850,11738,6174864,51268
2020-12-10,Oklahoma,40,225453,2460,1980,35,2297621,18710,225453,2460,2072168,16250
2020-12-10,Oregon,41,89838,1530,1124,12,2193822,18662,88287,1205,2105535,17457
2020-12-10,Pennsylvania,42,463175,12021,12066,227,3450796,32885,457289,11972,2993507,20913
2020-12-10,Puerto Rico,72,93073,496,1238,19,365430,496,59458,496,305972,0
2020-12-10,Rhode Island,44,69247,948,1498,14,568204,2175,69247,948,498957,1227
2020-12-10,South Carolina,45,241686,2242,4627,15,2614236,17455,241686,2242,2372550,15213
2020-12-10,South Dakota,46,88727,704,1177,30,346200,1728,88727,704,257473,1024
2020-12-10,Tennessee,47,418902,5859,5183,70,4841914,31676,428973,6011,4412941,25665
2020-12-10,Texas,48,1403687,13143,23967,240,12076734,38849,1433551,15299,10643183,23550
2020-12-10,Utah,49,225946,3401,1016,21,1427973,10080,225946,3401,1202027,6679
2020-12-10,Vermont,50,5413,128,89,3,238653,2025,5413,128,233240,1897
2020-12-10,Virgin Islands,78,1733,35,23,0,30480,276,1733,35,28747,241
2020-12-10,Virginia,51,271043,3915,4335,54,3636064,28577,271043,3915,3365021,24662
2020-12-10,Washington,53,201179,3206,3075,-71,3239834,28819,204269,2977,3035565,25842
2020-12-10,West Virginia,54,59695,1233,921,20,1275008,15177,59695,1233,1215313,13944
2020-12-10,Wisconsin,55,456889,4709,4216,67,2681467,13230,456889,4709,2224578,8521
2020-12-10,Wyoming,56,38223,338,299,0,186885,1466,38223,338,148662,1128
2020-12-11,Alabama,01,288775,3853,4086,52,1747335,13043,288775,3853,1458560,9190
2020-12-11,Alaska,02,39773,627,151,3,1123545,10185,38584,622,1084961,9563
2020-12-11,Arizona,04,398150,8103,7250,77,2475382,23571,394512,6983,2080870,16588
2020-12-11,Arkansas,05,181624,2770,2875,55,1853792,16013,181624,2770,1672168,13243
2020-12-11,California,06,1528177,37124,20854,218,26572343,248011,1485703,35468,25086640,212543
2020-12-11,Colorado,08,283571,4655,3858,63,1940699,14404,281673,4678,1659026,9726
2020-12-11,Connecticut,09,146761,3782,5363,36,3695091,54546,146761,3782,3548330,50764
2020-12-11,Delaware,10,43818,782,807,1,456379,2942,43818,782,412561,2160
2020-12-11,District of Columbia,11,24357,259,709,1,762746,4913,24357,259,738389,4654
2020-12-11,Florida,12,1106388,11699,19713,123,7786912,55177,1087956,11409,6698956,43768
2020-12-11,Georgia,13,512715,5913,9738,55,4657199,35358,466904,4729,4190295,30629
2020-12-11,Guam,66,8048,27,116,0,90109,415,7079,27,83030,388
2020-12-11,Hawaii,15,19029,128,267,1,19315,136,19315,136,,0
2020-12-11,Idaho,16,119934,1582,1169,24,518245,3754,118028,1825,400217,1929
2020-12-11,Illinois,17,834668,9532,15076,224,11586296,104448,832951,9420,10753345,95028
2020-12-11,Indiana,18,414961,7206,6673,70,2387500,18319,412135,7200,1975365,11119
2020-12-11,Iowa,19,253612,2585,3193,77,1115807,3867,219914,1537,895893,2330
2020-12-11,Kansas,20,188610,4860,2072,131,890717,14665,185294,5491,705423,9174
2020-12-11,Kentucky,21,220898,3786,2416,29,2895500,17099,217120,3670,2678380,13429
2020-12-11,Louisiana,22,264191,2862,6767,43,3739272,34407,264191,2862,3475081,31545
2020-12-11,Maine,23,15206,345,250,4,971996,10436,15206,345,956790,10091
2020-12-11,Maryland,24,228792,2619,5064,52,2527160,16954,228471,2616,2298689,14338
2020-12-11,Massachusetts,25,280436,5655,11257,48,3616768,26600,280436,5655,3336332,20945
2020-12-11,Michigan,26,459811,5631,10961,66,7285348,58349,460346,5626,6825002,52723
2020-12-11,Minnesota,27,371027,3750,4351,94,2736162,18322,370968,3750,2365194,14572
2020-12-11,Mississippi,28,175282,2327,4124,41,1201582,2327,175282,2327,1026300,0
2020-12-11,Missouri,29,355147,2065,4704,14,1908211,9458,338604,3900,1569607,5558
2020-12-11,Montana,30,71931,977,805,19,711734,9209,71870,978,639864,8231
2020-12-11,Nebraska,31,147037,1218,1363,15,789093,5396,145774,1850,643319,3546
2020-12-11,Nevada,32,181922,2513,2488,40,1048852,3006,181310,2783,867542,223
2020-12-11,New Hampshire,33,29460,1187,590,6,464907,4839,29460,1187,435447,3652
2020-12-11,New Jersey,34,392124,3650,17662,54,6624624,49942,427868,4335,6196756,45607
2020-12-11,New Mexico,35,116565,1834,1889,43,1707040,14364,116565,1834,1590475,12530
2020-12-11,New York,36,759765,10561,34983,99,21514118,212672,753837,10595,20760281,202077
2020-12-11,North Carolina,37,424991,7040,5791,39,5879122,100664,423623,7540,5455499,93124
2020-12-11,North Dakota,38,87220,507,1136,27,363971,1234,87214,507,276757,727
2020-12-11,Northern Mariana Islands,69,113,0,2,0,17319,0,113,0,17206,0
2020-12-11,Ohio,39,542209,10359,7426,128,6772307,65593,542209,10359,6230098,55234
2020-12-11,Oklahoma,40,229353,3900,2007,27,2320719,23098,229353,3900,2091366,19198
2020-12-11,Oregon,41,91434,1596,1147,23,2216527,22705,89838,1551,2126689,21154
2020-12-11,Pennsylvania,42,475844,12669,12298,232,3479544,28748,470034,12745,3009510,16003
2020-12-11,Puerto Rico,72,94617,1544,1249,11,366974,1544,61002,1544,305972,0
2020-12-11,Rhode Island,44,70818,1571,1509,11,573689,5485,70818,1571,502871,3914
2020-12-11,South Carolina,45,245226,3540,4673,46,2651756,37520,245226,3540,2406530,33980
2020-12-11,South Dakota,46,89672,945,1210,33,348369,2169,89672,945,258697,1224
2020-12-11,Tennessee,47,425954,7052,5271,88,4896753,54839,436262,7289,4460491,47550
2020-12-11,Texas,48,1461943,58256,24208,241,12086122,9388,1448002,14451,10638120,-5063
2020-12-11,Utah,49,228146,2200,1027,11,1436053,8080,228129,2183,1207924,5897
2020-12-11,Vermont,50,5541,128,93,4,240617,1964,5541,128,235076,1836
2020-12-11,Virgin Islands,78,1791,58,23,0,30480,0,1733,0,28747,0
2020-12-11,Virginia,51,274438,3395,4370,35,3670649,34585,274438,3395,3396211,31190
2020-12-11,Washington,53,204484,3305,3097,22,3271251,31417,206826,2557,3064425,28860
2020-12-11,West Virginia,54,60637,942,938,17,1293240,18232,60637,942,1232603,17290
2020-12-11,Wisconsin,55,461367,4478,4272,56,2693132,11665,461367,4478,2231765,7187
2020-12-11,Wyoming,56,38785,562,321,22,188321,1436,38785,562,149536,874
2020-12-12,Alabama,01,292841,4066,4102,16,1751401,4066,292841,4066,1458560,0
2020-12-12,Alaska,02,40293,520,169,18,1133418,9873,39101,517,1094317,9356
2020-12-12,Arizona,04,405656,7506,7340,90,2501754,26372,402589,8077,2099165,18295
2020-12-12,Arkansas,05,184252,2628,2911,36,1869408,15616,184252,2628,1685156,12988
2020-12-12,California,06,1554863,26686,20958,104,26886130,313787,1521432,35729,25364698,278058
2020-12-12,Colorado,08,287364,3793,3916,58,1955626,14927,285634,3961,1669992,10966
2020-12-12,Connecticut,09,146761,0,5363,0,3695091,0,146761,0,3548330,0
2020-12-12,Delaware,10,44876,1058,815,8,460700,4321,44876,1058,415824,3263
2020-12-12,District of Columbia,11,24643,286,713,4,770914,8168,24643,286,746271,7882
2020-12-12,Florida,12,1116965,10577,19784,71,7839137,52225,1098341,10385,6740796,41840
2020-12-12,Georgia,13,518973,6258,9779,41,4696707,39508,471734,4830,4224973,34678
2020-12-12,Guam,66,8059,11,118,2,90120,11,7090,11,83030,0
2020-12-12,Hawaii,15,19225,196,269,2,19512,197,19512,197,,0
2020-12-12,Idaho,16,120703,769,1173,4,521598,3353,119610,1582,401988,1771
2020-12-12,Illinois,17,843328,8660,15232,156,11713184,126888,841688,8737,10871496,118151
2020-12-12,Indiana,18,422368,7407,6758,85,2406388,18888,419536,7401,1986852,11487
2020-12-12,Iowa,19,255009,1397,3208,15,1119355,3548,221159,1245,898196,2303
2020-12-12,Kansas,20,188610,0,2072,0,890717,0,185294,0,705423,0
2020-12-12,Kentucky,21,224155,3257,2446,30,2914184,18684,220660,3540,2693524,15144
2020-12-12,Louisiana,22,264191,0,6767,0,3739272,0,264191,0,3475081,0
2020-12-12,Maine,23,15620,414,257,7,972410,414,15620,414,956790,0
2020-12-12,Maryland,24,232172,3380,5100,36,2547454,20294,232009,3538,2315445,16756
2020-12-12,Massachusetts,25,285725,5289,11307,50,3640748,23980,285725,5289,3355023,18691
2020-12-12,Michigan,26,464368,4557,11186,225,7341990,56642,465159,4813,6876831,51829
2020-12-12,Minnesota,27,375457,4430,4418,67,2753902,17740,375398,4430,2378504,13310
2020-12-12,Mississippi,28,177947,2665,4180,56,1204247,2665,177947,2665,1026300,0
2020-12-12,Missouri,29,360623,5476,4754,50,1917786,9575,342347,3743,1575439,5832
2020-12-12,Montana,30,72659,728,816,11,718502,6768,72644,774,645858,5994
2020-12-12,Nebraska,31,147792,755,1385,22,793417,4324,146877,1103,646540,3221
2020-12-12,Nevada,32,184527,2605,2530,42,1056620,7768,183951,2641,872669,5127
2020-12-12,New Hampshire,33,30244,784,600,10,468383,3476,30244,784,438139,2692
2020-12-12,New Jersey,34,398364,6240,17732,70,6631512,6888,434756,6888,6196756,0
2020-12-12,New Mexico,35,118358,1793,1913,24,1719109,12069,118358,1793,1600751,10276
2020-12-12,New York,36,770804,11039,35074,91,21757045,242927,764966,11129,20992079,231798
2020-12-12,North Carolina,37,430325,5334,5831,40,5936625,57503,429776,6153,5506849,51350
2020-12-12,North Dakota,38,87596,376,1158,22,365062,1091,87590,376,277472,715
2020-12-12,Northern Mariana Islands,69,113,0,2,0,17319,0,113,0,17206,0
2020-12-12,Ohio,39,553461,11252,7477,51,6840149,67842,553461,11252,6286688,56590
2020-12-12,Oklahoma,40,233336,3983,2042,35,2343815,23096,233336,3983,2110479,19113
2020-12-12,Oregon,41,92839,1405,1155,8,2242771,26244,91420,1582,2151351,24662
2020-12-12,Pennsylvania,42,485901,10057,12489,191,3506371,26827,481118,11084,3025253,15743
2020-12-12,Puerto Rico,72,95338,721,1266,17,367695,721,61723,721,305972,0
2020-12-12,Rhode Island,44,70818,0,1509,0,577857,4168,72649,1831,505208,2337
2020-12-12,South Carolina,45,248798,3572,4685,12,2655328,3572,248798,3572,2406530,0
2020-12-12,South Dakota,46,90407,735,1243,33,350215,1846,90407,735,259808,1111
2020-12-12,Tennessee,47,432246,6292,5344,73,4909997,13244,442953,6691,4467044,6553
2020-12-12,Texas,48,1473318,11375,24400,192,12089107,2985,1464362,16360,10624745,-13375
2020-12-12,Utah,49,231821,3675,1039,12,1446950,10897,231821,3692,1215129,7205
2020-12-12,Vermont,50,5626,85,95,2,241841,1224,5626,85,236215,1139
2020-12-12,Virgin Islands,78,1791,0,23,0,31253,773,1791,58,29462,715
2020-12-12,Virginia,51,278615,4177,4409,39,3707999,37350,278615,4177,3429384,33173
2020-12-12,Washington,53,207399,2915,3043,-54,3299629,28378,209247,2421,3090382,25957
2020-12-12,West Virginia,54,62151,1514,966,28,1309396,16156,62151,1514,1247245,14642
2020-12-12,Wisconsin,55,465991,4624,4329,57,2707339,14207,465991,4624,2241348,9583
2020-12-12,Wyoming,56,38907,122,321,0,188443,122,38907,122,149536,0
2020-12-13,Alabama,01,295631,2790,4102,0,1754191,2790,295631,2790,1458560,0
2020-12-13,Alaska,02,40934,641,169,0,1143098,9680,39738,637,1103360,9043
2020-12-13,Arizona,04,408646,2990,7357,17,2528147,26393,408442,5853,2119705,20540
2020-12-13,Arkansas,05,185702,1450,2945,34,1882283,12875,185702,1450,1696581,11425
2020-12-13,California,06,1590670,35807,21043,85,27195587,309457,1551766,30334,25643821,279123
2020-12-13,Colorado,08,289679,2315,3982,66,1967409,11783,288193,2559,1679216,9224
2020-12-13,Connecticut,09,146761,0,5363,0,3695091,0,146761,0,3548330,0
2020-12-13,Delaware,10,45460,584,816,1,463363,2663,45460,584,417903,2079
2020-12-13,District of Columbia,11,24874,231,715,2,778265,7351,24874,231,753391,7120
2020-12-13,Florida,12,1125923,8958,19865,81,7877488,38351,1107103,8762,6770385,29589
2020-12-13,Georgia,13,523580,4607,9781,2,4729534,32827,476044,4310,4253490,28517
2020-12-13,Guam,66,8075,16,119,1,90136,16,7106,16,83030,0
2020-12-13,Hawaii,15,19302,77,272,3,19599,87,19599,87,,0
2020-12-13,Idaho,16,121243,540,1179,6,523879,2281,120632,1022,403247,1259
2020-12-13,Illinois,17,850412,7084,15340,108,11776832,63648,848904,7216,10927928,56432
2020-12-13,Indiana,18,428275,5907,6805,47,2423719,17331,425434,5898,1998285,11433
2020-12-13,Iowa,19,256249,1240,3209,1,1122583,3228,222148,989,900435,2239
2020-12-13,Kansas,20,188660,50,2072,0,890717,0,185294,0,705423,0
2020-12-13,Kentucky,21,226604,2449,2453,7,2916628,2444,223104,2444,2693524,0
2020-12-13,Louisiana,22,268613,4422,6818,51,3794201,54929,268613,4422,3525588,50507
2020-12-13,Maine,23,15923,303,257,0,972713,303,15923,303,956790,0
2020-12-13,Maryland,24,234975,2803,5117,17,2565648,18194,234647,2638,2331001,15556
2020-12-13,Massachusetts,25,290578,4853,11349,42,3663352,22604,290578,4853,3372774,17751
2020-12-13,Michigan,26,464606,238,11186,0,7341990,0,465159,0,6876831,0
2020-12-13,Minnesota,27,378882,3425,4503,85,2769643,15741,378823,3425,2390820,12316
2020-12-13,Mississippi,28,179447,1500,4199,19,1205747,1500,179447,1500,1026300,0
2020-12-13,Missouri,29,363246,2623,4761,7,1925812,8026,345041,2694,1580771,5332
2020-12-13,Montana,30,73303,644,818,2,722308,3806,73303,659,649005,3147
2020-12-13,Nebraska,31,149044,1252,1389,4,795716,2299,147688,811,648028,1488
2020-12-13,Nevada,32,187502,2975,2545,15,1063513,6893,186833,2882,876680,4011
2020-12-13,New Hampshire,33,30956,712,603,3,471459,3076,30956,712,440503,2364
2020-12-13,New Jersey,34,402518,4154,17751,19,6636223,4711,439467,4711,6196756,0
2020-12-13,New Mexico,35,119800,1442,1957,44,1732004,12895,119800,1442,1612204,11453
2020-12-13,New York,36,780831,10027,35198,124,21962295,205250,775160,10194,21187135,195056
2020-12-13,North Carolina,37,436655,6330,5855,24,6000910,64285,436595,6819,5564315,57466
2020-12-13,North Dakota,38,87877,281,1158,0,365709,647,87871,281,277838,366
2020-12-13,Northern Mariana Islands,69,113,0,2,0,17319,0,113,0,17206,0
2020-12-13,Ohio,39,562727,9266,7492,15,6895762,55613,562727,9266,6333035,46347
2020-12-13,Oklahoma,40,237668,4332,2064,22,2348147,4332,237668,4332,2110479,0
2020-12-13,Oregon,41,93853,1014,1158,3,2244190,1419,92839,1419,2151351,0
2020-12-13,Pennsylvania,42,495906,10005,12613,124,3537125,30754,491802,10684,3045323,20070
2020-12-13,Puerto Rico,72,96046,708,1272,6,368403,708,62431,708,305972,0
2020-12-13,Rhode Island,44,70818,0,1509,0,581842,3985,73519,870,508323,3115
2020-12-13,South Carolina,45,252206,3408,4739,54,2719621,64293,252206,3408,2467415,60885
2020-12-13,South Dakota,46,91038,631,1259,16,351856,1641,91038,631,260818,1010
2020-12-13,Tennessee,47,442707,10461,5406,62,4994602,84605,454305,11352,4540297,73253
2020-12-13,Texas,48,1480047,6729,24501,101,12173510,84403,1472711,8349,10700799,76054
2020-12-13,Utah,49,233904,2083,1055,16,1455319,8369,233904,2083,1221415,6286
2020-12-13,Vermont,50,5753,127,95,0,243515,1674,5753,127,237762,1547
2020-12-13,Virgin Islands,78,1791,0,23,0,31253,0,1791,0,29462,0
2020-12-13,Virginia,51,281909,3294,4411,2,3740737,32738,281909,3294,3458828,29444
2020-12-13,Washington,53,209385,1986,3045,2,3331810,32181,211475,2228,3120335,29953
2020-12-13,West Virginia,54,63217,1066,968,2,1322664,13268,63217,1066,1259447,12202
2020-12-13,Wisconsin,55,468956,2965,4344,15,2719722,12383,468956,2965,2250766,9418
2020-12-13,Wyoming,56,39360,453,321,0,188896,453,39360,453,149536,0
2020-12-14,Alabama,01,297895,2264,4102,0,1776802,22611,297895,2264,1478907,20347
2020-12-14,Alaska,02,41363,429,169,0,1147560,4462,40160,422,1107400,4040
2020-12-14,Arizona,04,420459,11813,7358,1,2547176,19029,420248,11806,2126928,7223
2020-12-14,Arkansas,05,187057,1355,2990,45,1893350,11067,187507,1805,1705843,9262
2020-12-14,California,06,1620870,30200,21196,153,27552039,356452,1585044,33278,25966995,323174
2020-12-14,Colorado,08,291645,1966,4015,33,1980707,13298,291104,2911,1689603,10387
2020-12-14,Connecticut,09,153992,7231,5444,81,3814335,119244,153992,7231,3660343,112013
2020-12-14,Delaware,10,46457,997,816,0,467413,4050,46457,997,420956,3053
2020-12-14,District of Columbia,11,25038,164,716,1,782979,4714,25038,164,757941,4550
2020-12-14,Florida,12,1134375,8452,20002,137,7918013,40525,1115446,8343,6802567,32182
2020-12-14,Georgia,13,527157,3577,9803,22,4755530,25996,479340,3296,4276190,22700
2020-12-14,Guam,66,8106,31,120,1,91132,996,7137,31,83995,965
2020-12-14,Hawaii,15,19489,187,272,0,19788,189,19788,189,,0
2020-12-14,Idaho,16,122679,1436,1199,20,525660,1781,121179,547,404481,1234
2020-12-14,Illinois,17,857860,7448,15458,118,11869088,92256,856118,7214,11012970,85042
2020-12-14,Indiana,18,433242,4967,6840,35,2435885,12166,430401,4967,2005484,7199
2020-12-14,Iowa,19,256902,653,3269,60,1124774,2191,222785,637,901989,1554
2020-12-14,Kansas,20,193109,4449,2109,37,903732,13015,190018,4724,713714,8291
2020-12-14,Kentucky,21,228668,2064,2472,19,2956293,39665,224890,1786,2731403,37879
2020-12-14,Louisiana,22,269643,1030,6845,27,3804370,10169,269643,1030,3534727,9139
2020-12-14,Maine,23,16349,426,259,2,993373,20660,16349,426,977024,20234
2020-12-14,Maryland,24,237215,2240,5142,25,2580984,15336,236961,2314,2344023,13022
2020-12-14,Massachusetts,25,294231,3653,11388,39,3680609,17257,294231,3653,3386378,13604
2020-12-14,Michigan,26,472166,7560,11282,96,7430448,88458,472780,7621,6957668,80837
2020-12-14,Minnesota,27,381900,3018,4521,18,2785429,15786,381841,3018,2403588,12768
2020-12-14,Mississippi,28,181095,1648,4204,5,1260755,55008,181095,1648,1079660,53360
2020-12-14,Missouri,29,367510,4264,4787,26,1933243,7431,347603,2562,1585640,4869
2020-12-14,Montana,30,73356,53,818,0,722308,0,73303,0,649005,0
2020-12-14,Nebraska,31,149620,576,1432,43,798923,3207,148861,1173,650062,2034
2020-12-14,Nevada,32,189805,2303,2557,12,1070420,6907,189412,2579,881008,4328
2020-12-14,New Hampshire,33,31875,919,604,1,475567,4108,31875,919,443692,3189
2020-12-14,New Jersey,34,407316,4798,17775,24,6825991,189768,444804,5337,6381187,184431
2020-12-14,New Mexico,35,121299,1499,1978,21,1741401,9397,121299,1499,1620102,7898
2020-12-14,New York,36,789815,8984,35288,90,22122139,159844,784204,9044,21337935,150800
2020-12-14,North Carolina,37,441721,5066,5899,44,6046926,46016,441365,4770,5605561,41246
2020-12-14,North Dakota,38,88073,196,1163,5,366246,537,88067,196,278179,341
2020-12-14,Northern Mariana Islands,69,113,0,2,0,17319,0,113,0,17206,0
2020-12-14,Ohio,39,570602,7875,7551,59,6955181,59419,570602,7875,6384579,51544
2020-12-14,Oklahoma,40,239767,2099,2072,8,2350246,2099,239767,2099,2110479,0
2020-12-14,Oregon,41,95042,1189,1168,10,2245204,1014,93853,1014,2151351,0
2020-12-14,Pennsylvania,42,505422,9516,12668,55,3560453,23328,499764,7962,3060689,15366
2020-12-14,Puerto Rico,72,96600,554,1282,10,368957,554,62985,554,305972,0
2020-12-14,Rhode Island,44,74071,3253,1555,46,584367,2525,74071,552,510296,1973
2020-12-14,South Carolina,45,254776,2570,4751,12,2745200,25579,254776,2570,2490424,23009
2020-12-14,South Dakota,46,91354,316,1259,0,352547,691,91354,316,261193,375
2020-12-14,Tennessee,47,452476,9769,5484,78,5055140,60538,464264,9959,4590876,50579
2020-12-14,Texas,48,1493857,13810,24582,81,12308459,134949,1481612,8901,10826847,126048
2020-12-14,Utah,49,235872,1968,1065,10,1461066,5747,235872,1968,1225194,3779
2020-12-14,Vermont,50,5857,104,96,1,245350,1835,5857,104,239493,1731
2020-12-14,Virgin Islands,78,1807,16,23,0,31379,126,1807,16,29572,110
2020-12-14,Virginia,51,285149,3240,4414,3,3767596,26859,285149,3240,3482447,23619
2020-12-14,Washington,53,212342,2957,3084,39,3358725,26915,212885,1410,3145840,25505
2020-12-14,West Virginia,54,64394,1177,978,10,1331983,9319,64394,1177,1267589,8142
2020-12-14,Wisconsin,55,471285,2329,4359,15,2727279,7557,471285,2329,2255994,5228
2020-12-14,Wyoming,56,39775,415,321,0,191036,2140,39775,415,151261,1725
2020-12-15,Alabama,01,301533,3638,4124,22,1786715,9913,301533,3638,1485182,6275
2020-12-15,Alaska,02,41645,282,172,3,1157867,10307,40438,278,1117429,10029
2020-12-15,Arizona,04,427121,6662,7428,70,2561564,14388,424382,4134,2137182,10254
2020-12-15,Arkansas,05,189198,2141,3016,26,1902077,8727,189198,1691,1712879,7036
2020-12-15,California,06,1655086,34216,21483,287,27845066,293027,1617370,32326,26227696,260701
2020-12-15,Colorado,08,295558,3913,4131,116,1987721,7014,293382,2278,1694339,4736
2020-12-15,Connecticut,09,155462,1470,5466,22,3839064,24729,155462,1470,3683602,23259
2020-12-15,Delaware,10,47142,685,826,10,470171,2758,47142,685,423029,2073
2020-12-15,District of Columbia,11,25339,301,720,4,791984,9005,25339,301,766645,8704
2020-12-15,Florida,12,1143786,9411,20081,79,7961744,43731,1124742,9296,6837002,34435
2020-12-15,Georgia,13,534488,7331,9856,53,4794475,38945,484152,4812,4310323,34133
2020-12-15,Guam,66,8118,12,120,0,91609,477,7149,12,84460,465
2020-12-15,Hawaii,15,19541,52,272,0,19844,56,19844,56,,0
2020-12-15,Idaho,16,124286,1607,1219,20,527256,1596,122217,1038,405039,558
2020-12-15,Illinois,17,865261,7401,15591,133,11962010,92922,863477,7359,11098533,85563
2020-12-15,Indiana,18,437513,4271,6968,128,2446551,10666,434642,4241,2011909,6425
2020-12-15,Iowa,19,258253,1351,3337,68,1127084,2310,223511,726,903573,1584
2020-12-15,Kansas,20,193555,446,2109,0,903732,0,190018,0,713714,0
2020-12-15,Kentucky,21,231287,2619,2499,27,2967046,10753,227818,2928,2739228,7825
2020-12-15,Louisiana,22,272276,2633,6895,50,3838249,33879,272276,2633,3565973,31246
2020-12-15,Maine,23,16760,411,265,6,999291,5918,16760,411,982531,5507
2020-12-15,Maryland,24,239694,2479,5206,64,2593877,12893,239362,2401,2354515,10492
2020-12-15,Massachusetts,25,298160,3929,11443,55,3700153,19544,298160,3929,3401993,15615
2020-12-15,Michigan,26,477613,5447,11488,206,7480152,49704,478171,5391,7001981,44313
2020-12-15,Minnesota,27,384223,2323,4542,21,2797923,12494,384164,2323,2413759,10171
2020-12-15,Mississippi,28,183300,2205,4252,48,1262960,2205,183300,2205,1079660,0
2020-12-15,Missouri,29,370869,3359,4959,172,1940007,6764,350365,2762,1589642,4002
2020-12-15,Montana,30,74160,804,826,8,732739,10431,74040,737,658699,9694
2020-12-15,Nebraska,31,151228,1608,1454,22,800242,1319,149344,483,650898,836
2020-12-15,Nevada,32,192109,2304,2609,52,1078605,8185,191732,2320,886873,5865
2020-12-15,New Hampshire,33,32545,670,604,0,478324,2757,32545,670,445779,2087
2020-12-15,New Jersey,34,411282,3966,17872,97,6910414,84423,449505,4701,6460909,79722
2020-12-15,New Mexico,35,122557,1258,2006,28,1755426,14025,122557,1258,1632869,12767
2020-12-15,New York,36,799551,9736,35425,137,22316327,194188,794557,10353,21521770,183835
2020-12-15,North Carolina,37,447303,5582,5926,27,6097725,50799,446601,5236,5651124,45563
2020-12-15,North Dakota,38,88401,328,1176,13,367013,767,88395,328,278618,439
2020-12-15,Northern Mariana Islands,69,113,0,2,0,17542,223,113,0,17429,223
2020-12-15,Ohio,39,579357,8755,7654,103,7002480,47299,579357,8755,6423123,38544
2020-12-15,Oklahoma,40,241991,2224,2086,14,2389948,39702,241991,2224,2147957,37478
2020-12-15,Oregon,41,96093,1051,1213,45,2304931,59727,95010,1157,2209921,58570
2020-12-15,Pennsylvania,42,515009,9587,12930,262,3581625,21172,509320,9556,3072305,11616
2020-12-15,Puerto Rico,72,97034,434,1294,12,369391,434,63419,434,305972,0
2020-12-15,Rhode Island,44,75237,1166,1570,15,588389,4022,75237,1166,513152,2856
2020-12-15,South Carolina,45,257320,2544,4756,5,2769559,24359,257320,2544,2512239,21815
2020-12-15,South Dakota,46,91699,345,1261,2,353282,735,91699,345,261583,390
2020-12-15,Tennessee,47,460454,7978,5557,73,5100997,45857,472875,8611,4628122,37246
2020-12-15,Texas,48,1513359,19502,24796,214,12431261,122802,1500538,18926,10930723,103876
2020-12-15,Utah,49,237787,1915,1078,13,1466514,5448,237787,1915,1228727,3533
2020-12-15,Vermont,50,5923,66,100,4,245602,252,5923,66,239679,186
2020-12-15,Virgin Islands,78,1828,21,23,0,31644,265,1828,21,29816,244
2020-12-15,Virginia,51,288309,3160,4470,56,3794025,26429,288309,3160,3505716,23269
2020-12-15,Washington,53,214085,1743,3123,39,3390084,31359,213537,652,3176547,30707
2020-12-15,West Virginia,54,65708,1314,1012,34,1341407,9424,65701,1307,1275706,8117
2020-12-15,Wisconsin,55,475340,4055,4412,53,2735132,7853,475340,4055,2259792,3798
2020-12-15,Wyoming,56,40064,289,328,7,191582,546,40064,289,151518,257
2020-12-16,Alabama,01,305640,4107,4198,74,1796919,10204,305640,4107,1491279,6097
2020-12-16,Alaska,02,42256,611,174,2,1166145,8278,41041,603,1125104,7675
2020-12-16,Arizona,04,431330,4209,7558,130,2577409,15845,429219,4837,2148190,11008
2020-12-16,Arkansas,05,191504,2306,3074,58,1914362,12285,191504,2306,1722858,9979
2020-12-16,California,06,1716027,60941,21881,398,28149590,304524,1671081,53711,26478509,250813
2020-12-16,Colorado,08,298492,2934,4192,61,1997929,10208,296716,3334,1701213,6874
2020-12-16,Connecticut,09,157781,2319,5506,40,3870391,31327,157781,2319,3712610,29008
2020-12-16,Delaware,10,47929,787,833,7,473493,3322,47929,787,425564,2535
2020-12-16,District of Columbia,11,25602,263,720,0,798388,6404,25602,263,772786,6141
2020-12-16,Florida,12,1155327,11541,20203,122,8012061,50317,1136024,11282,6876037,39035
2020-12-16,Georgia,13,541086,6598,9913,57,4817908,23433,488338,4186,4329570,19247
2020-12-16,Guam,66,8137,19,120,0,91915,306,7168,19,84747,287
2020-12-16,Hawaii,15,19645,104,276,4,19954,110,19954,110,,0
2020-12-16,Idaho,16,125834,1548,1247,28,531823,4567,124019,1802,407804,2765
2020-12-16,Illinois,17,872294,7033,15780,189,12055288,93278,870600,7123,11184688,86155
2020-12-16,Indiana,18,443734,6221,7101,133,2461562,15011,440850,6208,2020712,8803
2020-12-16,Iowa,19,260784,2531,3354,17,1131182,4098,225050,1539,906132,2559
2020-12-16,Kansas,20,197903,4348,2253,144,918265,14533,194569,4551,723696,9982
2020-12-16,Kentucky,21,234207,2920,2529,30,2983093,16047,230693,2875,2752400,13172
2020-12-16,Louisiana,22,275545,3269,6933,38,3863633,25384,275545,3269,3588088,22115
2020-12-16,Maine,23,17311,551,267,2,1008178,8887,17311,551,990867,8336
2020-12-16,Maryland,24,242057,2363,5270,64,2607611,13734,241767,2405,2365844,11329
2020-12-16,Massachusetts,25,304112,5952,11513,70,3728879,28726,304112,5952,3424767,22774
2020-12-16,Michigan,26,482217,4604,11582,94,7534591,54439,482815,4644,7051776,49795
2020-12-16,Minnesota,27,386471,2248,4634,92,2804803,6880,386412,2248,2418391,4632
2020-12-16,Mississippi,28,185643,2343,4294,42,1265303,2343,185643,2343,1079660,0
2020-12-16,Missouri,29,374010,3141,5043,84,1946697,6690,353038,2673,1593659,4017
2020-12-16,Montana,30,74764,604,836,10,736059,3320,74644,604,661415,2716
2020-12-16,Nebraska,31,152562,1334,1462,8,804015,3773,150861,1517,653154,2256
2020-12-16,Nevada,32,194461,2352,2659,50,1084570,5965,194098,2366,890472,3599
2020-12-16,New Hampshire,33,33433,888,625,21,481011,2687,33433,888,447578,1799
2020-12-16,New Jersey,34,416983,5701,18003,131,6986351,75937,455811,6306,6530540,69631
2020-12-16,New Mexico,35,124357,1800,2049,43,1767408,11982,124357,1800,1643051,10182
2020-12-16,New York,36,808929,9378,35522,97,22477274,160947,804555,9998,21672719,150949
2020-12-16,North Carolina,37,453628,6325,6030,104,6138845,41120,451874,5273,5686971,35847
2020-12-16,North Dakota,38,88692,291,1201,25,367830,817,88686,291,279144,526
2020-12-16,Northern Mariana Islands,69,113,0,2,0,17542,0,113,0,17429,0
2020-12-16,Ohio,39,584766,5409,7777,123,7040469,37989,584766,5409,6455703,32580
2020-12-16,Oklahoma,40,245229,3238,2128,42,2403866,13918,245229,3238,2158637,10680
2020-12-16,Oregon,41,97625,1532,1267,54,2343728,38797,96092,1082,2247636,37715
2020-12-16,Pennsylvania,42,525199,10190,13200,270,3605428,23803,519369,10049,3086059,13754
2020-12-16,Puerto Rico,72,97301,267,1312,18,369658,267,63686,267,305972,0
2020-12-16,Rhode Island,44,76209,972,1590,20,591698,3309,76209,972,515489,2337
2020-12-16,South Carolina,45,260119,2799,4800,44,2791674,22115,260119,2799,2531555,19316
2020-12-16,South Dakota,46,92604,905,1300,39,355614,2332,92603,904,263011,1428
2020-12-16,Tennessee,47,471348,10894,5610,53,5161287,60290,484285,11410,4677002,48880
2020-12-16,Texas,48,1535323,21964,25078,282,12511684,80423,1519340,18802,10992344,61621
2020-12-16,Utah,49,240715,2928,1102,24,1475127,8613,240715,2928,1234412,5685
2020-12-16,Vermont,50,6009,86,105,5,246178,576,6009,86,240169,490
2020-12-16,Virgin Islands,78,1828,0,23,0,31644,0,1828,0,29816,0
2020-12-16,Virginia,51,292240,3931,4508,38,3820372,26347,292240,3931,3528132,22416
2020-12-16,Washington,53,215310,1225,3139,16,3420811,30727,214204,667,3206607,30060
2020-12-16,West Virginia,54,66849,1141,1039,27,1350414,9007,66849,1148,1283565,7859
2020-12-16,Wisconsin,55,478162,2822,4499,87,2744803,9671,478162,2822,2266641,6849
2020-12-16,Wyoming,56,40310,246,328,0,192533,951,40310,246,152223,705
2020-12-17,Alabama,01,310335,4695,4254,56,1809684,12765,310335,4695,1499349,8070
2020-12-17,Alaska,02,42639,383,176,2,1175723,9578,41418,377,1134305,9201
2020-12-17,Arizona,04,438514,7184,7711,153,2600940,23531,435036,5817,2165904,17714
2020-12-17,Arkansas,05,194543,3039,3112,38,1928805,14443,194543,3039,1734262,11404
2020-12-17,California,06,1761341,45314,22155,274,28456358,306768,1723362,52281,26732996,254487
2020-12-17,Colorado,08,302086,3594,4265,73,2010785,12856,300414,3698,1710371,9158
2020-12-17,Connecticut,09,160102,2321,5552,46,3906494,36103,160102,2321,3746392,33782
2020-12-17,Delaware,10,48768,839,845,12,476675,3182,48768,839,427907,2343
2020-12-17,District of Columbia,11,25830,228,725,5,804207,5819,25830,228,778377,5591
2020-12-17,Florida,12,1168475,13148,20304,101,8071957,59896,1149126,13102,6922831,46794
2020-12-17,Georgia,13,548646,7560,9974,61,4856170,38262,494173,5835,4361997,32427
2020-12-17,Guam,66,8152,15,120,0,92352,437,7183,15,85169,422
2020-12-17,Hawaii,15,19781,136,278,2,20095,141,20095,141,,0
2020-12-17,Idaho,16,127224,1390,1266,19,535499,3676,125452,1433,410047,2243
2020-12-17,Illinois,17,881229,8935,15987,207,12147303,92015,879428,8828,11267875,83187
2020-12-17,Indiana,18,450074,6340,7180,79,2477734,16172,447190,6340,2030544,9832
2020-12-17,Iowa,19,262210,1426,3451,97,1135722,4540,226465,1415,909257,3125
2020-12-17,Kansas,20,198189,286,2253,0,918265,0,194569,0,723696,0
2020-12-17,Kentucky,21,237160,2953,2575,46,3012588,29495,234021,3328,2778567,26167
2020-12-17,Louisiana,22,279321,3776,6964,31,3896824,33191,279321,3776,3617503,29415
2020-12-17,Maine,23,17901,590,276,9,1016341,8163,17901,590,998440,7573
2020-12-17,Maryland,24,244247,2190,5319,49,2618526,10915,243984,2217,2374542,8698
2020-12-17,Massachusetts,25,309247,5135,11558,45,3753135,24256,309247,5135,3443888,19121
2020-12-17,Michigan,26,486831,4614,11793,211,7587661,53070,487356,4541,7100305,48529
2020-12-17,Minnesota,27,389230,2759,4717,83,2819859,15056,389171,2759,2430688,12297
2020-12-17,Mississippi,28,187904,2261,4320,26,1267564,2261,187904,2261,1079660,0
2020-12-17,Missouri,29,378014,4004,5101,58,1957194,10497,356607,3569,1600587,6928
2020-12-17,Montana,30,75545,781,849,13,742540,6481,75483,839,667057,5642
2020-12-17,Nebraska,31,153761,1199,1472,10,807647,3632,152103,1242,655544,2390
2020-12-17,Nevada,32,197059,2598,2680,21,1090377,5807,196379,2281,893998,3526
2020-12-17,New Hampshire,33,34264,831,629,4,484016,3005,34264,831,449752,2174
2020-12-17,New Jersey,34,421238,4255,18080,77,6991262,4911,460722,4911,6530540,0
2020-12-17,New Mexico,35,126045,1688,2103,54,1796603,29195,126045,1688,1670558,27507
2020-12-17,New York,36,819427,10498,35647,125,22680046,202772,815469,10914,21864577,191858
2020-12-17,North Carolina,37,458739,5111,6120,90,6183484,44639,457660,5786,5725824,38853
2020-12-17,North Dakota,38,89069,377,1210,9,368951,1121,89063,377,279888,744
2020-12-17,Northern Mariana Islands,69,113,0,2,0,17542,0,113,0,17429,0
2020-12-17,Ohio,39,596178,11412,7894,117,7107765,67296,596178,11412,6511587,55884
2020-12-17,Oklahoma,40,248204,2975,2144,16,2406841,2975,248204,2975,2158637,0
2020-12-17,Oregon,41,98937,1312,1284,17,2368409,24681,97622,1530,2270787,23151
2020-12-17,Pennsylvania,42,535231,10032,13442,242,3631099,25671,529335,9966,3101764,15705
2020-12-17,Puerto Rico,72,98366,1065,1323,11,370723,1065,64751,1065,305972,0
2020-12-17,Rhode Island,44,77290,1081,1602,12,595944,4246,77290,1081,518654,3165
2020-12-17,South Carolina,45,262774,2655,4843,43,2808022,16348,262774,2655,2545248,13693
2020-12-17,South Dakota,46,93197,593,1301,1,356916,1302,93197,594,263719,708
2020-12-17,Tennessee,47,480225,8877,5783,173,5196858,35571,493230,8945,4703628,26626
2020-12-17,Texas,48,1552549,17226,25336,258,12611978,100294,1539189,19849,11072789,80445
2020-12-17,Utah,49,243918,3203,1126,24,1484987,9860,243918,3203,1241069,6657
2020-12-17,Vermont,50,6149,140,105,0,247457,1279,6149,140,241308,1139
2020-12-17,Virgin Islands,78,1878,50,23,0,32463,819,1878,50,30585,769
2020-12-17,Virginia,51,296093,3853,4553,45,3852161,31789,296093,3853,3556068,27936
2020-12-17,Washington,53,220628,5318,3170,31,3440563,19752,214265,61,3226298,19691
2020-12-17,West Virginia,54,68485,1636,1071,32,1364955,14541,68485,1636,1296470,12905
2020-12-17,Wisconsin,55,482443,4281,4566,67,2756379,11576,482443,4281,2273936,7295
2020-12-17,Wyoming,56,40593,283,351,23,193719,1186,40593,283,153126,903
2020-12-18,Alabama,01,315683,5348,4296,42,1822887,13203,315683,5348,1507204,7855
2020-12-18,Alaska,02,43132,493,176,0,1184922,9199,41905,487,1143017,8712
2020-12-18,Arizona,04,444038,5524,7819,108,2623864,22924,442671,7635,2181193,15289
2020-12-18,Arkansas,05,197421,2878,3139,27,1943435,14630,197421,2878,1746014,11752
2020-12-18,California,06,1809585,48244,22496,341,28741027,284669,1764374,41012,26976653,243657
2020-12-18,Colorado,08,305622,3536,4323,58,2025063,14278,304107,3693,1720956,10585
2020-12-18,Connecticut,09,162782,2680,5581,29,3945648,39154,162782,2680,3782866,36474
2020-12-18,Delaware,10,49109,341,854,9,478106,1431,49109,341,428997,1090
2020-12-18,District of Columbia,11,26104,274,728,3,812902,8695,26104,274,786798,8421
2020-12-18,Florida,12,1181475,13000,20400,96,8128430,56473,1161953,12827,6966477,43646
2020-12-18,Georgia,13,556615,7969,10009,35,4904046,47876,500265,6092,4403781,41784
2020-12-18,Guam,66,8162,10,120,0,92741,389,7193,10,85548,379
2020-12-18,Hawaii,15,19937,156,279,1,20257,162,20257,162,,0
2020-12-18,Idaho,16,128498,1274,1280,14,540105,4606,126878,1426,413227,3180
2020-12-18,Illinois,17,888478,7249,16206,219,12259595,112292,886805,7377,11372790,104915
2020-12-18,Indiana,18,456028,5954,7265,85,2492370,14636,453139,5949,2039231,8687
2020-12-18,Iowa,19,264729,2519,3451,0,1139593,3871,227989,1524,911604,2347
2020-12-18,Kansas,20,203646,5457,2341,88,930806,12541,200426,5857,730380,6684
2020-12-18,Kentucky,21,240345,3185,2618,43,3033321,20733,237190,3169,2796131,17564
2020-12-18,Louisiana,22,282434,3113,6994,30,3925514,28690,282434,3113,3643080,25577
2020-12-18,Maine,23,18337,436,281,5,1025640,9299,18337,436,1007303,8863
2020-12-18,Maryland,24,246816,2569,5358,39,2633730,15204,246553,2569,2387177,12635
2020-12-18,Massachusetts,25,314926,5679,11610,52,3785110,31975,314926,5679,3470184,26296
2020-12-18,Michigan,26,491339,4508,11861,68,7638468,50807,491875,4519,7146593,46288
2020-12-18,Minnesota,27,391948,2718,4782,65,2838115,18256,391889,2718,2446226,15538
2020-12-18,Mississippi,28,190411,2507,4354,34,1270071,2507,190411,2507,1079660,0
2020-12-18,Missouri,29,382181,4167,5170,69,1967696,10502,360330,3723,1607366,6779
2020-12-18,Montana,30,76056,511,855,6,747802,5262,75992,509,671810,4753
2020-12-18,Nebraska,31,155068,1307,1490,18,811473,3826,153400,1297,658073,2529
2020-12-18,Nevada,32,200032,2973,2728,48,1096842,6465,199257,2878,897585,3587
2020-12-18,New Hampshire,33,34960,696,638,9,487802,3786,34960,696,452842,3090
2020-12-18,New Jersey,34,425134,3896,18124,44,7137646,146384,465167,4445,6672479,141939
2020-12-18,New Mexico,35,127500,1455,2128,25,1809293,12690,127500,1455,1681793,11235
2020-12-18,New York,36,832033,12606,35775,128,22929431,249385,828166,12697,22101265,236688
2020-12-18,North Carolina,37,468195,9456,6172,52,6266727,83243,466104,8444,5800623,74799
2020-12-18,North Dakota,38,89563,494,1231,21,370422,1471,89557,494,280865,977
2020-12-18,Northern Mariana Islands,69,115,2,2,0,17544,2,115,2,17429,0
2020-12-18,Ohio,39,605862,9684,7967,73,7177064,69299,605862,9684,6571202,59615
2020-12-18,Oklahoma,40,251760,3556,2161,17,2443847,37006,251760,3556,2192087,33450
2020-12-18,Oregon,41,100309,1372,1306,22,2392813,24404,98936,1314,2293877,23090
2020-12-18,Pennsylvania,42,544417,9186,13664,222,3657529,26430,538655,9320,3118874,17110
2020-12-18,Puerto Rico,72,99747,1381,1333,10,372104,1381,66132,1381,305972,0
2020-12-18,Rhode Island,44,77812,522,1625,23,597623,1679,77812,522,519811,1157
2020-12-18,South Carolina,45,267076,4302,4872,29,2844895,36873,267076,4302,2577819,32571
2020-12-18,South Dakota,46,93772,575,1330,29,358566,1650,93772,575,264794,1075
2020-12-18,Tennessee,47,490304,10079,5897,114,5263516,66658,503651,10421,4759865,56237
2020-12-18,Texas,48,1571925,19376,25608,272,12703849,91871,1555981,16792,11147868,75079
2020-12-18,Utah,49,246562,2644,1140,14,1493137,8150,246562,2644,1246575,5506
2020-12-18,Vermont,50,6243,94,107,2,249140,1683,6243,94,242897,1589
2020-12-18,Virgin Islands,78,1900,22,23,0,32808,345,1900,22,30908,323
2020-12-18,Virginia,51,299388,3295,4598,45,3874072,21911,299388,3295,3574684,18616
2020-12-18,Washington,53,224594,3966,3168,-2,3443503,2940,217205,2940,3226298,0
2020-12-18,West Virginia,54,69751,1266,1091,20,1377072,12117,69751,1266,1307321,10851
2020-12-18,Wisconsin,55,486364,3921,4635,69,2767494,11115,486364,3921,2281130,7194
2020-12-18,Wyoming,56,41359,766,351,0,194864,1145,41359,766,153505,379
2020-12-19,Alabama,01,319904,4221,4389,93,1834831,11944,319904,4221,1514927,7723
2020-12-19,Alaska,02,43468,336,177,1,1193118,8196,42235,330,1150883,7866
2020-12-19,Arizona,04,450807,6769,7956,137,2644809,20945,448231,5560,2196578,15385
2020-12-19,Arkansas,05,200114,2693,3191,52,1958098,14663,200114,2693,1757984,11970
2020-12-19,California,06,1846943,37358,22651,155,29112249,371222,1807982,43608,27304267,327614
2020-12-19,Colorado,08,308350,2728,4400,77,2035008,9945,306598,2491,1728410,7454
2020-12-19,Connecticut,09,162782,0,5581,0,3945648,0,162782,0,3782866,0
2020-12-19,Delaware,10,50136,1027,858,4,482025,3919,50136,1027,431889,2892
2020-12-19,District of Columbia,11,26342,238,730,2,820999,8097,26342,238,794657,7859
2020-12-19,Florida,12,1193157,11682,20472,72,8180515,52085,1173409,11456,7007106,40629
2020-12-19,Georgia,13,562479,5864,10054,45,4941049,37003,504501,4236,4436548,32767
2020-12-19,Guam,66,8167,5,120,0,92746,5,7198,5,85548,0
2020-12-19,Hawaii,15,20089,152,279,0,20413,156,20413,156,,0
2020-12-19,Idaho,16,129334,836,1280,0,543168,3063,128218,1340,414950,1723
2020-12-19,Illinois,17,896003,7525,16326,120,12356446,96851,894367,7562,11462079,89289
2020-12-19,Indiana,18,460766,4738,7338,73,2505094,12724,457871,4732,2047223,7992
2020-12-19,Iowa,19,266959,2230,3533,82,1143798,4205,229187,1198,914611,3007
2020-12-19,Kansas,20,203650,4,2341,0,930806,0,200426,0,730380,0
2020-12-19,Kentucky,21,243047,2702,2637,19,3049073,15752,240564,3374,2808509,12378
2020-12-19,Louisiana,22,282434,0,6994,0,3925514,0,282434,0,3643080,0
2020-12-19,Maine,23,18739,402,292,11,1026042,402,18739,402,1007303,0
2020-12-19,Maryland,24,248924,2108,5412,54,2645474,11744,248754,2201,2396720,9543
2020-12-19,Massachusetts,25,319270,4344,11657,47,3802761,17651,319270,4344,3483491,13307
2020-12-19,Michigan,26,495282,3943,12066,205,7699634,61166,496056,4181,7203578,56985
2020-12-19,Minnesota,27,394694,2746,4839,57,2848775,10660,394635,2746,2454140,7914
2020-12-19,Mississippi,28,192111,1700,4390,36,1271771,1700,192111,1700,1079660,0
2020-12-19,Missouri,29,384522,2341,5236,66,1974507,6811,363114,2784,1611393,4027
2020-12-19,Montana,30,76708,652,864,9,752243,4441,76619,627,675624,3814
2020-12-19,Nebraska,31,155765,697,1495,5,814808,3335,154745,1345,660063,1990
2020-12-19,Nevada,32,202164,2132,2754,26,1102203,5361,201858,2601,900345,2760
2020-12-19,New Hampshire,33,35609,649,650,12,491398,3596,35609,649,455789,2947
2020-12-19,New Jersey,34,429325,4191,18173,49,7142505,4859,470026,4859,6672479,0
2020-12-19,New Mexico,35,128930,1430,2155,27,1823169,13876,128930,1430,1694239,12446
2020-12-19,New York,36,841946,9913,35897,122,23120907,191476,838085,9919,22282822,181557
2020-12-19,North Carolina,37,473691,5496,6222,50,6342889,76162,472268,6164,5870621,69998
2020-12-19,North Dakota,38,89794,231,1237,6,371421,999,89788,231,281633,768
2020-12-19,Northern Mariana Islands,69,115,0,2,0,17544,0,115,0,17429,0
2020-12-19,Ohio,39,614429,8567,8031,64,7239882,62818,614429,8567,6625453,54251
2020-12-19,Oklahoma,40,255868,4108,2189,28,2454616,10769,255868,4108,2198748,6661
2020-12-19,Oregon,41,101814,1505,1340,34,2415804,22991,100308,1372,2315496,21619
2020-12-19,Pennsylvania,42,553424,9007,13869,205,3680120,22591,548489,9834,3131631,12757
2020-12-19,Puerto Rico,72,100826,1079,1342,9,373183,1079,67211,1079,305972,0
2020-12-19,Rhode Island,44,77812,0,1625,0,599766,2143,78783,971,520983,1172
2020-12-19,South Carolina,45,270537,3461,4895,23,2871621,26726,270537,3461,2601084,23265
2020-12-19,South Dakota,46,94336,564,1350,20,360182,1616,94336,564,265846,1052
2020-12-19,Tennessee,47,494497,4193,5953,56,5263516,0,503651,0,4759865,0
2020-12-19,Texas,48,1585338,13413,25841,233,12745117,41268,1573888,17907,11171229,23361
2020-12-19,Utah,49,248970,2408,1148,8,1500528,7391,248970,2408,1251558,4983
2020-12-19,Vermont,50,6343,100,108,1,250527,1387,6343,100,244184,1287
2020-12-19,Virgin Islands,78,1910,10,23,0,33172,364,1910,10,31262,354
2020-12-19,Virginia,51,302972,3584,4643,45,3932006,57934,302972,3584,3629034,54350
2020-12-19,Washington,53,226551,1957,3169,1,3486613,43110,220268,3063,3266345,40047
2020-12-19,West Virginia,54,71215,1464,1122,31,1390401,13329,71215,1464,1319186,11865
2020-12-19,Wisconsin,55,490679,4315,4724,89,2779010,11516,490679,4315,2288331,7201
2020-12-19,Wyoming,56,41488,129,351,0,194993,129,41488,129,153505,0
2020-12-20,Alabama,01,322452,2548,4389,0,1843744,8913,322452,2548,1521292,6365
2020-12-20,Alaska,02,43649,181,176,-1,1196506,3388,42413,178,1154093,3210
2020-12-20,Arizona,04,453601,2794,7971,15,2668236,23427,453597,5366,2214639,18061
2020-12-20,Arkansas,05,201650,1536,3237,46,1971287,13189,201650,1536,1769637,11653
2020-12-20,California,06,1889828,42885,22736,85,29465170,352921,1854456,46474,27610714,306447
2020-12-20,Colorado,08,310522,2172,4420,20,2047198,12190,308890,2292,1738308,9898
2020-12-20,Connecticut,09,162782,0,5581,0,3945648,0,162782,0,3782866,0
2020-12-20,Delaware,10,50616,480,862,4,484059,2034,50616,480,433443,1554
2020-12-20,District of Columbia,11,26601,259,737,7,829299,8300,26601,259,802698,8041
2020-12-20,Florida,12,1201558,8401,20567,95,8223154,42639,1181549,8140,7041605,34499
2020-12-20,Georgia,13,567654,5175,10056,2,4974164,33115,509588,5087,4464576,28028
2020-12-20,Guam,66,8171,4,120,0,92750,4,7202,4,85548,0
2020-12-20,Hawaii,15,20291,202,280,1,20615,202,20615,202,,0
2020-12-20,Idaho,16,130039,705,1284,4,546196,3028,129069,851,417127,2177
2020-12-20,Illinois,17,901924,5921,16407,81,12434525,78079,900370,6003,11534155,72076
2020-12-20,Indiana,18,467258,6492,7404,66,2523679,18585,464354,6483,2059325,12102
2020-12-20,Iowa,19,267329,370,3589,56,1147392,3594,230084,897,917308,2697
2020-12-20,Kansas,20,203674,24,2341,0,930806,0,200426,0,730380,0
2020-12-20,Kentucky,21,244784,1737,2665,28,3067977,18904,242321,1757,2825656,17147
2020-12-20,Louisiana,22,286145,3711,7042,48,3969384,43870,286145,3711,3683239,40159
2020-12-20,Maine,23,18946,207,292,0,1026249,207,18946,207,1007303,0
2020-12-20,Maryland,24,251069,2145,5448,36,2658591,13117,250808,2054,2407783,11063
2020-12-20,Massachusetts,25,323531,4261,11717,60,3823777,21016,323531,4261,3500246,16755
2020-12-20,Michigan,26,495458,176,12066,0,7699634,0,496056,0,7203578,0
2020-12-20,Minnesota,27,397378,2684,4909,70,2871269,22494,397319,2684,2473950,19810
2020-12-20,Mississippi,28,194333,2222,4409,19,1273993,2222,194333,2222,1079660,0
2020-12-20,Missouri,29,386259,1737,5262,26,1979966,5459,365186,2072,1614780,3387
2020-12-20,Montana,30,77170,462,865,1,755291,3048,77170,551,678121,2497
2020-12-20,Nebraska,31,156513,748,1505,10,816926,2118,155415,670,661511,1448
2020-12-20,Nevada,32,204227,2063,2786,32,1106466,4263,203945,2087,902521,2176
2020-12-20,New Hampshire,33,36542,933,656,6,493628,2230,36542,933,457086,1297
2020-12-20,New Jersey,34,434500,5175,18194,21,7148236,5731,475757,5731,6672479,0
2020-12-20,New Mexico,35,129993,1063,2171,16,1833325,10156,129993,1063,1703332,9093
2020-12-20,New York,36,851400,9454,36017,120,23318158,197251,848042,9957,22470116,187294
2020-12-20,North Carolina,37,479875,6184,6259,37,6409315,66426,479168,6900,5930147,59526
2020-12-20,North Dakota,38,90045,251,1237,0,372056,635,90039,251,282017,384
2020-12-20,Northern Mariana Islands,69,115,0,2,0,17544,0,115,0,17429,0
2020-12-20,Ohio,39,622806,8377,8047,16,7288797,48915,622806,8377,6665991,40538
2020-12-20,Oklahoma,40,260838,4970,2212,23,2459586,4970,260838,4970,2198748,0
2020-12-20,Oregon,41,102930,1116,1341,1,2417310,1506,101814,1506,2315496,0
2020-12-20,Pennsylvania,42,560002,6578,13964,95,3701258,21138,555702,7213,3145556,13925
2020-12-20,Puerto Rico,72,102048,1222,1368,26,374405,1222,68433,1222,305972,0
2020-12-20,Rhode Island,44,77812,0,1625,0,603904,4138,79812,1029,524092,3109
2020-12-20,South Carolina,45,273406,2869,4935,40,2897011,25390,273406,2869,2623605,22521
2020-12-20,South Dakota,46,94727,391,1361,11,361285,1103,94727,391,266558,712
2020-12-20,Tennessee,47,505880,11383,6007,54,5335981,72465,519687,16036,4816294,56429
2020-12-20,Texas,48,1593201,7863,25948,107,12857760,112643,1581668,7780,11276092,104863
2020-12-20,Utah,49,250964,1994,1155,7,1508398,7870,250964,1994,1257434,5876
2020-12-20,Vermont,50,6443,100,111,3,251915,1388,6443,100,245472,1288
2020-12-20,Virgin Islands,78,1921,11,23,0,33666,494,1921,11,31745,483
2020-12-20,Virginia,51,306848,3876,4650,7,3982227,50221,306848,3876,3675379,46345
2020-12-20,Washington,53,227049,498,3170,1,3511711,25098,222600,2332,3289111,22766
2020-12-20,West Virginia,54,72342,1127,1128,6,1398549,8148,72342,1127,1326207,7021
2020-12-20,Wisconsin,55,492724,2045,4745,21,2786922,7912,492724,2045,2294198,5867
2020-12-20,Wyoming,56,41662,174,351,0,195167,174,41662,174,153505,0
2020-12-21,Alabama,01,324832,2380,4389,0,1850342,6598,324832,2380,1525510,4218
2020-12-21,Alaska,02,43801,152,176,0,1200977,4471,42563,150,1158414,4321
2020-12-21,Arizona,04,461345,7744,7972,1,2685721,17485,461345,7748,2224376,9737
2020-12-21,Arkansas,05,203107,1457,3295,58,1980964,9677,203107,1457,1777857,8220
2020-12-21,California,06,1933083,43255,22980,244,29860404,395234,1892348,37892,27968056,357342
2020-12-21,Colorado,08,312713,2191,4432,12,2059740,12542,311036,2146,1748704,10396
2020-12-21,Connecticut,09,167377,4595,5676,95,4034669,89021,167377,4595,3867292,84426
2020-12-21,Delaware,10,51056,440,871,9,486104,2045,51056,440,435048,1605
2020-12-21,District of Columbia,11,26740,139,742,5,834138,4839,26740,139,807398,4700
2020-12-21,Florida,12,1212573,11015,20679,112,8275570,52416,1192456,10907,7083114,41509
2020-12-21,Georgia,13,571301,3647,10072,16,4999306,25142,512699,3111,4486607,22031
2020-12-21,Guam,66,8180,9,121,1,93567,817,7211,9,86356,808
2020-12-21,Hawaii,15,20423,132,280,0,20749,134,20749,134,,0
2020-12-21,Idaho,16,131468,1429,1305,21,547904,1708,129960,891,417944,817
2020-12-21,Illinois,17,906917,4993,16530,123,12520979,86454,905069,4699,11615910,81755
2020-12-21,Indiana,18,471124,3866,7438,34,2533672,9993,468219,3865,2065453,6128
2020-12-21,Iowa,19,268736,1407,3589,0,1149061,1669,230622,538,918439,1131
2020-12-21,Kansas,20,207933,4259,2448,107,946123,15317,204600,4174,741523,11143
2020-12-21,Kentucky,21,247243,2459,2701,36,3075233,7256,244297,1976,2830936,5280
2020-12-21,Louisiana,22,287261,1116,7107,65,3981309,11925,287261,1116,3694048,10809
2020-12-21,Maine,23,19285,339,293,1,1043633,17384,19285,339,1024348,17045
2020-12-21,Maryland,24,253345,2276,5471,23,2673490,14899,253073,2265,2420417,12634
2020-12-21,Massachusetts,25,327374,3843,11759,42,3842909,19132,327374,3843,3515535,15289
2020-12-21,Michigan,26,500461,5003,12146,80,7782176,82542,501115,5059,7281061,77483
2020-12-21,Minnesota,27,399370,1992,4931,22,2882526,11257,399311,1992,2483215,9265
2020-12-21,Mississippi,28,195500,1167,4411,2,1323158,49165,195500,1167,1127658,47998
2020-12-21,Missouri,29,390512,4253,5291,29,1988451,8485,368316,3130,1620135,5355
2020-12-21,Montana,30,77456,286,881,16,758979,3688,77324,154,681655,3534
2020-12-21,Nebraska,31,157418,905,1530,25,819700,2774,156382,967,663318,1807
2020-12-21,Nevada,32,206195,1968,2801,15,1113930,7464,205884,1939,908046,5525
2020-12-21,New Hampshire,33,37388,846,656,0,495964,2336,37388,846,458576,1490
2020-12-21,New Jersey,34,437671,3171,18223,29,7339203,190967,479443,3686,6859760,187281
2020-12-21,New Mexico,35,130808,815,2180,9,1841584,8259,130808,815,1710776,7444
2020-12-21,New York,36,860856,9456,36147,130,23474668,156510,857049,9007,22617619,147503
2020-12-21,North Carolina,37,484513,4638,6285,26,6456474,47159,483647,4479,5972827,42680
2020-12-21,North Dakota,38,90127,82,1239,2,372107,51,90121,82,281986,-31
2020-12-21,Northern Mariana Islands,69,116,1,2,0,17545,1,116,1,17429,0
2020-12-21,Ohio,39,629354,6548,8122,75,7330074,41277,629354,6548,6700720,34729
2020-12-21,Oklahoma,40,263434,2596,2218,6,2462182,2596,263434,2596,2198748,0
2020-12-21,Oregon,41,103880,950,1351,10,2418426,1116,102930,1116,2315496,0
2020-12-21,Pennsylvania,42,569413,9411,14021,57,3723664,22406,563589,7887,3160075,14519
2020-12-21,Puerto Rico,72,102464,416,1382,14,374821,416,68849,416,305972,0
2020-12-21,Rhode Island,44,80231,2419,1670,45,605972,2068,80231,419,525741,1649
2020-12-21,South Carolina,45,275733,2327,4962,27,2916627,19616,275733,2327,2640894,17289
2020-12-21,South Dakota,46,95074,347,1381,20,362320,1035,95074,347,267246,688
2020-12-21,Tennessee,47,515145,9265,6072,65,5396151,60170,529578,9891,4866573,50279
2020-12-21,Texas,48,1610141,16940,26164,216,13003964,146204,1591948,10280,11412016,135924
2020-12-21,Utah,49,252783,1819,1163,8,1514421,6023,252783,1819,1261638,4204
2020-12-21,Vermont,50,6534,91,111,0,253814,1899,6534,91,247280,1808
2020-12-21,Virgin Islands,78,1921,0,23,0,33666,0,1921,0,31745,0
2020-12-21,Virginia,51,310890,4042,4654,4,4020121,37894,310890,4042,3709231,33852
2020-12-21,Washington,53,230642,3593,3186,16,3511711,0,222600,0,3289111,0
2020-12-21,West Virginia,54,73337,995,1129,1,1409130,10581,73337,995,1335793,9586
2020-12-21,Wisconsin,55,494353,1629,4754,9,2793618,6696,494353,1629,2299265,5067
2020-12-21,Wyoming,56,42118,456,351,0,197061,1894,42118,456,154943,1438
2020-12-22,Alabama,01,329811,4979,4452,63,1862451,12109,329811,4979,1532640,7130
2020-12-22,Alaska,02,44241,440,186,10,1215282,14305,43001,438,1172281,13867
2020-12-22,Arizona,04,470351,9006,8133,161,2700966,15245,467215,5870,2233751,9375
2020-12-22,Arkansas,05,205048,1941,3338,43,1990244,9280,205048,1941,1785196,7339
2020-12-22,California,06,1968430,35347,23254,274,30190182,329778,1925007,32659,28265175,297119
2020-12-22,Colorado,08,315397,2684,4464,32,2069655,9915,313552,2516,1756103,7399
2020-12-22,Connecticut,09,168960,1583,5703,27,4058540,23871,168960,1583,3889580,22288
2020-12-22,Delaware,10,51623,567,872,1,488275,2171,51623,567,436652,1604
2020-12-22,District of Columbia,11,26900,160,744,2,840202,6064,26900,160,813302,5904
2020-12-22,Florida,12,1223007,10434,20753,74,8323626,48056,1202660,10204,7120966,37852
2020-12-22,Georgia,13,579957,8656,10135,63,5049355,50049,518902,6203,4530453,43846
2020-12-22,Guam,66,8180,0,121,0,94042,475,7238,27,86804,448
2020-12-22,Hawaii,15,20487,64,280,0,20815,66,20815,66,,0
2020-12-22,Idaho,16,132950,1482,1317,12,550270,2366,130877,917,419393,1449
2020-12-22,Illinois,17,913265,6348,16677,147,12605743,84764,911308,6239,11694435,78525
2020-12-22,Indiana,18,474797,3673,7581,143,2545018,11346,471876,3657,2073142,7689
2020-12-22,Iowa,19,270294,1558,3653,64,1150768,1707,231264,642,919504,1065
2020-12-22,Kansas,20,208109,176,2448,0,946123,0,204600,0,741523,0
2020-12-22,Kentucky,21,250089,2846,2739,38,3085474,10241,247344,3047,2838130,7194
2020-12-22,Louisiana,22,290960,3699,7158,51,4022758,41449,290960,3699,3731798,37750
2020-12-22,Maine,23,19743,458,303,10,1050559,6926,19743,458,1030816,6468
2020-12-22,Maryland,24,255666,2321,5519,48,2690750,17260,255397,2324,2435353,14936
2020-12-22,Massachusetts,25,331174,3800,11804,45,3861458,18549,331174,3800,3530284,14749
2020-12-22,Michigan,26,503980,3519,12333,187,7815998,33822,504629,3514,7311369,30308
2020-12-22,Minnesota,27,401070,1700,4955,24,2894108,11582,401011,1700,2493097,9882
2020-12-22,Mississippi,28,197691,2191,4490,79,1325349,2191,197691,2191,1127658,0
2020-12-22,Missouri,29,393488,2976,5474,183,1993848,5397,370439,2123,1623409,3274
2020-12-22,Montana,30,78017,561,901,20,762854,3875,77947,623,684907,3252
2020-12-22,Nebraska,31,158580,1162,1543,13,821785,2085,157103,721,664682,1364
2020-12-22,Nevada,32,207351,1156,2832,31,1117697,3767,206974,1090,910723,2677
2020-12-22,New Hampshire,33,38008,620,656,0,498342,2378,38008,620,460334,1758
2020-12-22,New Jersey,34,442274,4603,18326,103,7344469,5266,484709,5266,6859760,0
2020-12-22,New Mexico,35,132075,1267,2203,23,1851782,10198,132075,1267,1719707,8931
2020-12-22,New York,36,871155,10299,36300,153,23639536,164868,866765,9716,22772771,155152
2020-12-22,North Carolina,37,491242,6729,6342,57,6502673,46199,488902,5255,6013771,40944
2020-12-22,North Dakota,38,90459,332,1244,5,373428,1321,90453,332,282975,989
2020-12-22,Northern Mariana Islands,69,116,0,2,0,17545,0,116,0,17429,0
2020-12-22,Ohio,39,637032,7678,8252,130,7378957,48883,637032,7678,6741925,41205
2020-12-22,Oklahoma,40,265620,2186,2240,22,2516937,54755,265620,2186,2251317,52569
2020-12-22,Oregon,41,105091,1211,1382,31,2472444,54018,103755,825,2368689,53193
2020-12-22,Pennsylvania,42,577183,7770,14244,223,3740433,16769,571551,7962,3168882,8807
2020-12-22,Puerto Rico,72,103527,1063,1391,9,375884,1063,69912,1063,305972,0
2020-12-22,Rhode Island,44,81187,956,1678,8,609928,3956,81187,956,528741,3000
2020-12-22,South Carolina,45,278055,2322,4976,14,2942180,25553,278055,2322,2664125,23231
2020-12-22,South Dakota,46,95509,435,1381,0,363598,1278,95509,435,268089,843
2020-12-22,Tennessee,47,519475,4330,6205,133,5413861,17710,534019,4441,4879842,13269
2020-12-22,Texas,48,1632297,22156,26363,199,13130022,126058,1613095,21147,11516927,104911
2020-12-22,Utah,49,255085,2302,1175,12,1520832,6411,255085,2302,1265747,4109
2020-12-22,Vermont,50,6608,74,112,1,255257,1443,6608,74,248649,1369
2020-12-22,Virgin Islands,78,1934,13,23,0,33961,295,1934,13,32027,282
2020-12-22,Virginia,51,314481,3591,4705,51,4039241,19120,314481,3591,3724760,15529
2020-12-22,Washington,53,232204,1562,3214,28,3567915,56204,226635,4035,3341280,52169
2020-12-22,West Virginia,54,74737,1400,1171,42,1417184,8054,74737,1400,1342447,6654
2020-12-22,Wisconsin,55,497380,3027,4882,128,2801094,7476,497380,3027,2303714,4449
2020-12-22,Wyoming,56,42379,261,373,22,197980,919,42379,261,155601,658
2020-12-23,Alabama,01,334569,4758,4587,135,1876420,13969,334569,4758,1541851,9211
2020-12-23,Alaska,02,44602,361,189,3,1222027,6745,43361,360,1178666,6385
2020-12-23,Arizona,04,475706,5355,8184,51,2718608,17642,473273,6058,2245335,11584
2020-12-23,Arkansas,05,207941,2893,3376,38,2004014,13770,207941,2893,1796073,10877
2020-12-23,California,06,2013188,44758,23633,379,30468560,278378,1964076,39069,28504484,239309
2020-12-23,Colorado,08,318027,2630,4531,67,2083204,13549,316500,2948,1766704,10601
2020-12-23,Connecticut,09,170705,1745,5736,33,4087417,28877,170705,1745,3916712,27132
2020-12-23,Delaware,10,52235,612,872,0,490248,1973,52235,612,438013,1361
2020-12-23,District of Columbia,11,27226,326,751,7,849992,9790,27226,326,822766,9464
2020-12-23,Florida,12,1234391,11384,20873,120,8376934,53308,1213760,11100,7163174,42208
2020-12-23,Georgia,13,587472,7515,10193,58,5086136,36781,524055,5153,4562081,31628
2020-12-23,Guam,66,8180,0,121,0,94482,440,7257,19,87225,421
2020-12-23,Hawaii,15,20582,95,283,3,20920,105,20920,105,,0
2020-12-23,Idaho,16,134258,1308,1343,26,552781,2511,132594,1717,420187,794
2020-12-23,Illinois,17,919992,6727,16846,169,12688071,82328,918070,6762,11770001,75566
2020-12-23,Indiana,18,479476,4679,7645,64,2556493,11475,476538,4662,2079955,6813
2020-12-23,Iowa,19,272112,1818,3668,15,1154784,4016,232765,1501,922019,2515
2020-12-23,Kansas,20,212871,4762,2507,59,962204,16081,209689,5089,752515,10992
2020-12-23,Kentucky,21,252978,2889,2774,35,3109928,24454,250280,2936,2859648,21518
2020-12-23,Louisiana,22,293934,2974,7226,68,4050466,27708,293934,2974,3756532,24734
2020-12-23,Maine,23,20491,748,311,8,1058598,8039,20491,748,1038107,7291
2020-12-23,Maryland,24,258129,2463,5568,49,2704940,14190,257862,2465,2447078,11725
2020-12-23,Massachusetts,25,335988,4814,11887,83,3884823,23365,335988,4814,3548835,18551
2020-12-23,Michigan,26,507775,3795,12405,72,7850048,34050,508449,3820,7341599,30230
2020-12-23,Minnesota,27,402578,1508,5030,75,2902287,8179,402519,1508,2499768,6671
2020-12-23,Mississippi,28,200325,2634,4533,43,1327983,2634,200325,2634,1127658,0
2020-12-23,Missouri,29,396409,2921,5588,114,2000846,6998,373580,3141,1627266,3857
2020-12-23,Montana,30,78591,574,917,16,766196,3342,78522,575,687674,2767
2020-12-23,Nebraska,31,159861,1281,1586,43,825261,3476,158324,1221,666937,2255
2020-12-23,Nevada,32,210319,2968,2885,53,1124187,6490,209962,2988,914225,3502
2020-12-23,New Hampshire,33,38512,504,677,21,500886,2544,38512,504,462374,2040
2020-12-23,New Jersey,34,447083,4809,18466,140,7392671,48202,490162,5453,6902509,42749
2020-12-23,New Mexico,35,133242,1167,2243,40,1861862,10080,133242,1167,1728620,8913
2020-12-23,New York,36,882895,11740,36454,154,23843897,204361,878702,11937,22965195,192424
2020-12-23,North Carolina,37,497869,6627,6418,76,6547998,45325,494511,5609,6053487,39716
2020-12-23,North Dakota,38,90729,270,1249,5,374264,836,90723,270,283541,566
2020-12-23,Northern Mariana Islands,69,118,2,2,0,17545,0,116,0,17429,0
2020-12-23,Ohio,39,644822,7790,8361,109,7412467,33510,644822,7790,6767645,25720
2020-12-23,Oklahoma,40,269276,3656,2283,43,2543255,26318,269276,3656,2273979,22662
2020-12-23,Oregon,41,106020,929,1409,27,2491437,18993,105073,1318,2386364,17675
2020-12-23,Pennsylvania,42,586908,9725,14470,226,3762422,21989,581156,9605,3181266,12384
2020-12-23,Puerto Rico,72,104103,576,1408,17,376460,576,70488,576,305972,0
2020-12-23,Rhode Island,44,82066,879,1704,26,613839,3911,82066,879,531773,3032
2020-12-23,South Carolina,45,282230,4175,5028,52,2975719,33539,282230,4175,2693489,29364
2020-12-23,South Dakota,46,96040,531,1389,8,365126,1528,96040,531,269086,997
2020-12-23,Tennessee,47,527326,7851,6316,111,5446359,32498,541240,7221,4905119,25277
2020-12-23,Texas,48,1652994,20697,26624,261,13207057,77035,1636458,23363,11570599,53672
2020-12-23,Utah,49,257697,2612,1196,21,1528537,7705,257697,2612,1270840,5093
2020-12-23,Vermont,50,6680,72,117,5,255268,11,6680,72,248588,-61
2020-12-23,Virgin Islands,78,1950,16,23,0,34711,750,1950,16,32761,734
2020-12-23,Virginia,51,319133,4652,4760,55,4077225,37984,319133,4652,3758092,33332
2020-12-23,Washington,53,234832,2628,3245,31,3598762,30847,227887,1252,3370875,29595
2020-12-23,West Virginia,54,75936,1199,1194,23,1423899,6715,75936,1199,1347963,5516
2020-12-23,Wisconsin,55,500443,3063,4956,74,2810434,9340,500443,3063,2309991,6277
2020-12-23,Wyoming,56,42664,285,373,0,198718,738,42664,285,156054,453
2020-12-24,Alabama,01,338801,4232,4676,89,1888803,12383,338801,4232,1550002,8151
2020-12-24,Alaska,02,44876,274,191,2,1227735,5708,43629,268,1184106,5440
2020-12-24,Arizona,04,483502,7796,8301,117,2741834,23226,480319,7046,2261515,16180
2020-12-24,Arkansas,05,211145,3204,3406,30,2023078,19064,211145,3204,1811933,15860
2020-12-24,California,06,2047919,34731,23944,311,30769749,301189,2003146,39070,28766603,262119
2020-12-24,Colorado,08,320714,2687,4610,79,2096738,13534,319530,3030,1777208,10504
2020-12-24,Connecticut,09,172743,2038,5791,55,4125079,37662,172743,2038,3952336,35624
2020-12-24,Delaware,10,53015,780,888,16,493650,3402,53015,780,440635,2622
2020-12-24,District of Columbia,11,27436,210,756,5,856781,6789,27436,210,829345,6579
2020-12-24,Florida,12,1247538,13147,20994,121,8436778,59844,1226530,12770,7210248,47074
2020-12-24,Georgia,13,597753,10281,10256,63,5135306,49170,531954,7899,4603352,41271
2020-12-24,Guam,66,8235,55,122,1,94682,200,7266,9,87416,191
2020-12-24,Hawaii,15,20707,125,283,0,21048,128,21048,128,,0
2020-12-24,Idaho,16,135383,1125,1353,10,555239,2458,133985,1391,421254,1067
2020-12-24,Illinois,17,926967,6975,16964,118,12782980,94909,925107,7037,11857873,87872
2020-12-24,Indiana,18,485681,6205,7730,85,2572545,16052,482734,6196,2089811,9856
2020-12-24,Iowa,19,273661,1549,3739,71,1157711,2927,233881,1116,923830,1811
2020-12-24,Kansas,20,212962,91,2507,0,962204,0,209689,0,752515,0
2020-12-24,Kentucky,21,253437,459,2780,6,3109928,0,250280,0,2859648,0
2020-12-24,Louisiana,22,296499,2565,7272,46,4075822,25356,296499,2565,3779323,22791
2020-12-24,Maine,23,21226,735,317,6,1068208,9610,21226,735,1046982,8875
2020-12-24,Maryland,24,260994,2865,5627,59,2721219,16279,260728,2866,2460491,13413
2020-12-24,Massachusetts,25,341925,5937,11963,76,3914189,29366,341925,5937,3572264,23429
2020-12-24,Michigan,26,508029,254,12406,1,7850048,0,508449,0,7341599,0
2020-12-24,Minnesota,27,404462,1884,5109,79,2916301,14014,404403,1884,2511898,12130
2020-12-24,Mississippi,28,202651,2326,4556,23,1330309,2326,202651,2326,1127658,0
2020-12-24,Missouri,29,399528,3119,5627,39,2009336,8490,376811,3231,1632525,5259
2020-12-24,Montana,30,79066,475,918,1,771693,5497,78929,407,692764,5090
2020-12-24,Nebraska,31,160622,761,1590,4,829749,4488,159662,1338,670087,3150
2020-12-24,Nevada,32,212662,2343,2926,41,1132265,8078,212211,2249,920054,5829
2020-12-24,New Hampshire,33,38902,390,690,13,504268,3382,38902,390,465366,2992
2020-12-24,New Jersey,34,451787,4704,18544,78,7444011,51340,495492,5330,6948519,46010
2020-12-24,New Mexico,35,135166,1924,2272,29,1876924,15062,135166,1924,1741758,13138
2020-12-24,New York,36,896242,13347,36604,150,24070193,226296,891270,12568,23178923,213728
2020-12-24,North Carolina,37,498005,136,6420,2,6547998,0,494511,0,6053487,0
2020-12-24,North Dakota,38,90955,226,1267,18,375295,1031,90948,225,284347,806
2020-12-24,Northern Mariana Islands,69,118,0,2,0,17547,2,118,2,17429,0
2020-12-24,Ohio,39,653650,8828,8456,95,7468945,56478,653650,8828,6815295,47650
2020-12-24,Oklahoma,40,272553,3277,2328,45,2568884,25629,272553,3277,2296331,22352
2020-12-24,Oregon,41,106822,802,1417,8,2517896,26459,105970,897,2411926,25562
2020-12-24,Pennsylvania,42,596122,9214,14759,289,3783914,21492,590386,9230,3193528,12262
2020-12-24,Puerto Rico,72,104423,320,1423,15,376780,320,70808,320,305972,0
2020-12-24,Rhode Island,44,82066,0,1704,0,616907,3068,83112,1046,533795,2022
2020-12-24,South Carolina,45,285028,2798,5043,15,2998755,23036,285028,2798,2713727,20238
2020-12-24,South Dakota,46,96546,506,1430,41,366510,1384,96546,506,269964,878
2020-12-24,Tennessee,47,532375,5049,6367,51,5473851,27492,546497,5257,4927354,22235
2020-12-24,Texas,48,1661007,8013,26879,255,13325666,118609,1653522,17064,11672144,101545
2020-12-24,Utah,49,260589,2892,1205,9,1537177,8640,260589,2892,1276588,5748
2020-12-24,Vermont,50,6781,101,120,3,256887,1619,6781,101,250106,1518
2020-12-24,Virgin Islands,78,1967,17,23,0,34983,272,1967,17,33016,255
2020-12-24,Virginia,51,323915,4782,4791,31,4118680,41455,323915,4782,3794765,36673
2020-12-24,Washington,53,237269,2437,3268,23,3629157,30395,230202,2315,3398955,28080
2020-12-24,West Virginia,54,77239,1303,1228,34,1436290,12391,77239,1303,1359051,11088
2020-12-24,Wisconsin,55,503706,3263,5022,66,2821416,10982,503706,3263,2317710,7719
2020-12-24,Wyoming,56,42664,0,373,0,198718,0,42664,0,156054,0
2020-12-25,Alabama,01,342426,3625,4680,4,1899096,10293,342426,3625,1556670,6668
2020-12-25,Alaska,02,44876,0,191,0,1227735,0,43629,0,1184106,0
2020-12-25,Arizona,04,486993,3491,8409,108,2762894,21060,486935,6616,2275959,14444
2020-12-25,Arkansas,05,213267,2122,3438,32,2033195,10117,213267,2122,1819928,7995
2020-12-25,California,06,2064691,16772,23964,20,31066861,297112,2042290,39144,29024571,257968
2020-12-25,Colorado,08,323329,2615,4631,21,2109783,13045,322189,2659,1787594,10386
2020-12-25,Connecticut,09,172743,0,5791,0,4125079,0,172743,0,3952336,0
2020-12-25,Delaware,10,53653,638,891,3,496409,2759,53653,638,442756,2121
2020-12-25,District of Columbia,11,27436,0,756,0,856781,0,27436,0,829345,0
2020-12-25,Florida,12,1247538,0,20994,0,8436778,0,1226530,0,7210248,0
2020-12-25,Georgia,13,603246,5493,10303,47,5188835,53529,537079,5125,4651756,48404
2020-12-25,Guam,66,8237,2,122,0,94684,2,7268,2,87416,0
2020-12-25,Hawaii,15,20861,154,283,0,21204,156,21204,156,,0
2020-12-25,Idaho,16,135383,0,1353,0,557468,2229,135233,1248,422235,981
2020-12-25,Illinois,17,932427,5460,17155,191,12881938,98958,930849,5742,11951089,93216
2020-12-25,Indiana,18,491125,5444,7770,40,2586165,13620,488180,5446,2097985,8174
2020-12-25,Iowa,19,274266,605,3744,5,1160420,2709,234751,870,925669,1839
2020-12-25,Kansas,20,213076,114,2507,0,962204,0,209689,0,752515,0
2020-12-25,Kentucky,21,253824,387,2782,2,3109928,0,250280,0,2859648,0
2020-12-25,Louisiana,22,296499,0,7272,0,4075822,0,296499,0,3779323,0
2020-12-25,Maine,23,21547,321,319,2,1068529,321,21547,321,1046982,0
2020-12-25,Maryland,24,263326,2332,5659,32,2734964,13745,263160,2432,2471804,11313
2020-12-25,Massachusetts,25,341925,0,11963,0,3914189,0,341925,0,3572264,0
2020-12-25,Michigan,26,508171,142,12406,0,7850048,0,508449,0,7341599,0
2020-12-25,Minnesota,27,404462,0,5109,0,2916301,0,404403,0,2511898,0
2020-12-25,Mississippi,28,204178,1527,4562,6,1331836,1527,204178,1527,1127658,0
2020-12-25,Missouri,29,400714,1186,5633,6,2015256,5920,378887,2076,1636369,3844
2020-12-25,Montana,30,79066,0,918,0,771693,0,78929,0,692764,0
2020-12-25,Nebraska,31,161265,643,1583,-7,831796,2047,160357,695,671439,1352
2020-12-25,Nevada,32,214077,1415,2943,17,1136347,4082,214064,1853,922283,2229
2020-12-25,New Hampshire,33,38902,0,690,0,504268,0,38902,0,465366,0
2020-12-25,New Jersey,34,456847,5060,18595,51,7506560,62549,501097,5605,7005463,56944
2020-12-25,New Mexico,35,136622,1456,2309,37,1912551,35627,136622,1456,1775929,34171
2020-12-25,New York,36,909123,12881,36739,135,24296753,226560,903716,12446,23393037,214114
2020-12-25,North Carolina,37,498005,0,6420,0,6547998,0,494511,0,6053487,0
2020-12-25,North Dakota,38,91229,274,1271,4,375295,0,90948,0,284347,0
2020-12-25,Northern Mariana Islands,69,118,0,2,0,17547,0,118,0,17429,0
2020-12-25,Ohio,39,653650,0,8456,0,7468945,0,653650,0,6815295,0
2020-12-25,Oklahoma,40,272553,0,2328,0,2587225,18341,272553,0,2314672,18341
2020-12-25,Oregon,41,107833,1011,1431,14,2537482,19586,106821,851,2430661,18735
2020-12-25,Pennsylvania,42,602605,6483,14892,133,3804439,20525,597560,7174,3206879,13351
2020-12-25,Puerto Rico,72,105039,616,1432,9,377396,616,71424,616,305972,0
2020-12-25,Rhode Island,44,82066,0,1704,0,621187,4280,83982,870,537205,3410
2020-12-25,South Carolina,45,285028,0,5043,0,2998755,0,285028,0,2713727,0
2020-12-25,South Dakota,46,96546,0,1430,0,366510,0,96546,0,269964,0
2020-12-25,Tennessee,47,541267,8892,6367,0,5473851,0,546497,0,4927354,0
2020-12-25,Texas,48,1663094,2087,27042,163,13440530,114864,1657857,4335,11782673,110529
2020-12-25,Utah,49,260589,0,1205,0,1537177,0,260589,0,1276588,0
2020-12-25,Vermont,50,6781,0,120,0,256887,0,6781,0,250106,0
2020-12-25,Virgin Islands,78,1979,12,23,0,35184,201,1979,12,33205,189
2020-12-25,Virginia,51,327993,4078,4820,29,4122758,4078,327993,4078,3794765,0
2020-12-25,Washington,53,237689,420,3268,0,3657904,28747,233093,2891,3424811,25856
2020-12-25,West Virginia,54,78836,1597,1247,19,1450024,13734,78836,1597,1371188,12137
2020-12-25,Wisconsin,55,505345,1639,5028,6,2830164,8748,505345,1639,2324819,7109
2020-12-25,Wyoming,56,42664,0,373,0,198718,0,42664,0,156054,0
2020-12-26,Alabama,01,343458,1032,4685,5,1904436,5340,343458,1032,1560978,4308
2020-12-26,Alaska,02,45247,371,192,1,1245063,17328,43990,361,1201073,16967
2020-12-26,Arizona,04,493277,6284,8424,15,2786303,23409,493041,6106,2293262,17303
2020-12-26,Arkansas,05,213969,702,3441,3,2041121,7926,213969,702,1827152,7224
2020-12-26,California,06,2129678,64987,24221,257,31446542,379681,2072665,30375,29373877,349306
2020-12-26,Colorado,08,324869,1540,4652,21,2115546,5763,323619,1430,1791927,4333
2020-12-26,Connecticut,09,172743,0,5791,0,4125079,0,172743,0,3952336,0
2020-12-26,Delaware,10,54473,820,895,4,499747,3338,54473,820,445274,2518
2020-12-26,District of Columbia,11,27710,274,762,6,864407,7626,27710,274,836697,7352
2020-12-26,Florida,12,1264580,17042,21134,140,8503333,66555,1243118,16588,7260215,49967
2020-12-26,Georgia,13,607133,3887,10352,49,5218474,29639,540758,3679,4677716,25960
2020-12-26,Guam,66,8238,1,122,0,94685,1,7269,1,87416,0
2020-12-26,Hawaii,15,20970,109,283,0,21323,119,21323,119,,0
2020-12-26,Idaho,16,135886,503,1357,4,557468,0,135233,0,422235,0
2020-12-26,Illinois,17,935849,3422,17225,70,12939386,57448,934142,3293,12005244,54155
2020-12-26,Indiana,18,494967,3842,7801,31,2595969,9804,492021,3841,2103948,5963
2020-12-26,Iowa,19,274793,527,3744,0,1161680,1260,235061,310,926619,950
2020-12-26,Kansas,20,213091,15,2507,0,962204,0,209689,0,752515,0
2020-12-26,Kentucky,21,257453,3629,2821,39,3162862,52934,255563,5283,2907299,47651
2020-12-26,Louisiana,22,296499,0,7272,0,4075822,0,296499,0,3779323,0
2020-12-26,Maine,23,21547,0,319,0,1068529,0,21547,0,1046982,0
2020-12-26,Maryland,24,265606,2280,5680,21,2748160,13196,265440,2280,2482720,10916
2020-12-26,Massachusetts,25,349602,7677,12010,47,3944684,30495,349602,7677,3595082,22818
2020-12-26,Michigan,26,515484,7313,12680,274,7979269,129221,516326,7877,7462943,121344
2020-12-26,Minnesota,27,406604,2142,5166,57,2931397,15096,406545,2142,2524852,12954
2020-12-26,Mississippi,28,205023,845,4565,3,1332681,845,205023,845,1127658,0
2020-12-26,Missouri,29,402344,1630,5642,9,2020302,5046,380643,1756,1639659,3290
2020-12-26,Montana,30,79521,455,919,1,778541,6848,79433,504,699108,6344
2020-12-26,Nebraska,31,161579,314,1584,1,834221,2425,161162,805,673059,1620
2020-12-26,Nevada,32,216329,2252,2951,8,1142706,6359,215653,1589,927053,4770
2020-12-26,New Hampshire,33,39933,1031,701,11,509654,5386,39933,1031,469721,4355
2020-12-26,New Jersey,34,460846,3999,18613,18,7510891,4331,505428,4331,7005463,0
2020-12-26,New Mexico,35,137227,605,2318,9,1923907,11356,137226,604,1786681,10752
2020-12-26,New York,36,920171,11048,36870,131,24498195,201442,914522,10806,23583673,190636
2020-12-26,North Carolina,37,514724,16719,6574,154,6749530,201532,513930,19419,6235600,182113
2020-12-26,North Dakota,38,91362,133,1271,0,376490,1195,91355,407,285135,788
2020-12-26,Northern Mariana Islands,69,122,4,2,0,17551,4,122,4,17429,0
2020-12-26,Ohio,39,664668,11018,8476,20,7534051,65106,664668,11018,6869383,54088
2020-12-26,Oklahoma,40,276508,3955,2357,29,2591180,3955,276508,3955,2314672,0
2020-12-26,Oregon,41,108348,515,1431,0,2538379,897,107718,897,2430661,0
2020-12-26,Pennsylvania,42,609682,7077,14915,23,3826249,21810,605141,7581,3221108,14229
2020-12-26,Puerto Rico,72,106058,1019,1432,0,378415,1019,72443,1019,305972,0
2020-12-26,Rhode Island,44,82066,0,1704,0,622017,830,84208,226,537809,604
2020-12-26,South Carolina,45,288892,3864,5124,81,3031335,32580,288892,3864,2742443,28716
2020-12-26,South Dakota,46,96963,417,1446,16,367781,1271,96963,417,270818,854
2020-12-26,Tennessee,47,546245,4978,6382,15,5548115,74264,560892,14395,4987223,59869
2020-12-26,Texas,48,1668843,5749,27062,20,13557735,117205,1660551,2694,11897184,114511
2020-12-26,Utah,49,264078,3489,1212,7,1549113,11936,264078,3489,1285035,8447
2020-12-26,Vermont,50,6966,185,121,1,259439,2552,6966,185,252473,2367
2020-12-26,Virgin Islands,78,1979,0,23,0,35184,0,1979,0,33205,0
2020-12-26,Virginia,51,329577,1584,4840,20,4179223,56465,329577,1584,3849646,54881
2020-12-26,Washington,53,240763,3074,3283,15,3657904,0,233093,0,3424811,0
2020-12-26,West Virginia,54,80177,1341,1253,6,1461631,11607,80177,1341,1381454,10266
2020-12-26,Wisconsin,55,506022,677,5032,4,2836102,5938,506022,677,2330080,5261
2020-12-26,Wyoming,56,43146,482,373,0,199200,482,43146,482,156054,0
2020-12-27,Alabama,01,345628,2170,4691,6,1909109,4673,345628,2170,1563481,2503
2020-12-27,Alaska,02,45547,300,192,0,1250251,5188,44280,290,1205971,4898
2020-12-27,Arizona,04,494489,1212,8427,3,2798095,11792,494337,1296,2303758,10496
2020-12-27,Arkansas,05,214877,908,3482,41,2046196,5075,214877,908,1831319,4167
2020-12-27,California,06,2167233,37555,24283,62,31826696,380154,2122806,50141,29703890,330013
2020-12-27,Colorado,08,326276,1407,4660,8,2121087,5541,325018,1399,1796069,4142
2020-12-27,Connecticut,09,172743,0,5791,0,4125079,0,172743,0,3952336,0
2020-12-27,Delaware,10,55057,584,897,2,502004,2257,55057,584,446947,1673
2020-12-27,District of Columbia,11,28202,492,768,6,882847,18440,28202,492,854645,17948
2020-12-27,Florida,12,1271971,7391,21211,77,8530717,27384,1250275,7157,7280442,20227
2020-12-27,Georgia,13,610574,3441,10356,4,5233528,15054,543707,2949,4689821,12105
2020-12-27,Guam,66,8239,1,122,0,94686,1,7270,1,87416,0
2020-12-27,Hawaii,15,21064,94,283,0,21418,95,21418,95,,0
2020-12-27,Idaho,16,136281,395,1357,0,559716,2248,135787,554,423929,1694
2020-12-27,Illinois,17,939671,3822,17336,111,12985612,46226,937909,3767,12047703,42459
2020-12-27,Indiana,18,496795,1828,7843,42,2600211,4242,493841,1820,2106370,2422
2020-12-27,Iowa,19,275299,506,3745,1,1163367,1687,235539,478,927828,1209
2020-12-27,Kansas,20,213173,82,2507,0,962204,0,209689,0,752515,0
2020-12-27,Kentucky,21,258820,1367,2845,24,3164362,1500,257063,1500,2907299,0
2020-12-27,Louisiana,22,299722,3223,7291,19,4102652,26830,299722,3223,3802930,23607
2020-12-27,Maine,23,21880,333,323,4,1068862,333,21880,333,1046982,0
2020-12-27,Maryland,24,267455,1849,5712,32,2758139,9979,267198,1758,2490941,8221
2020-12-27,Massachusetts,25,352736,3134,12110,100,3956464,11780,352736,3134,3603728,8646
2020-12-27,Michigan,26,515576,92,12680,0,7979269,0,516326,0,7462943,0
2020-12-27,Minnesota,27,409120,2516,5206,40,2960982,29585,409061,2516,2551921,27069
2020-12-27,Mississippi,28,206388,1365,4606,41,1334046,1365,206388,1365,1127658,0
2020-12-27,Missouri,29,404201,1857,5656,14,2023588,3286,382094,1451,1641494,1835
2020-12-27,Montana,30,79780,259,924,5,780119,1578,79780,347,700339,1231
2020-12-27,Nebraska,31,162202,623,1584,0,834785,564,161337,175,673448,389
2020-12-27,Nevada,32,217653,1324,2965,14,1146288,3582,217509,1856,928779,1726
2020-12-27,New Hampshire,33,40809,876,708,7,513322,3668,40809,876,472513,2792
2020-12-27,New Jersey,34,463166,2320,18630,17,7513786,2895,508323,2895,7005463,0
2020-12-27,New Mexico,35,137968,741,2348,30,1932739,8832,137968,742,1794771,8090
2020-12-27,New York,36,928376,8205,37000,130,24628494,130299,922145,7623,23706349,122676
2020-12-27,North Carolina,37,517449,2725,6592,18,6779423,29893,516828,2898,6262595,26995
2020-12-27,North Dakota,38,91472,110,1273,2,376711,221,91466,111,285245,110
2020-12-27,Northern Mariana Islands,69,122,0,2,0,17551,0,122,0,17429,0
2020-12-27,Ohio,39,670525,5857,8509,33,7607922,73871,670525,5857,6937397,68014
2020-12-27,Oklahoma,40,279139,2631,2370,13,2593811,2631,279139,2631,2314672,0
2020-12-27,Oregon,41,109734,1386,1436,5,2538987,608,108326,608,2430661,0
2020-12-27,Pennsylvania,42,614303,4621,15040,125,3841488,15239,610025,4884,3231463,10355
2020-12-27,Puerto Rico,72,106842,784,1445,13,379199,784,73227,784,305972,0
2020-12-27,Rhode Island,44,82066,0,1704,0,624666,2649,84941,733,539725,1916
2020-12-27,South Carolina,45,296179,7287,5155,31,3102884,71549,296179,7287,2806705,64262
2020-12-27,South Dakota,46,97390,427,1446,0,368785,1004,97390,427,271395,577
2020-12-27,Tennessee,47,549299,3054,6451,69,5560918,12803,564080,3188,4996838,9615
2020-12-27,Texas,48,1691515,22672,27110,48,13648259,90524,1668597,8046,11979662,82478
2020-12-27,Utah,49,264874,796,1214,2,1551096,1983,264874,796,1286222,1187
2020-12-27,Vermont,50,7029,63,127,6,259950,511,7029,63,252921,448
2020-12-27,Virgin Islands,78,1979,0,23,0,35184,0,1979,0,33205,0
2020-12-27,Virginia,51,333576,3999,4854,14,4201156,21933,333576,3999,3867580,17934
2020-12-27,Washington,53,241036,273,3283,0,3719703,61799,236719,3626,3482984,58173
2020-12-27,West Virginia,54,80710,533,1254,1,1466530,4899,80710,533,1385820,4366
2020-12-27,Wisconsin,55,508580,2558,5042,10,2841275,5173,508580,2558,2332695,2615
2020-12-27,Wyoming,56,43200,54,373,0,199254,54,43200,54,156054,0
2020-12-28,Alabama,01,347897,2269,4712,21,1914095,4986,347897,2269,1566198,2717
2020-12-28,Alaska,02,45674,127,192,0,1254397,4146,44406,126,1209991,4020
2020-12-28,Arizona,04,504616,10127,8469,42,2805755,7660,504423,10086,2301332,-2426
2020-12-28,Arkansas,05,216528,1651,3537,55,2052496,6300,216528,1651,1835968,4649
2020-12-28,California,06,2208953,41720,24529,246,32128516,301820,2155976,33170,29972540,268650
2020-12-28,Colorado,08,328249,1973,4699,39,2127606,6519,326668,1650,1800938,4869
2020-12-28,Connecticut,09,181200,8457,5904,113,4265232,140153,181200,8457,4084032,131696
2020-12-28,Delaware,10,55488,431,898,1,503657,1653,55488,431,448169,1222
2020-12-28,District of Columbia,11,28342,140,771,3,885875,3028,28342,140,857533,2888
2020-12-28,Florida,12,1280169,8198,21307,96,8558491,27774,1258315,8040,7300176,19734
2020-12-28,Georgia,13,614716,4142,10363,7,5248593,15065,546859,3152,4701734,11913
2020-12-28,Guam,66,8250,11,122,0,95313,627,7281,11,88032,616
2020-12-28,Hawaii,15,21109,45,283,0,21463,45,21463,45,,0
2020-12-28,Idaho,16,137449,1168,1381,24,560582,866,136215,428,424367,438
2020-12-28,Illinois,17,944402,4731,17476,140,13036658,51046,942362,4453,12094296,46593
2020-12-28,Indiana,18,499256,2461,7886,43,2605669,5458,496306,2465,2109363,2993
2020-12-28,Iowa,19,276649,1350,3745,0,1164835,1468,236101,562,928734,906
2020-12-28,Kansas,20,219095,5922,2548,41,985813,23609,216062,6373,769751,17236
2020-12-28,Kentucky,21,261009,2189,2871,26,3174317,9955,258517,1454,2915800,8501
2020-12-28,Louisiana,22,300539,817,7336,45,4108164,5512,300539,817,3807625,4695
2020-12-28,Maine,23,22319,439,326,3,1091810,22948,22319,439,1069491,22509
2020-12-28,Maryland,24,269442,1987,5740,28,2771508,13369,269183,1985,2502325,11384
2020-12-28,Massachusetts,25,356934,4198,12158,48,3971594,15130,356934,4198,3614660,10932
2020-12-28,Michigan,26,519291,3715,12744,64,8040836,61567,519876,3550,7520960,58017
2020-12-28,Minnesota,27,410197,1077,5219,13,2965588,4606,410138,1077,2555450,3529
2020-12-28,Mississippi,28,208089,1701,4634,28,1335747,1701,208089,1701,1127658,0
2020-12-28,Missouri,29,407193,2992,5668,12,2026230,2642,383616,1522,1642614,1120
2020-12-28,Montana,30,80080,300,927,3,782018,1899,79999,219,702019,1680
2020-12-28,Nebraska,31,163197,995,1614,30,836279,1494,161974,637,674305,857
2020-12-28,Nevada,32,218666,1013,2973,8,1149786,3498,218377,868,931409,2630
2020-12-28,New Hampshire,33,41670,861,715,7,516522,3200,41670,861,474852,2339
2020-12-28,New Jersey,34,465910,2744,18651,21,7705189,191403,511636,3313,7193553,188090
2020-12-28,New Mexico,35,138659,691,2384,36,1939081,6342,138659,691,1800422,5651
2020-12-28,New York,36,938710,10334,37118,118,24753360,124866,932552,10407,23820808,114459
2020-12-28,North Carolina,37,521990,4541,6601,9,6816028,36605,520716,3888,6295312,32717
2020-12-28,North Dakota,38,91565,93,1277,4,376998,287,91559,93,285439,194
2020-12-28,Northern Mariana Islands,69,122,0,2,0,17551,0,122,0,17429,0
2020-12-28,Ohio,39,675044,4519,8571,62,7639834,31912,675044,4519,6964790,27393
2020-12-28,Oklahoma,40,282587,3448,2383,13,2597259,3448,282587,3448,2314672,0
2020-12-28,Oregon,41,110303,569,1438,2,2540386,1399,109725,1399,2430661,0
2020-12-28,Pennsylvania,42,619425,5122,15114,74,3851895,10407,613804,3779,3238091,6628
2020-12-28,Puerto Rico,72,107273,431,1456,11,379630,431,73658,431,305972,0
2020-12-28,Rhode Island,44,85602,3536,1742,38,627262,2596,85602,661,541660,1935
2020-12-28,South Carolina,45,298050,1871,5173,18,3117127,14243,298050,1871,2819077,12372
2020-12-28,South Dakota,46,97658,268,1446,0,369269,484,97657,267,271612,217
2020-12-28,Tennessee,47,552794,3495,6524,73,5575180,14262,567792,3712,5007388,10550
2020-12-28,Texas,48,1711986,20471,27245,135,13709190,60931,1683426,14829,12025764,46102
2020-12-28,Utah,49,266590,1716,1223,9,1555760,4664,266590,1716,1289170,2948
2020-12-28,Vermont,50,7120,91,129,2,260979,1029,7120,91,253859,938
2020-12-28,Virgin Islands,78,1979,0,23,0,35184,0,1979,0,33205,0
2020-12-28,Virginia,51,336175,2599,4861,7,4220504,19348,336175,2599,3884329,16749
2020-12-28,Washington,53,243547,2511,3300,17,3719703,0,236719,0,3482984,0
2020-12-28,West Virginia,54,81436,726,1263,9,1471430,4900,81436,726,1389994,4174
2020-12-28,Wisconsin,55,510137,1557,5065,23,2846668,5393,510137,1557,2336531,3836
2020-12-28,Wyoming,56,43704,504,405,32,201881,2627,43704,504,158177,2123
2020-12-29,Alabama,01,351804,3907,4737,25,1923057,8962,351804,3907,1571253,5055
2020-12-29,Alaska,02,45856,182,193,1,1259845,5448,44581,175,1215264,5273
2020-12-29,Arizona,04,510548,5932,8647,178,2817798,12043,507222,2799,2310576,9244
2020-12-29,Arkansas,05,219246,2718,3603,66,2061115,8619,219246,2718,1841869,5901
2020-12-29,California,06,2243119,34166,24954,425,32374471,245955,2187221,31245,30187250,214710
2020-12-29,Colorado,08,330118,1869,4758,59,2132611,5005,328408,1740,1804203,3265
2020-12-29,Connecticut,09,181967,767,5924,20,4278915,13683,181967,767,4096948,12916
2020-12-29,Delaware,10,56189,701,898,0,505812,2155,56189,701,449623,1454
2020-12-29,District of Columbia,11,28535,193,775,4,888992,3117,28535,193,860457,2924
2020-12-29,Florida,12,1292244,12075,21408,101,8602988,44497,1270063,11748,7332925,32749
2020-12-29,Georgia,13,623901,9185,10439,76,5281282,32689,552712,5853,4728570,26836
2020-12-29,Guam,66,8262,12,122,0,95669,356,7293,12,88376,344
2020-12-29,Hawaii,15,21180,71,283,0,21538,75,21538,75,,0
2020-12-29,Idaho,16,138909,1460,1396,15,562155,1573,137010,795,425145,778
2020-12-29,Illinois,17,950122,5720,17606,130,13103444,66786,948006,5644,12155438,61142
2020-12-29,Indiana,18,503242,3986,8051,165,2613675,8006,500282,3976,2113393,4030
2020-12-29,Iowa,19,278310,1661,3812,67,1166051,1216,236798,697,929253,519
2020-12-29,Kansas,20,219415,320,2548,0,985813,0,216062,0,769751,0
2020-12-29,Kentucky,21,264150,3141,2903,32,3179124,4807,261492,2975,2917632,1832
2020-12-29,Louisiana,22,304485,3946,7397,61,4142108,33944,304485,3946,3837623,29998
2020-12-29,Maine,23,22909,590,333,7,1096473,4663,22909,590,1073564,4073
2020-12-29,Maryland,24,271267,1825,5803,63,2779140,7632,271061,1878,2508079,5754
2020-12-29,Massachusetts,25,361079,4145,12218,60,3986732,15138,361079,4145,3625653,10993
2020-12-29,Michigan,26,523085,3794,12956,212,8064471,23635,523839,3963,7540632,19672
2020-12-29,Minnesota,27,411169,972,5255,36,2966864,1276,411110,972,2555754,304
2020-12-29,Mississippi,28,210032,1943,4719,85,1337690,1943,210032,1943,1127658,0
2020-12-29,Missouri,29,410334,3141,5766,98,2031984,5754,386095,2479,1645889,3275
2020-12-29,Montana,30,80516,436,939,12,783495,1477,80426,427,703069,1050
2020-12-29,Nebraska,31,164200,1003,1630,16,838798,2519,162849,875,675949,1644
2020-12-29,Nevada,32,220391,1725,3035,62,1153014,3228,220124,1747,932890,1481
2020-12-29,New Hampshire,33,42697,1027,735,20,518708,2186,42697,1027,476011,1159
2020-12-29,New Jersey,34,469567,3657,18777,126,7741907,36718,516043,4407,7225864,32311
2020-12-29,New Mexico,35,139908,1249,2405,21,1946285,7204,139875,1216,1806410,5988
2020-12-29,New York,36,950730,12020,37256,138,24913524,160164,943990,11438,23969534,148726
2020-12-29,North Carolina,37,526439,4449,6630,29,6842669,26641,524279,3563,6318390,23078
2020-12-29,North Dakota,38,91836,271,1283,6,377875,877,91831,272,286044,605
2020-12-29,Northern Mariana Islands,69,122,0,2,0,17551,0,122,0,17429,0
2020-12-29,Ohio,39,682570,7526,8722,151,7666450,26616,682570,7526,6983880,19090
2020-12-29,Oklahoma,40,283781,1194,2405,22,2619690,22431,283781,1194,2335909,21237
2020-12-29,Oregon,41,111258,955,1457,19,2598391,58005,110545,820,2487846,57185
2020-12-29,Pennsylvania,42,628083,8658,15389,275,3866452,14557,622349,8545,3244103,6012
2020-12-29,Puerto Rico,72,109405,2132,1460,4,381762,2132,75790,2132,305972,0
2020-12-29,Rhode Island,44,86789,1187,1760,18,630872,3610,86789,1187,544083,2423
2020-12-29,South Carolina,45,300602,2552,5198,25,3133285,16158,300602,2552,2832683,13606
2020-12-29,South Dakota,46,98158,500,1446,0,370159,890,98158,501,272001,389
2020-12-29,Tennessee,47,557554,4760,6647,123,5588933,13753,572589,4797,5016344,8956
2020-12-29,Texas,48,1735809,23823,27499,254,13789246,80056,1715978,32552,12073268,47504
2020-12-29,Utah,49,269326,2736,1238,15,1561600,5840,269326,2736,1292274,3104
2020-12-29,Vermont,50,7202,82,130,1,261261,282,7202,82,254059,200
2020-12-29,Virgin Islands,78,1979,0,23,0,35184,0,1979,0,33205,0
2020-12-29,Virginia,51,340297,4122,4920,59,4244264,23760,340297,4122,3903967,19638
2020-12-29,Washington,53,245692,2145,3433,133,3777662,57959,238672,1953,3538990,56006
2020-12-29,West Virginia,54,82773,1337,1284,21,1483446,12016,82773,1337,1400673,10679
2020-12-29,Wisconsin,55,513056,2919,5157,92,2853220,6552,513056,2919,2340164,3633
2020-12-29,Wyoming,56,43923,219,405,0,202331,450,43923,219,158408,231
2020-12-30,Alabama,01,356820,5016,4774,37,1931895,8838,356820,5016,1575075,3822
2020-12-30,Alaska,02,46241,385,195,2,1267092,7247,44966,385,1222126,6862
2020-12-30,Arizona,04,515366,4818,8726,79,2836652,18854,512489,5267,2324163,13587
2020-12-30,Arkansas,05,222430,3184,3637,34,2076543,15428,222430,3184,1854113,12244
2020-12-30,California,06,2275505,32386,25391,437,32623076,248605,2218142,30921,30404934,217684
2020-12-30,Colorado,08,332686,2568,4822,64,2140399,7788,330859,2451,1809540,5337
2020-12-30,Connecticut,09,183663,1696,5964,40,4297581,18666,183663,1696,4113918,16970
2020-12-30,Delaware,10,56596,407,921,23,507478,1666,56596,407,450882,1259
2020-12-30,District of Columbia,11,28758,223,780,5,892764,3772,28758,223,864006,3549
2020-12-30,Florida,12,1306115,13871,21545,137,8644659,41671,1283701,13638,7360958,28033
2020-12-30,Georgia,13,632861,8960,10503,64,5304793,23511,558177,5465,4746616,18046
2020-12-30,Guam,66,8277,15,122,0,95941,272,7308,15,88633,257
2020-12-30,Hawaii,15,21284,104,283,0,21644,106,21644,106,,0
2020-12-30,Idaho,16,140150,1241,1409,13,564161,2006,138524,1514,425637,492
2020-12-30,Illinois,17,957853,7731,17813,207,13178017,74573,955380,7374,12222637,67199
2020-12-30,Indiana,18,507979,4737,8160,109,2622879,9204,505017,4735,2117862,4469
2020-12-30,Iowa,19,280067,1757,3822,10,1168170,2119,237850,1052,930320,1067
2020-12-30,Kansas,20,225361,5946,2741,193,1001232,15419,222433,6371,778799,9048
2020-12-30,Kentucky,21,267990,3840,2943,40,3200612,21488,265262,3770,2935350,17718
2020-12-30,Louisiana,22,311229,6744,7448,51,4184768,42660,311229,6744,3873539,35916
2020-12-30,Maine,23,23499,590,334,1,1102498,6025,23499,590,1078999,5435
2020-12-30,Maryland,24,273881,2614,5848,45,2790545,11405,273689,2628,2516856,8777
2020-12-30,Massachusetts,25,367918,6839,12338,120,4008686,21954,367918,6839,3640768,15115
2020-12-30,Michigan,26,526932,3847,13008,52,8113075,48604,528621,4782,7584454,43822
2020-12-30,Minnesota,27,413166,1997,5321,66,2975186,8322,413107,1997,2562079,6325
2020-12-30,Mississippi,28,213055,3023,4747,28,1340713,3023,213055,3023,1127658,0
2020-12-30,Missouri,29,413764,3430,5846,80,2037825,5841,388856,2761,1648969,3080
2020-12-30,Montana,30,81352,836,950,11,786808,3313,81300,874,705508,2439
2020-12-30,Nebraska,31,165708,1508,1640,10,840792,1994,163781,932,677011,1062
2020-12-30,Nevada,32,223033,2642,3081,46,1157654,4640,222594,2470,935060,2170
2020-12-30,New Hampshire,33,43242,545,741,6,520315,1607,43242,545,477073,1062
2020-12-30,New Jersey,34,474285,4718,18952,175,7747137,5230,521273,5230,7225864,0
2020-12-30,New Mexico,35,141219,1311,2438,33,1954680,8395,141186,1311,1813494,7084
2020-12-30,New York,36,963647,12917,37412,156,25068473,154949,957412,13422,24111061,141527
2020-12-30,North Carolina,37,535120,8681,6780,150,6880495,37826,532830,8551,6347665,29275
2020-12-30,North Dakota,38,92208,372,1289,6,376036,-1839,92202,371,283834,-2210
2020-12-30,Northern Mariana Islands,69,122,0,2,0,17551,0,122,0,17429,0
2020-12-30,Ohio,39,690748,8178,8855,133,7694900,28450,690748,8178,7004152,20272
2020-12-30,Oklahoma,40,287030,3249,2453,48,2649374,29684,287030,3249,2362344,26435
2020-12-30,Oregon,41,112301,1043,1478,21,2613558,15167,111227,682,2502331,14485
2020-12-30,Pennsylvania,42,636710,8627,15718,329,3885630,19178,631333,8984,3254297,10194
2020-12-30,Puerto Rico,72,109503,98,1484,24,381860,98,75888,98,305972,0
2020-12-30,Rhode Island,44,87949,1160,1777,17,633613,2741,87949,1160,545664,1581
2020-12-30,South Carolina,45,303475,2873,5249,51,3150834,17549,303475,2873,2847359,14676
2020-12-30,South Dakota,46,98720,562,1464,18,371459,1300,98720,562,272739,738
2020-12-30,Tennessee,47,566457,8903,6748,101,5618268,29335,580809,8220,5037459,21115
2020-12-30,Texas,48,1755293,19484,27821,322,13862795,73549,1737447,21469,12125348,52080
2020-12-30,Utah,49,271940,2614,1259,21,1568807,7207,271940,2614,1296867,4593
2020-12-30,Vermont,50,7276,74,134,4,261808,547,7276,74,254532,473
2020-12-30,Virgin Islands,78,2010,31,23,0,35591,407,2010,31,33581,376
2020-12-30,Virginia,51,344345,4048,4984,64,4275556,31292,344345,4048,3931211,27244
2020-12-30,Washington,53,247455,1763,3486,53,3807443,29781,240846,2174,3566597,27607
2020-12-30,West Virginia,54,84225,1452,1318,34,1495094,11648,84225,1452,1410869,10196
2020-12-30,Wisconsin,55,516226,3170,5195,38,2860997,7777,516226,3170,2344771,4607
2020-12-30,Wyoming,56,44133,210,405,0,203063,732,44133,210,158930,522
2020-12-31,Alabama,01,361226,4406,4827,53,1944645,12750,361226,4406,1583419,8344
2020-12-31,Alaska,02,46740,499,198,3,1275750,8658,45461,495,1230289,8163
2020-12-31,Arizona,04,523829,8463,8879,153,2859842,23190,520207,7718,2339635,15472
2020-12-31,Arkansas,05,225138,2708,3676,39,2089842,13299,225138,2708,1864704,10591
2020-12-31,California,06,2307769,32264,25965,574,32855482,232406,2245379,27237,30610103,205169
2020-12-31,Colorado,08,335579,2893,4879,57,2149666,9267,334097,3238,1815569,6029
2020-12-31,Connecticut,09,185708,2045,5995,31,4320693,23112,185708,2045,4134985,21067
2020-12-31,Delaware,10,57456,860,926,5,510085,2607,57456,860,452629,1747
2020-12-31,District of Columbia,11,28983,225,786,6,897439,4675,28983,225,868456,4450
2020-12-31,Florida,12,1323307,17192,21672,127,8705592,60933,1300528,16827,7405064,44106
2020-12-31,Georgia,13,644065,11204,10588,85,5349390,44597,566676,8499,4782714,36098
2020-12-31,Guam,66,8286,9,123,1,96192,251,7317,9,88875,242
2020-12-31,Hawaii,15,21459,175,286,3,21832,188,21832,188,,0
2020-12-31,Idaho,16,141388,1238,1438,29,567282,3121,139864,1340,427418,1781
2020-12-31,Illinois,17,965840,7987,17979,166,13277443,99426,963389,8009,12314054,91417
2020-12-31,Indiana,18,514455,6476,8263,103,2636695,13816,511485,6468,2125210,7348
2020-12-31,Iowa,19,281712,1645,3891,69,1171219,3049,239173,1323,932046,1726
2020-12-31,Kansas,20,225455,94,2741,0,1001232,0,222433,0,778799,0
2020-12-31,Kentucky,21,268828,838,2956,13,3200612,0,265262,0,2935350,0
2020-12-31,Louisiana,22,315275,4046,7488,40,4214182,29414,315275,4046,3898907,25368
2020-12-31,Maine,23,24201,702,347,13,1111413,8915,24201,702,1087212,8213
2020-12-31,Maryland,24,276834,2953,5895,47,2802468,11923,276662,2973,2525806,8950
2020-12-31,Massachusetts,25,375178,7260,12423,85,4033343,24657,375178,7260,3658165,17397
2020-12-31,Michigan,26,527199,267,13010,2,8113075,0,528621,0,7584454,0
2020-12-31,Minnesota,27,415361,2195,5382,61,2987148,11962,415302,2195,2571846,9767
2020-12-31,Mississippi,28,215811,2756,4787,40,1343469,2756,215811,2756,1127658,0
2020-12-31,Missouri,29,418637,4873,5887,41,2044872,7047,392570,3714,1652302,3333
2020-12-31,Montana,30,81701,349,962,12,791589,4781,81555,255,710034,4526
2020-12-31,Nebraska,31,167128,1420,1679,39,844532,3740,165297,1516,679235,2224
2020-12-31,Nevada,32,225178,2145,3136,55,1162755,5101,224731,2137,938024,2964
2020-12-31,New Hampshire,33,44028,786,759,18,523618,3303,44028,786,479590,2517
2020-12-31,New Jersey,34,479381,5096,19042,90,7785400,38263,526985,5712,7258415,32551
2020-12-31,New Mexico,35,142897,1678,2479,41,1970212,15532,142864,1678,1827348,13854
2020-12-31,New York,36,979040,15393,37557,145,25285060,216587,974214,16802,24310846,199785
2020-12-31,North Carolina,37,541070,5950,6811,31,6944103,63608,539545,6715,6404558,56893
2020-12-31,North Dakota,38,92502,294,1299,10,375748,-288,92495,293,283253,-581
2020-12-31,Northern Mariana Islands,69,122,0,2,0,17551,0,122,0,17429,0
2020-12-31,Ohio,39,700380,9632,8962,107,7752314,57414,700380,9632,7051934,47782
2020-12-31,Oklahoma,40,290936,3906,2489,36,2668245,18871,290936,3906,2377309,14965
2020-12-31,Oregon,41,113929,1628,1485,7,2632475,18917,112260,1033,2520215,17884
2020-12-31,Pennsylvania,42,646060,9350,16020,302,3905454,19824,640325,8992,3265129,10832
2020-12-31,Puerto Rico,72,109906,403,1503,19,382263,403,76291,403,305972,0
2020-12-31,Rhode Island,44,87949,0,1777,0,637665,4052,89541,1592,548124,2460
2020-12-31,South Carolina,45,307507,4032,5296,47,3173021,22187,307507,4032,2865514,18155
2020-12-31,South Dakota,46,99164,444,1488,24,372640,1181,99164,444,273476,737
2020-12-31,Tennessee,47,572579,6122,6846,98,5644058,25790,586802,5993,5057256,19797
2020-12-31,Texas,48,1772163,16870,28155,334,13947901,85106,1756172,18725,12191729,66381
2020-12-31,Utah,49,276612,4672,1270,11,1579103,10296,276612,4672,1302491,5624
2020-12-31,Vermont,50,7412,136,136,2,263096,1288,7412,136,255684,1152
2020-12-31,Virgin Islands,78,2031,21,23,0,36170,579,2031,21,34139,558
2020-12-31,Virginia,51,349584,5239,5032,48,4312129,36573,349584,5239,3962545,31334
2020-12-31,Washington,53,251064,3609,3523,37,3814727,7284,242330,1484,3572397,5800
2020-12-31,West Virginia,54,85334,1109,1338,20,1514520,19426,85334,1109,1429186,18317
2020-12-31,Wisconsin,55,520438,4212,5245,50,2871107,10110,520438,4212,2350669,5898
2020-12-31,Wyoming,56,44409,276,438,33,203937,874,44409,276,159528,598
2021-01-01,Alabama,01,365747,4521,4872,45,1956497,11852,365747,4521,1590750,7331
2021-01-01,Alaska,02,46740,0,198,0,1275750,0,45461,0,1230289,0
2021-01-01,Arizona,04,530267,6438,9015,136,2905337,45495,530267,10060,2375070,35435
2021-01-01,Arkansas,05,229442,4304,3711,35,2107957,18115,229442,4304,1878515,13811
2021-01-01,California,06,2345726,37957,26236,271,33058311,202829,2292568,47189,30765743,155640
2021-01-01,Colorado,08,338357,2778,4936,57,2159628,9962,337161,3064,1822467,6898
2021-01-01,Connecticut,09,185708,0,5995,0,4320693,0,185708,0,4134985,0
2021-01-01,Delaware,10,58064,608,930,4,511924,1839,58064,608,453860,1231
2021-01-01,District of Columbia,11,29252,269,788,2,904302,6863,29252,269,875050,6594
2021-01-01,Florida,12,1323307,0,21672,0,8705592,0,1300528,0,7405064,0
2021-01-01,Georgia,13,654950,10885,10610,22,5401054,51664,575395,8719,4825659,42945
2021-01-01,Guam,66,8295,9,123,0,96201,9,7326,9,88875,0
2021-01-01,Hawaii,15,21736,277,287,1,22120,288,22120,288,,0
2021-01-01,Idaho,16,141388,0,1438,0,569845,2563,141077,1213,428768,1350
2021-01-01,Illinois,17,966287,447,17979,0,13374665,97222,970590,7201,12404075,90021
2021-01-01,Indiana,18,520750,6295,8371,108,2649964,13269,517773,6288,2132191,6981
2021-01-01,Iowa,19,282980,1268,3898,7,1174406,3187,240766,1593,933640,1594
2021-01-01,Kansas,20,230352,4897,2879,138,1012506,11274,227745,5312,784761,5962
2021-01-01,Kentucky,21,269470,642,2956,0,3200612,0,265262,0,2935350,0
2021-01-01,Louisiana,22,315275,0,7488,0,4214182,0,315275,0,3898907,0
2021-01-01,Maine,23,24201,0,347,0,1111413,0,24201,0,1087212,0
2021-01-01,Maryland,24,280387,3553,5942,47,2818361,15893,280219,3557,2538142,12336
2021-01-01,Massachusetts,25,375178,0,12423,0,4033343,0,375178,0,3658165,0
2021-01-01,Michigan,26,527376,177,13011,1,8113075,0,528621,0,7584454,0
2021-01-01,Minnesota,27,415361,0,5382,0,2987148,0,415302,0,2571846,0
2021-01-01,Mississippi,28,218386,2575,4816,29,1346044,2575,218386,2575,1127658,0
2021-01-01,Missouri,29,421217,2580,5906,19,2054680,9808,397299,4729,1657381,5079
2021-01-01,Montana,30,81701,0,962,0,791589,0,81555,0,710034,0
2021-01-01,Nebraska,31,167799,671,1693,14,847657,3125,166798,1501,680859,1624
2021-01-01,Nevada,32,227046,1868,3146,10,1167859,5104,227046,2315,940813,2789
2021-01-01,New Hampshire,33,44028,0,759,0,523618,0,44028,0,479590,0
2021-01-01,New Jersey,34,484882,5501,19160,118,7842756,57356,532903,5918,7309853,51438
2021-01-01,New Mexico,35,144142,1245,2504,25,1983507,13295,144142,1278,1839365,12017
2021-01-01,New York,36,996073,17033,37733,176,25504313,219253,990711,16497,24513602,202756
2021-01-01,North Carolina,37,543976,2906,6819,8,6944103,0,539545,0,6404558,0
2021-01-01,North Dakota,38,92777,275,1316,17,377523,1775,92495,0,285028,1775
2021-01-01,Northern Mariana Islands,69,122,0,2,0,17551,0,122,0,17429,0
2021-01-01,Ohio,39,700380,0,8962,0,7752314,0,700380,0,7051934,0
2021-01-01,Oklahoma,40,290936,0,2489,0,2685254,17009,290936,0,2394318,17009
2021-01-01,Oregon,41,115377,1448,1501,16,2652670,20195,113909,1649,2538761,18546
2021-01-01,Pennsylvania,42,652952,6892,16247,227,3923244,17790,648039,7714,3275205,10076
2021-01-01,Puerto Rico,72,110669,763,1521,18,383026,763,77054,763,305972,0
2021-01-01,Rhode Island,44,87949,0,1777,0,641432,3767,90404,863,551028,2904
2021-01-01,South Carolina,45,307507,0,5296,0,3173021,0,307507,0,2865514,0
2021-01-01,South Dakota,46,99164,0,1488,0,372640,0,99164,0,273476,0
2021-01-01,Tennessee,47,572579,0,6846,0,5644058,0,586802,0,5057256,0
2021-01-01,Texas,48,1779961,7798,28434,279,14057515,109614,1772483,16311,12285032,93303
2021-01-01,Utah,49,276612,0,1273,3,1579103,0,276612,0,1302491,0
2021-01-01,Vermont,50,7412,0,136,0,263096,0,7412,0,255684,0
2021-01-01,Virgin Islands,78,2036,5,23,0,36212,42,2036,5,34176,37
2021-01-01,Virginia,51,354766,5182,5081,49,4349033,36904,354766,5182,3994267,31722
2021-01-01,Washington,53,251585,521,3523,0,3846407,31680,246752,4422,3599655,27258
2021-01-01,West Virginia,54,87820,2486,1361,23,1535487,20967,87820,2486,1447667,18481
2021-01-01,Wisconsin,55,522523,2085,5257,12,2879580,8473,522523,2085,2357057,6388
2021-01-01,Wyoming,56,44409,0,438,0,203937,0,44409,0,159528,0
2021-01-02,Alabama,01,369458,3711,4872,0,1963173,6676,369458,3711,1593715,2965
2021-01-02,Alaska,02,47549,809,207,9,1290349,14599,46262,801,1244087,13798
2021-01-02,Arizona,04,539162,8895,9061,46,2932486,27149,539150,8883,2393336,18266
2021-01-02,Arkansas,05,231442,2000,3729,18,2120064,12107,231442,2000,1888622,10107
2021-01-02,California,06,2397923,52197,26542,306,33391442,333131,2345909,53341,31045533,279790
2021-01-02,Colorado,08,340454,2097,4976,40,2166178,6550,339172,2011,1827006,4539
2021-01-02,Connecticut,09,190120,4412,6099,104,4383361,62668,190120,4412,4193241,58256
2021-01-02,Delaware,10,58873,809,930,0,514835,2911,58873,809,455962,2102
2021-01-02,District of Columbia,11,29509,257,792,4,911378,7076,29509,257,881869,6819
2021-01-02,Florida,12,1354825,31518,21889,217,8804536,98944,1331059,30531,7473477,68413
2021-01-02,Georgia,13,662077,7127,10612,2,5436988,35934,581999,6604,4854989,29330
2021-01-02,Guam,66,8295,0,124,1,96201,0,7326,0,88875,0
2021-01-02,Hawaii,15,21895,159,287,0,22289,169,22289,169,,0
2021-01-02,Idaho,16,142290,902,1451,13,569845,0,141077,0,428768,0
2021-01-02,Illinois,17,977677,11390,18217,238,13436652,61987,975352,4762,12461300,57225
2021-01-02,Indiana,18,526065,5315,8410,39,2660696,10732,523090,5317,2137606,5415
2021-01-02,Iowa,19,283895,915,3946,48,1175920,1514,241242,476,934678,1038
2021-01-02,Kansas,20,230352,0,2879,0,1012506,0,227745,0,784761,0
2021-01-02,Kentucky,21,275803,6333,2999,43,3264544,63932,273971,8709,2990573,55223
2021-01-02,Louisiana,22,315275,0,7488,0,4214182,0,315275,0,3898907,0
2021-01-02,Maine,23,25245,1044,358,11,1112457,1044,25245,1044,1087212,0
2021-01-02,Maryland,24,283339,2952,5967,25,2833711,15350,283171,2952,2550540,12398
2021-01-02,Massachusetts,25,384181,9003,12502,79,4063550,30207,384181,9003,3679369,21204
2021-01-02,Michigan,26,535815,8439,13296,285,8122575,9500,538121,9500,7584454,0
2021-01-02,Minnesota,27,417891,2530,5436,54,2997535,10387,417832,2530,2579703,7857
2021-01-02,Mississippi,28,220277,1891,4840,24,1347935,1891,220277,1891,1127658,0
2021-01-02,Missouri,29,423894,2677,5910,4,2060128,5448,399456,2157,1660672,3291
2021-01-02,Montana,30,81991,290,971,9,792779,1190,81944,389,710835,801
2021-01-02,Nebraska,31,168564,765,1694,1,849953,2296,167716,918,682237,1378
2021-01-02,Nevada,32,229601,2555,3158,12,1173896,6037,228871,1825,945025,4212
2021-01-02,New Hampshire,33,45184,1156,769,10,524774,1156,45184,1156,479590,0
2021-01-02,New Jersey,34,490393,5511,19187,27,7848555,5799,538702,5799,7309853,0
2021-01-02,New Mexico,35,145379,1237,2536,32,1995329,11822,145379,1237,1849950,10585
2021-01-02,New York,36,1011922,15849,37854,121,25706759,202446,1005785,15074,24700974,187372
2021-01-02,North Carolina,37,559942,15966,6933,114,7079384,135281,558437,18892,6520947,116389
2021-01-02,North Dakota,38,92898,121,1317,1,378317,794,92891,396,285426,398
2021-01-02,Northern Mariana Islands,69,122,0,2,0,17551,0,122,0,17429,0
2021-01-02,Ohio,39,714673,14293,9017,55,7819008,66694,714673,14293,7104335,52401
2021-01-02,Oklahoma,40,296055,5119,2527,38,2690373,5119,296055,5119,2394318,0
2021-01-02,Oregon,41,116348,971,1503,2,2654100,1430,115339,1430,2538761,0
2021-01-02,Pennsylvania,42,661731,8779,16270,23,3946800,23556,657292,9253,3289508,14303
2021-01-02,Puerto Rico,72,111547,878,1526,5,383904,878,77932,878,305972,0
2021-01-02,Rhode Island,44,87949,0,1777,0,644176,2744,91187,783,552989,1961
2021-01-02,South Carolina,45,312718,5211,5385,89,3204255,31234,312718,5211,2891537,26023
2021-01-02,South Dakota,46,99829,665,1501,13,373946,1306,99829,665,274117,641
2021-01-02,Tennessee,47,589406,16827,6908,62,5718900,74842,604132,17330,5114768,57512
2021-01-02,Texas,48,1793858,13897,28508,74,14214849,157334,1777246,4763,12437603,152571
2021-01-02,Utah,49,281747,5135,1294,21,1592604,13501,281654,5042,1310950,8459
2021-01-02,Vermont,50,7689,277,139,3,266219,3123,7689,277,258530,2846
2021-01-02,Virgin Islands,78,2042,6,23,0,36212,0,2036,0,34176,0
2021-01-02,Virginia,51,358755,3989,5117,36,4396731,47698,358755,3989,4037976,43709
2021-01-02,Washington,53,253290,1705,3524,1,3846407,0,246752,0,3599655,0
2021-01-02,West Virginia,54,89327,1507,1373,12,1552160,16673,89327,1507,1462833,15166
2021-01-02,Wisconsin,55,523652,1129,5259,2,2884685,5105,523652,1129,2361033,3976
2021-01-02,Wyoming,56,44573,164,438,0,204101,164,44573,164,159528,0
2021-01-03,Alabama,01,371934,2476,4873,1,1972204,9031,371934,2476,1600270,6555
2021-01-03,Alaska,02,47846,297,207,0,1293837,3488,46552,290,1247285,3198
2021-01-03,Arizona,04,556384,17222,9061,0,2950792,18306,556384,17234,2394408,1072
2021-01-03,Arkansas,05,233475,2033,3749,20,2130863,10799,233475,2033,1897388,8766
2021-01-03,California,06,2433838,35915,26635,93,33812786,421344,2391261,45352,31421525,375992
2021-01-03,Colorado,08,342494,2040,4997,21,2173125,6947,341250,2078,1831875,4869
2021-01-03,Connecticut,09,190120,0,6099,0,4383361,0,190120,0,4193241,0
2021-01-03,Delaware,10,59484,611,930,0,516770,1935,59484,611,457286,1324
2021-01-03,District of Columbia,11,29764,255,794,2,918000,6622,29764,255,888236,6367
2021-01-03,Florida,12,1365428,10603,21986,97,8838785,34249,1341287,10228,7497498,24021
2021-01-03,Georgia,13,667705,5628,10616,4,5462241,25253,587076,5077,4875165,20176
2021-01-03,Guam,66,8296,1,124,0,96202,1,7327,1,88875,0
2021-01-03,Hawaii,15,22017,122,287,0,22438,149,22438,149,,0
2021-01-03,Idaho,16,142568,278,1451,0,572571,2726,142199,1122,430372,1604
2021-01-03,Illinois,17,982105,4428,18322,105,13482117,45465,979821,4469,12502296,40996
2021-01-03,Indiana,18,529054,2989,8475,65,2667473,6777,526071,2981,2141402,3796
2021-01-03,Iowa,19,284715,820,3946,0,1178096,2176,242107,865,935989,1311
2021-01-03,Kansas,20,230352,0,2879,0,1012506,0,227745,0,784761,0
2021-01-03,Kentucky,21,278478,2675,3013,14,3267399,2855,276826,2855,2990573,0
2021-01-03,Louisiana,22,321058,5783,7537,49,4256466,42284,321058,5783,3935408,36501
2021-01-03,Maine,23,25592,347,359,1,1112804,347,25592,347,1087212,0
2021-01-03,Maryland,24,285487,2148,5994,27,2843700,9989,285319,2148,2558381,7841
2021-01-03,Massachusetts,25,387662,3481,12610,108,4075573,12023,387662,3481,3687911,8542
2021-01-03,Michigan,26,536037,222,13296,0,8122575,0,538121,0,7584454,0
2021-01-03,Minnesota,27,420603,2712,5489,53,3032167,34632,420544,2712,2611623,31920
2021-01-03,Mississippi,28,222061,1784,4871,31,1349719,1784,222061,1784,1127658,0
2021-01-03,Missouri,29,426489,2595,5928,18,2064952,4824,401761,2305,1663191,2519
2021-01-03,Montana,30,82381,390,972,1,795796,3017,82381,437,713415,2580
2021-01-03,Nebraska,31,169284,720,1696,2,851294,1341,168262,546,683032,795
2021-01-03,Nevada,32,231869,2268,3195,37,1178880,4984,231618,2747,947262,2237
2021-01-03,New Hampshire,33,46450,1266,780,11,532915,8141,46450,1266,486465,6875
2021-01-03,New Jersey,34,494063,3670,19208,21,7852643,4088,542790,4088,7309853,0
2021-01-03,New Mexico,35,146394,1015,2553,17,2006168,10839,146394,1015,1859774,9824
2021-01-03,New York,36,1024154,12232,38001,147,25849104,142345,1017153,11368,24831951,130977
2021-01-03,North Carolina,37,565260,5318,6963,30,7132661,53277,564924,6487,6567737,46790
2021-01-03,North Dakota,38,93048,150,1317,0,378535,218,93041,150,285494,68
2021-01-03,Northern Mariana Islands,69,122,0,2,0,17551,0,122,0,17429,0
2021-01-03,Ohio,39,721481,6808,9076,59,7898946,79938,721481,6808,7177465,73130
2021-01-03,Oklahoma,40,304072,8017,2547,20,2698390,8017,304072,8017,2394318,0
2021-01-03,Oregon,41,117745,1397,1510,7,2655109,1009,116348,1009,2538761,0
2021-01-03,Pennsylvania,42,666207,4476,16324,54,3959183,12383,661871,4579,3297312,7804
2021-01-03,Puerto Rico,72,111784,237,1545,19,384141,237,78169,237,305972,0
2021-01-03,Rhode Island,44,87949,0,1777,0,647242,3066,92075,888,555167,2178
2021-01-03,South Carolina,45,321669,8951,5469,84,3261427,57172,321669,8951,2939758,48221
2021-01-03,South Dakota,46,100532,703,1513,12,375955,2009,100532,703,275423,1306
2021-01-03,Tennessee,47,593363,3957,6962,54,5735403,16503,608297,4165,5127106,12338
2021-01-03,Texas,48,1810065,16207,28554,46,14264436,49587,1793341,16095,12471095,33492
2021-01-03,Utah,49,283473,1726,1301,7,1596782,4178,283473,1819,1313309,2359
2021-01-03,Vermont,50,7793,104,140,1,267090,871,7793,104,259297,767
2021-01-03,Virgin Islands,78,2042,0,23,0,36407,195,2041,5,34366,190
2021-01-03,Virginia,51,363765,5010,5124,7,4425364,28633,363765,5010,4061599,23623
2021-01-03,Washington,53,258557,5267,3524,0,3846407,0,246752,0,3599655,0
2021-01-03,West Virginia,54,91058,1731,1376,3,1560022,7862,91058,1731,1468964,6131
2021-01-03,Wisconsin,55,526245,2593,5264,5,2889420,4735,526245,2593,2363175,2142
2021-01-03,Wyoming,56,44875,302,438,0,204403,302,44875,302,159528,0
2021-01-04,Alabama,01,374095,2161,4878,5,1975997,3793,374095,2161,1601902,1632
2021-01-04,Alaska,02,48110,264,209,2,1297498,3661,46812,260,1250686,3401
2021-01-04,Arizona,04,561542,5158,9064,3,2965856,15064,561542,5158,2404314,9906
2021-01-04,Arkansas,05,234781,1306,3800,51,2136747,5884,234781,1306,1901966,4578
2021-01-04,California,06,2474561,40723,26995,360,34127013,314227,2420894,29633,31706119,284594
2021-01-04,Colorado,08,345239,2745,5011,14,2180368,7243,343435,2185,1836933,5058
2021-01-04,Connecticut,09,194636,4516,6168,69,4468860,85499,194636,4516,4274224,80983
2021-01-04,Delaware,10,60333,849,937,7,519420,2650,60333,849,459087,1801
2021-01-04,District of Columbia,11,29904,140,797,3,921119,3119,29904,140,891215,2979
2021-01-04,Florida,12,1376684,11256,22089,103,8872440,33655,1352222,10935,7520218,22720
2021-01-04,Georgia,13,672849,5144,10623,7,5482790,20549,591106,4030,4891684,16519
2021-01-04,Guam,66,8313,17,124,0,96836,634,7344,17,89492,617
2021-01-04,Hawaii,15,22092,75,287,0,22527,89,22527,89,,0
2021-01-04,Idaho,16,143833,1265,1462,11,573708,1137,142507,308,431201,829
2021-01-04,Illinois,17,987459,5354,18414,92,13530371,48254,984880,5059,12545491,43195
2021-01-04,Indiana,18,532671,3617,8514,39,2675056,7583,529688,3617,2145368,3966
2021-01-04,Iowa,19,286356,1641,3992,46,1179621,1525,242808,701,936813,824
2021-01-04,Kansas,20,234390,4038,2897,18,1024129,11623,231317,3572,792812,8051
2021-01-04,Kentucky,21,282097,3619,3067,54,3279666,12267,279143,2317,3000523,9950
2021-01-04,Louisiana,22,322181,1123,7585,48,4265759,9293,322181,1123,3943578,8170
2021-01-04,Maine,23,25968,376,360,1,1133981,21177,25968,376,1108013,20801
2021-01-04,Maryland,24,287970,2483,6027,33,2857474,13774,287802,2483,2569672,11291
2021-01-04,Massachusetts,25,392582,4920,12669,59,4091317,15744,392568,4906,3698749,10838
2021-01-04,Michigan,26,541721,5684,13381,85,8294479,171904,543611,5490,7750868,166414
2021-01-04,Minnesota,27,423747,3144,5502,13,3035190,3023,423688,3144,2611502,-121
2021-01-04,Mississippi,28,223677,1616,4884,13,1351335,1616,223677,1616,1127658,0
2021-01-04,Missouri,29,429745,3256,5941,13,2067394,2442,402957,1196,1664437,1246
2021-01-04,Montana,30,82753,372,975,3,810880,15084,82664,283,728216,14801
2021-01-04,Nebraska,31,169981,697,1714,18,853070,1776,169000,738,684070,1038
2021-01-04,Nevada,32,233337,1468,3209,14,1203326,24446,233032,1414,970294,23032
2021-01-04,New Hampshire,33,47328,878,781,1,535593,2678,47328,878,488265,1800
2021-01-04,New Jersey,34,545155,51092,19244,36,7855001,2358,545148,2358,7309853,0
2021-01-04,New Mexico,35,147315,921,2576,23,2012759,6591,147315,921,1865444,5670
2021-01-04,New York,36,1035396,11242,38167,166,25983464,134360,1028362,11209,24955102,123151
2021-01-04,North Carolina,37,572018,6758,7000,37,7167886,35225,570111,5187,6597775,30038
2021-01-04,North Dakota,38,93247,199,1319,2,378913,378,93240,199,285673,179
2021-01-04,Northern Mariana Islands,69,122,0,2,0,17551,0,122,0,17429,0
2021-01-04,Ohio,39,727423,5942,9143,67,7929279,30333,727423,5942,7201856,24391
2021-01-04,Oklahoma,40,306771,2699,2552,5,2701089,2699,306771,2699,2394318,0
2021-01-04,Oregon,41,118473,728,1517,7,2656506,1397,117745,1397,2538761,0
2021-01-04,Pennsylvania,42,670769,4562,16394,70,3966283,7100,665097,3226,3301186,3874
2021-01-04,Puerto Rico,72,112420,636,1555,10,384777,636,78805,636,305972,0
2021-01-04,Rhode Island,44,92708,4759,1855,78,649986,2744,92708,633,557278,2111
2021-01-04,South Carolina,45,325472,3803,5484,15,3282238,20811,325472,3803,2956766,17008
2021-01-04,South Dakota,46,100643,111,1513,0,376356,401,100643,111,275713,290
2021-01-04,Tennessee,47,597201,3838,7101,139,5751015,15612,612250,3953,5138765,11659
2021-01-04,Texas,48,1833180,23115,28681,127,14401977,137541,1811523,18182,12590454,119359
2021-01-04,Utah,49,285633,2160,1307,6,1602609,5827,285633,2160,1316976,3667
2021-01-04,Vermont,50,7873,80,144,4,267729,639,7873,80,259856,559
2021-01-04,Virgin Islands,78,2042,0,23,0,36408,1,2042,1,34366,0
2021-01-04,Virginia,51,367536,3771,5132,8,4444396,19032,367536,3771,4076860,15261
2021-01-04,Washington,53,261328,2771,3558,34,3919987,73580,255396,8644,3664591,64936
2021-01-04,West Virginia,54,91886,828,1396,20,1566412,6390,91886,828,1474526,5562
2021-01-04,Wisconsin,55,527871,1626,5273,9,2893551,4131,527871,1626,2365680,2505
2021-01-04,Wyoming,56,45247,372,438,0,205920,1517,45247,372,160673,1145
2021-01-05,Alabama,01,379593,5498,4886,8,1985384,9387,379593,5498,1605791,3889
2021-01-05,Alaska,02,48302,192,209,0,1302859,5361,47006,194,1255853,5167
2021-01-05,Arizona,04,571676,10134,9354,290,2982487,16631,567474,5932,2415013,10699
2021-01-05,Arkansas,05,238888,4107,3836,36,2147281,10534,238888,4107,1908393,6427
2021-01-05,California,06,2511822,37261,27486,491,34330784,203771,2452334,31440,31878450,172331
2021-01-05,Colorado,08,348483,3244,5058,47,2197782,17414,346893,3458,1850889,13956
2021-01-05,Connecticut,09,196968,2332,6192,24,4499515,30655,196968,2332,4302547,28323
2021-01-05,Delaware,10,61100,767,947,10,521750,2330,61100,767,460650,1563
2021-01-05,District of Columbia,11,30166,262,801,4,926717,5598,30166,262,896551,5336
2021-01-05,Florida,12,1392115,15431,22187,98,8921767,49327,1367778,15556,7553989,33771
2021-01-05,Georgia,13,682749,9900,10725,102,5509880,27090,597208,6102,4912672,20988
2021-01-05,Guam,66,8326,13,124,0,97503,667,7357,13,90146,654
2021-01-05,Hawaii,15,22199,107,287,0,22650,123,22650,123,,0
2021-01-05,Idaho,16,145134,1301,1474,12,575135,1427,143305,798,431830,629
2021-01-05,Illinois,17,994511,7052,18569,155,13617454,87083,991719,6839,12625735,80244
2021-01-05,Indiana,18,536084,3413,8663,149,2681739,6683,533083,3395,2148656,3288
2021-01-05,Iowa,19,288298,1942,3999,7,1181244,1623,243829,1021,937415,602
2021-01-05,Kansas,20,234700,310,2897,0,1024129,0,231317,0,792812,0
2021-01-05,Kentucky,21,284545,2448,3093,26,3289726,10060,280836,1693,3008890,8367
2021-01-05,Louisiana,22,326648,4467,7635,50,4307755,41996,326648,4467,3981107,37529
2021-01-05,Maine,23,26565,597,369,9,1143104,9123,26565,597,1116539,8526
2021-01-05,Maryland,24,289927,1957,6082,55,2865100,7626,289758,1956,2575342,5670
2021-01-05,Massachusetts,25,397202,4620,12734,65,4107541,16224,397202,4634,3710339,11590
2021-01-05,Michigan,26,544858,3137,13598,217,8319486,25007,546642,3031,7772844,21976
2021-01-05,Minnesota,27,425320,1573,5520,18,3039521,4331,425261,1573,2614260,2758
2021-01-05,Mississippi,28,225444,1767,4975,91,1409022,57687,225444,1767,1183578,55920
2021-01-05,Missouri,29,432830,3085,6123,182,2072863,5469,405589,2632,1667274,2837
2021-01-05,Montana,30,83529,776,1006,31,813082,2202,83378,714,729704,1488
2021-01-05,Nebraska,31,171294,1313,1734,20,854300,1230,169585,585,684715,645
2021-01-05,Nevada,32,235723,2386,3246,37,1208317,4991,235455,2423,972862,2568
2021-01-05,New Hampshire,33,47992,664,792,11,538456,2863,47992,664,490464,2199
2021-01-05,New Jersey,34,551419,6264,19382,138,8067673,212672,551419,6271,7516254,206401
2021-01-05,New Mexico,35,148499,1184,2596,20,2023459,10700,148499,1184,1874960,9516
2021-01-05,New York,36,1048538,13142,38315,148,26135866,152402,1041028,12666,25094838,139736
2021-01-05,North Carolina,37,578309,6291,7080,80,7200171,32285,575396,5285,6624775,27000
2021-01-05,North Dakota,38,93501,254,1336,17,379682,769,93494,254,286188,515
2021-01-05,Northern Mariana Islands,69,122,0,2,0,17551,0,122,0,17429,0
2021-01-05,Ohio,39,735003,7580,9247,104,7961105,31826,735003,7580,7226102,24246
2021-01-05,Oklahoma,40,308268,1497,2571,19,2738033,36944,308268,1497,2429765,35447
2021-01-05,Oregon,41,119508,1035,1550,33,2722774,66268,118453,708,2604321,65560
2021-01-05,Pennsylvania,42,679760,8991,16583,189,3989049,22766,673915,8818,3315134,13948
2021-01-05,Puerto Rico,72,112934,514,1562,7,385291,514,79319,514,305972,0
2021-01-05,Rhode Island,44,93852,1144,1870,15,653541,3555,93852,1144,559689,2411
2021-01-05,South Carolina,45,328073,2601,5498,14,3298481,16243,328073,2601,2970408,13642
2021-01-05,South Dakota,46,101076,433,1513,0,377362,1006,101076,433,276286,573
2021-01-05,Tennessee,47,602397,5196,7200,99,5766988,15973,617649,5399,5149339,10574
2021-01-05,Texas,48,1864187,31007,28949,268,14506462,104485,1843153,31630,12663309,72855
2021-01-05,Utah,49,288951,3318,1314,7,1609506,6897,288951,3318,1320555,3579
2021-01-05,Vermont,50,8038,165,149,5,269205,1476,8038,165,261167,1311
2021-01-05,Virgin Islands,78,2042,0,23,0,36697,289,2055,13,34642,276
2021-01-05,Virginia,51,371913,4377,5191,59,4466895,22499,371913,4377,4094982,18122
2021-01-05,Washington,53,263713,2385,3611,53,3945819,25832,256435,1039,3689384,24793
2021-01-05,West Virginia,54,93162,1276,1442,46,1576908,10496,93162,1276,1483746,9220
2021-01-05,Wisconsin,55,531890,4019,5370,97,2902375,8824,531890,4019,2370485,4805
2021-01-05,Wyoming,56,45569,322,464,26,206396,476,45569,322,160827,154
2021-01-06,Alabama,01,384184,4591,4994,108,1997125,11741,384184,4591,1612941,7150
2021-01-06,Alaska,02,48636,334,211,2,1311015,8156,47334,328,1263681,7828
2021-01-06,Arizona,04,578623,6947,9467,113,3003578,21091,574680,7206,2428898,13885
2021-01-06,Arkansas,05,242593,3705,3901,65,2162031,14750,242593,3705,1919438,11045
2021-01-06,California,06,2548494,36672,28040,554,34548621,217837,2482226,29892,32066395,187945
2021-01-06,Colorado,08,350560,2077,5080,22,2200339,2557,349450,2557,1850889,0
2021-01-06,Connecticut,09,199454,2486,6230,38,4528777,29262,199454,2486,4329323,26776
2021-01-06,Delaware,10,61729,629,947,0,523926,2176,61729,629,462197,1547
2021-01-06,District of Columbia,11,30482,316,806,5,932102,5385,30482,316,901620,5069
2021-01-06,Florida,12,1409898,17783,22316,129,8977403,55636,1385040,17262,7592363,38374
2021-01-06,Georgia,13,690137,7388,10814,89,5523221,13341,602796,5588,4920425,7753
2021-01-06,Guam,66,8347,21,124,0,97831,328,7378,21,90453,307
2021-01-06,Hawaii,15,22325,126,297,10,22792,142,22792,142,,0
2021-01-06,Idaho,16,146322,1188,1495,21,577408,2273,144843,1538,432565,735
2021-01-06,Illinois,17,1001955,7444,18738,169,13698428,80974,999288,7569,12699140,73405
2021-01-06,Indiana,18,542235,6151,8743,80,2694585,12846,539229,6146,2155356,6700
2021-01-06,Iowa,19,290776,2478,4060,61,1185478,4234,245839,2010,939639,2224
2021-01-06,Kansas,20,239988,5288,3027,130,1037519,13390,236818,5501,800701,7889
2021-01-06,Kentucky,21,289992,5447,3135,42,3304105,14379,286541,5705,3017564,8674
2021-01-06,Louisiana,22,333524,6876,7681,46,4334992,27237,333524,6876,4001468,20361
2021-01-06,Maine,23,27090,525,372,3,1151056,7952,27090,525,1123966,7427
2021-01-06,Maryland,24,293079,3152,6132,50,2879150,14050,292904,3146,2586246,10904
2021-01-06,Massachusetts,25,404053,6851,12836,102,4129431,21890,404053,6851,3725378,15039
2021-01-06,Michigan,26,549467,4609,13657,59,8364930,45444,551498,4856,7813432,40588
2021-01-06,Minnesota,27,427655,2335,5596,76,3047614,8093,427587,2326,2620027,5767
2021-01-06,Mississippi,28,228235,2791,5013,38,1411813,2791,228235,2791,1183578,0
2021-01-06,Missouri,29,435687,2857,6167,44,2078476,5613,408443,2854,1670033,2759
2021-01-06,Montana,30,84155,626,1015,9,817142,4060,84060,682,733082,3378
2021-01-06,Nebraska,31,172820,1526,1743,9,857374,3074,171033,1448,686341,1626
2021-01-06,Nevada,32,237788,2065,3301,55,1213934,5617,237393,1938,976541,3679
2021-01-06,New Hampshire,33,48838,846,816,24,541632,3176,48838,846,492794,2330
2021-01-06,New Jersey,34,557271,5852,19523,141,8113523,45850,557267,5848,7556256,40002
2021-01-06,New Mexico,35,149984,1485,2643,47,2032578,9119,149984,1485,1882594,7634
2021-01-06,New York,36,1064554,16016,38486,171,26333682,197816,1057676,16648,25276006,181168
2021-01-06,North Carolina,37,584694,6385,7149,69,7243218,43047,582348,6952,6660870,36095
2021-01-06,North Dakota,38,93839,338,1341,5,380866,1184,93832,338,287034,846
2021-01-06,Northern Mariana Islands,69,124,2,2,0,17553,2,124,2,17429,0
2021-01-06,Ohio,39,742817,7814,9368,121,7989245,28140,742817,7814,7246428,20326
2021-01-06,Oklahoma,40,311573,3305,2633,62,2758923,20890,311573,3305,2447350,17585
2021-01-06,Oregon,41,120243,735,1571,21,2723809,1035,119488,1035,2604321,0
2021-01-06,Pennsylvania,42,689162,9402,16960,377,4010345,21296,683389,9474,3326956,11822
2021-01-06,Puerto Rico,72,113227,293,1570,8,385584,293,79612,293,305972,0
2021-01-06,Rhode Island,44,95463,1611,1890,20,658097,4556,95463,1611,562634,2945
2021-01-06,South Carolina,45,333235,5162,5582,84,3326876,28395,333235,5162,2993641,23233
2021-01-06,South Dakota,46,101684,608,1519,6,379041,1679,101684,608,277357,1071
2021-01-06,Tennessee,47,610347,7950,7312,112,5799089,32101,625237,7588,5173852,24513
2021-01-06,Texas,48,1889528,25341,29278,329,14590934,84472,1867163,24010,12723771,60462
2021-01-06,Utah,49,292720,3769,1333,19,1618929,9423,292720,3769,1326209,5654
2021-01-06,Vermont,50,8158,120,152,3,269898,693,8158,120,261740,573
2021-01-06,Virgin Islands,78,2042,0,23,0,36953,256,2083,28,34870,228
2021-01-06,Virginia,51,377300,5387,5226,35,4492162,25267,377300,5387,4114862,19880
2021-01-06,Washington,53,265790,2077,3681,70,3959819,14000,258767,2332,3701052,11668
2021-01-06,West Virginia,54,94678,1516,1481,39,1588859,11951,94678,1516,1494181,10435
2021-01-06,Wisconsin,55,535999,4109,5442,72,2913052,10677,535999,4109,2377053,6568
2021-01-06,Wyoming,56,45890,321,464,0,206957,561,45890,321,161067,240
2021-01-07,Alabama,01,389230,5046,5080,86,2009678,12553,389230,5046,1620448,7507
2021-01-07,Alaska,02,48961,325,214,3,1326542,15527,47660,326,1278882,15201
2021-01-07,Arizona,04,588383,9760,9764,297,3020432,16854,584593,9913,2435839,6941
2021-01-07,Arkansas,05,245916,3323,3926,25,2174615,12584,245916,3323,1928699,9261
2021-01-07,California,06,2588891,40397,28552,512,34760355,211734,2518611,36385,32241744,175349
2021-01-07,Colorado,08,354998,4438,5164,84,2223155,22816,352923,3473,1870232,19343
2021-01-07,Connecticut,09,202758,3304,6287,57,4581696,52919,202758,3304,4378938,49615
2021-01-07,Delaware,10,62949,1220,949,2,526925,2999,62949,1220,463976,1779
2021-01-07,District of Columbia,11,30750,268,808,2,937035,4933,30750,268,906285,4665
2021-01-07,Florida,12,1429714,19816,22480,164,9038867,61464,1404374,19334,7634493,42130
2021-01-07,Georgia,13,699806,9669,10878,64,5569613,46392,609868,7072,4959745,39320
2021-01-07,Guam,66,8355,8,124,0,98270,439,7386,8,90884,431
2021-01-07,Hawaii,15,22611,286,297,0,23113,321,23113,321,,0
2021-01-07,Idaho,16,147500,1178,1519,24,580008,2600,146106,1263,433902,1337
2021-01-07,Illinois,17,1010808,8853,18944,206,13803946,105518,1008045,8757,12795901,96761
2021-01-07,Indiana,18,549514,7279,8823,80,2710638,16053,546499,7270,2164139,8783
2021-01-07,Iowa,19,293189,2413,4065,5,1188908,3430,247133,1294,941775,2136
2021-01-07,Kansas,20,240540,552,3027,0,1037519,0,236818,0,800701,0
2021-01-07,Kentucky,21,294951,4959,3161,26,3326014,21909,291430,4889,3034584,17020
2021-01-07,Louisiana,22,338054,4530,7728,47,4369449,34457,338054,4530,4031395,29927
2021-01-07,Maine,23,27625,535,385,13,1162204,11148,27625,535,1134579,10613
2021-01-07,Maryland,24,296049,2970,6173,41,2891488,12338,295874,2970,2595614,9368
2021-01-07,Massachusetts,25,411601,7548,12909,73,4155067,25636,411601,7548,3743466,18088
2021-01-07,Michigan,26,553776,4309,13863,206,8410027,45097,555747,4249,7854280,40848
2021-01-07,Minnesota,27,429638,1983,5640,44,3057808,10194,429570,1983,2628238,8211
2021-01-07,Mississippi,28,231490,3255,5061,48,1415068,3255,231490,3255,1183578,0
2021-01-07,Missouri,29,440563,4876,6238,71,2086167,7691,412426,3983,1673741,3708
2021-01-07,Montana,30,84848,693,1039,24,823279,6137,84750,690,738529,5447
2021-01-07,Nebraska,31,173799,979,1869,126,860762,3388,172469,1436,688293,1952
2021-01-07,Nevada,32,241157,3369,3349,48,1220871,6937,240795,3402,980076,3535
2021-01-07,New Hampshire,33,49261,423,827,11,543981,2349,49261,423,494720,1926
2021-01-07,New Jersey,34,564750,7479,19646,123,8121062,7539,564806,7539,7556256,0
2021-01-07,New Mexico,35,151819,1835,2682,39,2048336,15758,151819,1835,1896517,13923
2021-01-07,New York,36,1082142,17588,38683,197,26572232,238550,1075312,17636,25496920,220914
2021-01-07,North Carolina,37,595308,10614,7262,113,7314642,71424,592746,10398,6721896,61026
2021-01-07,North Dakota,38,94163,324,1348,7,381579,713,94156,324,287423,389
2021-01-07,Northern Mariana Islands,69,125,1,2,0,17554,1,125,1,17429,0
2021-01-07,Ohio,39,753068,10251,9462,94,8045803,56558,753068,10251,7292735,46307
2021-01-07,Oklahoma,40,315354,3781,2672,39,2778295,19372,315354,3781,2462941,15591
2021-01-07,Oregon,41,121087,844,1577,6,2741851,18042,120223,735,2621628,17307
2021-01-07,Pennsylvania,42,699018,9856,17220,260,4030803,20458,693087,9698,3337716,10760
2021-01-07,Puerto Rico,72,113513,286,1588,18,385870,286,79898,286,305972,0
2021-01-07,Rhode Island,44,96591,1128,1910,20,661690,3593,96591,1128,565099,2465
2021-01-07,South Carolina,45,338112,4877,5661,79,3356854,29978,338112,4877,3018742,25101
2021-01-07,South Dakota,46,102132,448,1544,25,380234,1193,102132,448,278102,745
2021-01-07,Tennessee,47,620557,10210,7424,112,5840819,41730,634237,9000,5206582,32730
2021-01-07,Texas,48,1912159,22631,29645,367,14671163,80229,1891741,24578,12779422,55651
2021-01-07,Utah,49,297317,4597,1362,29,1630416,11487,297317,4597,1333099,6890
2021-01-07,Vermont,50,8403,245,155,3,271794,1896,8403,245,263391,1651
2021-01-07,Virgin Islands,78,2042,0,23,0,37042,89,2106,23,34936,66
2021-01-07,Virginia,51,382679,5379,5275,49,4529324,37162,382679,5379,4146645,31783
2021-01-07,Washington,53,269033,3243,3719,38,3980035,20216,260752,1985,3719283,18231
2021-01-07,West Virginia,54,96002,1324,1518,37,1606517,17658,96002,1324,1510515,16334
2021-01-07,Wisconsin,55,540508,4509,5485,43,2923918,10866,540508,4509,2383410,6357
2021-01-07,Wyoming,56,46168,278,489,25,207435,478,46168,278,161267,200
2021-01-08,Alabama,01,394287,5057,5191,111,2023155,13477,394287,5057,1628868,8420
2021-01-08,Alaska,02,49366,405,214,0,1337749,11207,48063,403,1289686,10804
2021-01-08,Arizona,04,602146,13763,9970,206,3048868,28436,596251,11658,2452617,16778
2021-01-08,Arkansas,05,248860,2944,3966,40,2188857,14242,248860,2944,1939997,11298
2021-01-08,California,06,2639814,50923,29226,674,35027330,266975,2568641,50030,32458689,216945
2021-01-08,Colorado,08,357465,2467,5207,43,2234226,11071,356110,3187,1878116,7884
2021-01-08,Connecticut,09,205994,3236,6324,37,4619970,38274,205994,3236,4413976,35038
2021-01-08,Delaware,10,63503,554,957,8,528890,1965,63503,554,465387,1411
2021-01-08,District of Columbia,11,31107,357,809,1,943818,6783,31107,357,912711,6426
2021-01-08,Florida,12,1449244,19530,22665,185,9100113,61246,1423510,19136,7676603,42110
2021-01-08,Georgia,13,712785,12979,10958,80,5583994,14381,620247,10379,4963747,4002
2021-01-08,Guam,66,8368,13,125,1,98506,236,7399,13,91107,223
2021-01-08,Hawaii,15,22894,283,301,4,23421,308,23421,308,,0
2021-01-08,Idaho,16,148578,1078,1526,7,583201,3193,147173,1067,436028,2126
2021-01-08,Illinois,17,1020011,9203,19110,166,13922611,118665,1017322,9277,12905289,109388
2021-01-08,Indiana,18,555613,6099,8892,69,2724389,13751,552594,6095,2171795,7656
2021-01-08,Iowa,19,294762,1573,4124,59,1192481,3573,248741,1608,943740,1965
2021-01-08,Kansas,20,245415,4875,3148,121,1051207,13688,242322,5504,808885,8184
2021-01-08,Kentucky,21,299476,4525,3194,33,3359354,33340,296167,4737,3063187,28603
2021-01-08,Louisiana,22,341431,3377,7833,105,4399258,29809,341431,3377,4057827,26432
2021-01-08,Maine,23,28407,782,426,41,1172721,10517,28407,782,1144314,9735
2021-01-08,Maryland,24,299781,3732,6216,43,2908197,16709,299606,3732,2608591,12977
2021-01-08,Massachusetts,25,419721,8120,12985,76,4182061,26994,419721,8120,3762340,18874
2021-01-08,Michigan,26,557674,3898,13903,40,8463228,53201,559655,3908,7903573,49293
2021-01-08,Minnesota,27,432012,2374,5688,48,3070575,12767,431944,2374,2638631,10393
2021-01-08,Mississippi,28,233665,2175,5101,40,1417243,2175,233665,2175,1183578,0
2021-01-08,Missouri,29,445310,4747,6276,38,2095585,9418,416758,4332,1678827,5086
2021-01-08,Montana,30,85668,820,1049,10,831887,8608,85568,818,746319,7790
2021-01-08,Nebraska,31,174839,1040,1796,-73,863922,3160,173591,1122,690331,2038
2021-01-08,Nevada,32,244116,2959,3409,60,1228403,7532,243661,2866,984742,4666
2021-01-08,New Hampshire,33,50152,891,846,19,544872,891,50152,891,494720,0
2021-01-08,New Jersey,34,571771,7021,19756,110,8174052,52990,571755,6949,7602297,46041
2021-01-08,New Mexico,35,153456,1637,2712,30,2061985,13649,153456,1637,1908529,12012
2021-01-08,New York,36,1101702,19560,38846,163,26816135,243903,1094144,18832,25721991,225071
2021-01-08,North Carolina,37,605187,9879,7383,121,7406550,91908,602774,10028,6803776,81880
2021-01-08,North Dakota,38,94446,283,1360,12,382414,835,94438,282,287976,553
2021-01-08,Northern Mariana Islands,69,125,0,2,0,17554,0,125,0,17429,0
2021-01-08,Ohio,39,762603,9535,9544,82,8117430,71627,762603,9535,7354827,62092
2021-01-08,Oklahoma,40,320586,5232,2703,31,2797914,19619,320586,5232,2477328,14387
2021-01-08,Oregon,41,122847,1760,1590,13,2762331,20480,121085,862,2641246,19618
2021-01-08,Pennsylvania,42,709235,10217,17427,207,4055642,24839,703265,10178,3352377,14661
2021-01-08,Puerto Rico,72,115682,2169,1592,4,388039,2169,82067,2169,305972,0
2021-01-08,Rhode Island,44,97614,1023,1916,6,665270,3580,97614,1023,567656,2557
2021-01-08,South Carolina,45,344176,6064,5695,34,3398114,41260,344176,6064,3053938,35196
2021-01-08,South Dakota,46,102580,448,1556,12,381792,1558,102580,448,279212,1110
2021-01-08,Tennessee,47,627776,7219,7549,125,5875526,34707,640606,6369,5234920,28338
2021-01-08,Texas,48,1936086,23927,30109,464,14763733,92570,1915261,23520,12848472,69050
2021-01-08,Utah,49,301110,3793,1383,21,1640292,9876,301110,3793,1339182,6083
2021-01-08,Vermont,50,8619,216,156,1,275243,3449,8619,216,266624,3233
2021-01-08,Virgin Islands,78,2042,0,23,0,37469,427,2143,37,35326,390
2021-01-08,Virginia,51,387917,5238,5312,37,4566747,37423,387917,5238,4178830,32185
2021-01-08,Washington,53,273142,4109,3768,49,3997749,17714,264012,3260,3733737,14454
2021-01-08,West Virginia,54,97898,1896,1554,36,1629977,23460,97898,1896,1532079,21564
2021-01-08,Wisconsin,55,544618,4110,5530,45,2935156,11238,544618,4110,2390538,7128
2021-01-08,Wyoming,56,46647,479,489,0,208338,903,46647,479,161691,424
2021-01-09,Alabama,01,399150,4863,5299,108,2036937,13782,399150,4863,1637787,8919
2021-01-09,Alaska,02,49681,315,215,1,1345573,7824,48374,311,1297199,7513
2021-01-09,Arizona,04,611900,9754,10083,113,3077204,28336,607345,11094,2469859,17242
2021-01-09,Arkansas,05,251746,2886,4010,44,2204869,16012,251746,2886,1953123,13126
2021-01-09,California,06,2687085,47271,29699,473,35353748,326418,2621277,52636,32732471,273782
2021-01-09,Colorado,08,360857,3392,5262,55,2245796,11570,358947,2837,1886849,8733
2021-01-09,Connecticut,09,205994,0,6324,0,4619970,0,205994,0,4413976,0
2021-01-09,Delaware,10,64475,972,969,12,532124,3234,64475,972,467649,2262
2021-01-09,District of Columbia,11,31457,350,813,4,950762,6944,31457,350,919305,6594
2021-01-09,Florida,12,1464689,15445,22803,138,9146985,46872,1438579,15069,7708406,31803
2021-01-09,Georgia,13,724317,11532,11096,138,5632471,48477,629204,8957,5003267,39520
2021-01-09,Guam,66,8373,5,125,0,98511,5,7404,5,91107,0
2021-01-09,Hawaii,15,23122,228,305,4,23669,248,23669,248,,0
2021-01-09,Idaho,16,149316,738,1530,4,585675,2474,148258,1085,437417,1389
2021-01-09,Illinois,17,1026639,6628,19212,102,14025514,102903,1024039,6717,13001475,96186
2021-01-09,Indiana,18,561579,5966,8966,74,2738914,14525,558560,5966,2180354,8559
2021-01-09,Iowa,19,296171,1409,4127,3,1195536,3055,249813,1072,945723,1983
2021-01-09,Kansas,20,245521,106,3148,0,1051207,0,242322,0,808885,0
2021-01-09,Kentucky,21,303769,4293,3214,20,3370860,11506,300398,4231,3070462,7275
2021-01-09,Louisiana,22,341431,0,7833,0,4399258,0,341431,0,4057827,0
2021-01-09,Maine,23,29019,612,432,6,1173333,612,29019,612,1144314,0
2021-01-09,Maryland,24,303535,3754,6246,30,2924609,16412,303364,3758,2621245,12654
2021-01-09,Massachusetts,25,427135,7414,13074,89,4207655,25594,427135,7414,3780520,18180
2021-01-09,Michigan,26,560419,2745,14134,231,8515027,51799,562553,2898,7952474,48901
2021-01-09,Minnesota,27,434481,2469,5731,43,3084316,13741,434413,2469,2649903,11272
2021-01-09,Mississippi,28,236868,3203,5146,45,1420446,3203,236868,3203,1183578,0
2021-01-09,Missouri,29,448586,3276,6309,33,2105544,9959,420583,3825,1684961,6134
2021-01-09,Montana,30,86116,448,1054,5,837136,5249,86102,534,751034,4715
2021-01-09,Nebraska,31,175842,1003,1800,4,866318,2396,174614,1023,691704,1373
2021-01-09,Nevada,32,246659,2543,3457,48,1233859,5456,246309,2648,987550,2808
2021-01-09,New Hampshire,33,50871,719,862,16,545591,719,50871,719,494720,0
2021-01-09,New Jersey,34,579182,7411,19854,98,8240865,66813,579182,7427,7661683,59386
2021-01-09,New Mexico,35,154954,1498,2734,22,2078816,16831,154954,1498,1923862,15333
2021-01-09,New York,36,1119541,17839,39041,195,27074166,258031,1111087,16943,25963079,241088
2021-01-09,North Carolina,37,614715,9528,7468,85,7487537,80987,614355,11581,6873182,69406
2021-01-09,North Dakota,38,94566,120,1360,0,382316,-98,94558,120,287758,-218
2021-01-09,Northern Mariana Islands,69,125,0,2,0,17554,0,125,0,17429,0
2021-01-09,Ohio,39,770977,8374,9599,55,8177714,60284,770977,8374,7406737,51910
2021-01-09,Oklahoma,40,324875,4289,2738,35,2824791,26877,324875,4289,2499916,22588
2021-01-09,Oregon,41,124476,1629,1607,17,2786624,24293,122847,1762,2663777,22531
2021-01-09,Pennsylvania,42,718642,9407,17681,254,4080903,25261,713310,10045,3367593,15216
2021-01-09,Puerto Rico,72,116245,563,1616,24,388602,563,82630,563,305972,0
2021-01-09,Rhode Island,44,97614,0,1916,0,669430,4160,99001,1387,570429,2773
2021-01-09,South Carolina,45,350084,5908,5758,63,3434733,36619,350084,5908,3084649,30711
2021-01-09,South Dakota,46,102901,321,1570,14,383093,1301,102901,321,280192,980
2021-01-09,Tennessee,47,634222,6446,7634,85,5908921,33395,646450,5844,5262471,27551
2021-01-09,Texas,48,1953816,17730,30441,332,14888728,124995,1938551,23290,12950177,101705
2021-01-09,Utah,49,303723,2613,1392,9,1647570,7278,303723,2613,1343847,4665
2021-01-09,Vermont,50,8790,171,156,0,277491,2248,8790,171,268701,2077
2021-01-09,Virgin Islands,78,2042,0,23,0,37469,0,2143,0,35326,0
2021-01-09,Virginia,51,393715,5798,5381,69,4606158,39411,393715,5798,4212443,33613
2021-01-09,Washington,53,275832,2690,3775,7,4020944,23195,268607,4595,3752337,18600
2021-01-09,West Virginia,54,99778,1880,1570,16,1649119,19142,99778,1880,1549341,17262
2021-01-09,Wisconsin,55,548134,3516,5568,38,2944240,9084,548134,3516,2396106,5568
2021-01-09,Wyoming,56,46719,72,489,0,208410,72,46719,72,161691,0
2021-01-10,Alabama,01,401900,2750,5334,35,2047271,10334,401900,2750,1645371,7584
2021-01-10,Alaska,02,49935,254,215,0,1352480,6907,48624,250,1303856,6657
2021-01-10,Arizona,04,618546,6646,10141,58,3108717,31513,618546,11201,2490171,20312
2021-01-10,Arkansas,05,255076,3330,4043,33,2239922,35053,255076,3330,1984846,31723
2021-01-10,California,06,2729525,42440,30000,301,35826824,473076,2670962,49685,33155862,423391
2021-01-10,Colorado,08,363019,2162,5279,17,2255969,10173,361148,2201,1894821,7972
2021-01-10,Connecticut,09,205994,0,6324,0,4619970,0,205994,0,4413976,0
2021-01-10,Delaware,10,65273,798,972,3,535558,3434,65273,798,470285,2636
2021-01-10,District of Columbia,11,31791,334,817,4,957350,6588,31791,334,925559,6254
2021-01-10,Florida,12,1477002,12313,22911,108,9194748,47763,1450620,12041,7744128,35722
2021-01-10,Georgia,13,732121,7804,11097,1,5672290,39819,636373,7169,5035917,32650
2021-01-10,Guam,66,8381,8,125,0,98519,8,7412,8,91107,0
2021-01-10,Hawaii,15,23300,178,306,1,23867,198,23867,198,,0
2021-01-10,Idaho,16,149742,426,1536,6,587806,2131,149235,977,438571,1154
2021-01-10,Illinois,17,1031288,4649,19295,83,14103289,77775,1028750,4711,13074539,73064
2021-01-10,Indiana,18,566670,5091,8985,19,2752524,13610,563653,5093,2188871,8517
2021-01-10,Iowa,19,296682,511,4138,11,1198291,2755,250753,940,947538,1815
2021-01-10,Kansas,20,245529,8,3148,0,1051207,0,242322,0,808885,0
2021-01-10,Kentucky,21,306823,3054,3224,10,3374087,3227,303625,3227,3070462,0
2021-01-10,Louisiana,22,346829,5398,7873,40,4445919,46661,346829,5398,4099090,41263
2021-01-10,Maine,23,29298,279,432,0,1173612,279,29298,279,1144314,0
2021-01-10,Maryland,24,306853,3318,6272,26,2942739,18130,306674,3310,2636065,14820
2021-01-10,Massachusetts,25,432791,5656,13151,77,4228168,20513,432791,5656,3795377,14857
2021-01-10,Michigan,26,560475,56,14134,0,8515027,0,562553,0,7952474,0
2021-01-10,Minnesota,27,436640,2159,5775,44,3099396,15080,436572,2159,2662824,12921
2021-01-10,Mississippi,28,239082,2214,5167,21,1422660,2214,239082,2214,1183578,0
2021-01-10,Missouri,29,450886,2300,6316,7,2114751,9207,423327,2744,1691424,6463
2021-01-10,Montana,30,86324,208,1056,2,842250,5114,86324,222,755926,4892
2021-01-10,Nebraska,31,176200,358,1803,3,869133,2815,175620,1006,693513,1809
2021-01-10,Nevada,32,248758,2099,3470,13,1239164,5305,248568,2259,990596,3046
2021-01-10,New Hampshire,33,51600,729,869,7,546320,729,51600,729,494720,0
2021-01-10,New Jersey,34,584828,5646,19886,32,8246511,5646,584828,5646,7661683,0
2021-01-10,New Mexico,35,156157,1203,2751,17,2093575,14759,156157,1203,1937418,13556
2021-01-10,New York,36,1135849,16308,39208,167,27321002,246836,1126442,15355,26194560,231481
2021-01-10,North Carolina,37,623503,8788,7609,141,7555356,67819,623188,8833,6932168,58986
2021-01-10,North Dakota,38,94724,158,1360,0,382474,158,94716,158,287758,0
2021-01-10,Northern Mariana Islands,69,125,0,2,0,17554,0,125,0,17429,0
2021-01-10,Ohio,39,777065,6088,9627,28,8232244,54530,777065,6088,7455179,48442
2021-01-10,Oklahoma,40,331362,6487,2761,23,2831278,6487,331362,6487,2499916,0
2021-01-10,Oregon,41,125683,1207,1607,0,2788253,1629,124476,1629,2663777,0
2021-01-10,Pennsylvania,42,725506,6864,17780,99,4102279,21376,720816,7506,3381463,13870
2021-01-10,Puerto Rico,72,116734,489,1630,14,389091,489,83119,489,305972,0
2021-01-10,Rhode Island,44,97614,0,1916,0,673866,4436,100039,1038,573827,3398
2021-01-10,South Carolina,45,354525,4441,5811,53,3466585,31852,354525,4441,3112060,27411
2021-01-10,South Dakota,46,103318,417,1585,15,384161,1068,103318,417,280843,651
2021-01-10,Tennessee,47,641123,6901,7715,81,5948059,39138,653869,7419,5294190,31719
2021-01-10,Texas,48,1967859,14043,30599,158,15028626,139898,1954406,15855,13074220,124043
2021-01-10,Utah,49,305999,2276,1393,1,1654926,7356,305999,2276,1348927,5080
2021-01-10,Vermont,50,8967,177,156,0,279396,1905,8967,177,270429,1728
2021-01-10,Virgin Islands,78,2042,0,23,0,37469,0,2143,0,35326,0
2021-01-10,Virginia,51,398856,5141,5383,2,4657823,51665,398856,5141,4258967,46524
2021-01-10,Washington,53,276333,501,3776,1,4046009,25065,271595,2988,3774414,22077
2021-01-10,West Virginia,54,101212,1434,1582,12,1662374,13255,101212,1434,1561162,11821
2021-01-10,Wisconsin,55,550260,2126,5571,3,2951996,7756,550260,2126,2401736,5630
2021-01-10,Wyoming,56,46832,113,489,0,208523,113,46832,113,161691,0
2021-01-11,Alabama,01,404000,2100,5347,13,2053818,6547,404000,2100,1649818,4447
2021-01-11,Alaska,02,50111,176,215,0,1357708,5228,48797,173,1308911,5055
2021-01-11,Arizona,04,627771,9225,10147,6,3131257,22540,627541,8995,2503716,13545
2021-01-11,Arkansas,05,256344,1268,4081,38,2250057,10135,256344,1268,1993713,8867
2021-01-11,California,06,2770065,40540,30381,381,36170528,343704,2710801,39839,33459727,303865
2021-01-11,Colorado,08,364815,1796,5291,12,2263526,7557,362825,1677,1900701,5880
2021-01-11,Connecticut,09,213358,7364,6416,92,4736445,116475,213358,7364,4523087,109111
2021-01-11,Delaware,10,65827,554,986,14,537981,2423,65827,554,472154,1869
2021-01-11,District of Columbia,11,31993,202,821,4,960916,3566,31993,202,928923,3364
2021-01-11,Florida,12,1488578,11576,23070,159,9232861,38113,1461958,11338,7770903,26775
2021-01-11,Georgia,13,740078,7957,11113,16,5708060,35770,642712,6339,5065348,29431
2021-01-11,Guam,66,8392,11,125,0,99160,641,7423,11,91737,630
2021-01-11,Hawaii,15,23462,162,306,0,24039,172,24039,172,,0
2021-01-11,Idaho,16,150557,815,1552,16,589305,1499,149667,432,439638,1067
2021-01-11,Illinois,17,1036450,5162,19365,70,14169986,66697,1033526,4776,13136460,61921
2021-01-11,Indiana,18,570355,3685,9016,31,2762573,10049,567338,3685,2195235,6364
2021-01-11,Iowa,19,297774,1092,4139,1,1199759,1468,251229,476,948530,992
2021-01-11,Kansas,20,250421,4892,3255,107,1066516,15309,247502,5180,819014,10129
2021-01-11,Kentucky,21,309414,2591,3247,23,3396611,22524,305707,2082,3090904,20442
2021-01-11,Louisiana,22,348234,1405,7918,45,4458747,12828,348234,1405,4110513,11423
2021-01-11,Maine,23,29611,313,438,6,1196269,22657,29611,313,1166658,22344
2021-01-11,Maryland,24,309874,3021,6301,29,2959264,16525,309686,3012,2649578,13513
2021-01-11,Massachusetts,25,437042,4251,13206,55,4245081,16913,437042,4251,3808039,12662
2021-01-11,Michigan,26,565845,5370,14183,49,8588813,73786,567682,5129,8021131,68657
2021-01-11,Minnesota,27,437620,980,5779,4,3105893,6497,437552,980,2668341,5517
2021-01-11,Mississippi,28,240309,1227,5186,19,1463235,40575,240309,1227,1222926,39348
2021-01-11,Missouri,29,454492,3606,6336,20,2119650,4899,424986,1659,1694664,3240
2021-01-11,Montana,30,86757,433,1057,1,845439,3189,86653,329,758786,2860
2021-01-11,Nebraska,31,176831,631,1823,20,870467,1334,176026,406,694441,928
2021-01-11,Nevada,32,250484,1726,3503,33,1243822,4658,250249,1681,993573,2977
2021-01-11,New Hampshire,33,52307,707,869,0,562225,15905,52307,707,509918,15198
2021-01-11,New Jersey,34,590165,5337,19932,46,8251845,5334,590162,5334,7661683,0
2021-01-11,New Mexico,35,157087,930,2766,15,2101155,7580,157087,930,1944068,6650
2021-01-11,New York,36,1150028,14179,39404,196,27524906,203904,1140156,13714,26384750,190190
2021-01-11,North Carolina,37,632994,9491,7635,26,7668690,113334,629124,5936,7039566,107398
2021-01-11,North Dakota,38,94838,114,1360,0,382588,114,94830,114,287758,0
2021-01-11,Northern Mariana Islands,69,125,0,2,0,17554,0,125,0,17429,0
2021-01-11,Ohio,39,784957,7892,9702,75,8274273,42029,784957,7892,7489316,34137
2021-01-11,Oklahoma,40,335247,3885,2775,14,2835163,3885,335247,3885,2499916,0
2021-01-11,Oregon,41,126607,924,1628,21,2789460,1207,125683,1207,2663777,0
2021-01-11,Pennsylvania,42,731967,6461,17861,81,4118400,16121,726154,5338,3392246,10783
2021-01-11,Puerto Rico,72,117083,349,1642,12,389440,349,83468,349,305972,0
2021-01-11,Rhode Island,44,100607,2993,1947,31,676409,2543,100607,568,575802,1975
2021-01-11,South Carolina,45,357654,3129,5826,15,3488615,22030,357654,3129,3130961,18901
2021-01-11,South Dakota,46,103499,181,1585,0,384712,551,103499,181,281213,370
2021-01-11,Tennessee,47,645378,4255,7795,80,5969654,21595,657396,3527,5312258,18068
2021-01-11,Texas,48,1991625,23766,30720,121,15178233,149607,1969240,14834,13208993,134773
2021-01-11,Utah,49,307502,1503,1400,7,1659499,4573,307483,1484,1352016,3089
2021-01-11,Vermont,50,9078,111,156,0,280247,851,9078,111,271169,740
2021-01-11,Virgin Islands,78,2042,0,23,0,37469,0,2143,0,35326,0
2021-01-11,Virginia,51,403386,4530,5393,10,4691796,33973,403386,4530,4288410,29443
2021-01-11,Washington,53,281071,4738,3793,17,4046009,0,271595,0,3774414,0
2021-01-11,West Virginia,54,102282,1070,1594,12,1674403,12029,102282,1070,1572121,10959
2021-01-11,Wisconsin,55,551942,1682,5576,5,2957676,5680,551942,1682,2405734,3998
2021-01-11,Wyoming,56,47395,563,489,0,209667,1144,47395,563,162272,581
2021-01-12,Alabama,01,407848,3848,5573,226,2063791,9973,407848,3848,1655943,6125
2021-01-12,Alaska,02,50243,132,216,1,1357708,0,48797,0,1308911,0
2021-01-12,Arizona,04,638739,10968,10537,390,3149994,18737,636100,8559,2513894,10178
2021-01-12,Arkansas,05,259553,3209,4121,40,2257416,7359,259553,3209,1997863,4150
2021-01-12,California,06,2815933,45868,31105,724,36508384,337856,2747288,36487,33761096,301369
2021-01-12,Colorado,08,366385,1570,5326,35,2269328,5802,364336,1511,1904992,4291
2021-01-12,Connecticut,09,217047,3689,6449,33,4771175,34730,217047,3689,4554128,31041
2021-01-12,Delaware,10,66446,619,991,5,539733,1752,66446,619,473287,1133
2021-01-12,District of Columbia,11,32423,430,825,4,970048,9132,32423,430,937625,8702
2021-01-12,Florida,12,1503474,14896,23226,156,9287639,54778,1476484,14526,7811155,40252
2021-01-12,Georgia,13,749417,9339,11297,184,5737862,29802,648694,5982,5089168,23820
2021-01-12,Guam,66,8398,6,125,0,99503,343,7423,0,92080,343
2021-01-12,Hawaii,15,23570,108,306,0,24153,114,24153,114,,0
2021-01-12,Idaho,16,151474,917,1563,11,591437,2132,150239,572,441198,1560
2021-01-12,Illinois,17,1043041,6591,19497,132,14263477,93491,1040168,6642,13223309,86849
2021-01-12,Indiana,18,573505,3150,9104,88,2770157,7584,570477,3139,2199680,4445
2021-01-12,Iowa,19,299254,1480,4222,83,1201471,1712,251866,637,949605,1075
2021-01-12,Kansas,20,250646,225,3255,0,1066516,0,247502,0,819014,0
2021-01-12,Kentucky,21,312316,2902,3284,37,3405698,9087,308729,3022,3096969,6065
2021-01-12,Louisiana,22,352939,4705,7971,53,4508788,50041,352939,4705,4155849,45336
2021-01-12,Maine,23,30326,715,449,11,1203694,7425,30326,715,1173368,6710
2021-01-12,Maryland,24,312534,2660,6367,66,2971093,11829,312351,2665,2658742,9164
2021-01-12,Massachusetts,25,442529,5487,13273,67,4264629,19548,442529,5487,3822100,14061
2021-01-12,Michigan,26,568523,2678,14286,103,8624043,35230,570150,2468,8053893,32762
2021-01-12,Minnesota,27,438935,1315,5792,13,3113995,8102,438867,1315,2675128,6787
2021-01-12,Mississippi,28,241957,1648,5284,98,1464883,1648,241957,1648,1222926,0
2021-01-12,Missouri,29,456978,2486,6495,159,2125139,5489,427117,2131,1698022,3358
2021-01-12,Montana,30,87179,422,1067,10,851594,6155,87077,424,764517,5731
2021-01-12,Nebraska,31,177883,1052,1847,24,871838,1371,176670,644,695168,727
2021-01-12,Nevada,32,253100,2616,3551,48,1250330,6508,252842,2593,997488,3915
2021-01-12,New Hampshire,33,53148,841,878,9,562848,623,53148,841,509700,-218
2021-01-12,New Jersey,34,594751,4586,20039,107,8469406,217561,594749,4587,7874657,212974
2021-01-12,New Mexico,35,157974,887,2796,30,2113785,12630,157974,887,1955811,11743
2021-01-12,New York,36,1164819,14791,39588,184,27721577,196671,1155370,15214,26566207,181457
2021-01-12,North Carolina,37,638330,5336,7687,52,7727649,58959,635975,6851,7091674,52108
2021-01-12,North Dakota,38,94976,138,1363,3,384279,1691,94968,138,289311,1553
2021-01-12,Northern Mariana Islands,69,128,3,2,0,17557,3,128,3,17429,0
2021-01-12,Ohio,39,792938,7981,9802,100,8315727,41454,792938,7981,7522789,33473
2021-01-12,Oklahoma,40,337457,2210,2804,29,2864080,28917,337457,2210,2526623,26707
2021-01-12,Oregon,41,127791,1184,1669,41,2839839,50379,126607,924,2713232,49455
2021-01-12,Pennsylvania,42,739212,7245,18091,230,4136589,18189,733429,7275,3403160,10914
2021-01-12,Puerto Rico,72,118042,959,1645,3,390399,959,84427,959,305972,0
2021-01-12,Rhode Island,44,101393,786,1970,23,679890,3481,101393,786,578497,2695
2021-01-12,South Carolina,45,359357,1703,5860,34,3498188,9573,359357,1703,3138831,7870
2021-01-12,South Dakota,46,103743,244,1585,0,385382,670,103743,244,281639,426
2021-01-12,Tennessee,47,649227,3849,7941,146,5986016,16362,660874,3478,5325142,12884
2021-01-12,Texas,48,2018685,27060,31017,297,15273764,95531,1995292,26052,13278472,69479
2021-01-12,Utah,49,309629,2127,1422,22,1666430,6931,309629,2146,1356801,4785
2021-01-12,Vermont,50,9247,169,158,2,280411,164,9247,169,271164,-5
2021-01-12,Virgin Islands,78,2166,124,24,1,37925,456,2166,23,35759,433
2021-01-12,Virginia,51,407947,4561,5477,84,4712711,20915,407947,4561,4304764,16354
2021-01-12,Washington,53,283363,2292,3869,76,4098905,52896,276686,5091,3822219,47805
2021-01-12,West Virginia,54,103203,921,1634,40,1684532,10129,103203,921,1581329,9208
2021-01-12,Wisconsin,55,555249,3307,5635,59,2964829,7153,555249,3307,2409580,3846
2021-01-12,Wyoming,56,48072,677,522,33,210259,592,48072,677,162187,-85
2021-01-13,Alabama,01,410995,3147,5760,187,2073591,9800,410995,3147,1662596,6653
2021-01-13,Alaska,02,50526,283,217,1,1370835,13127,49203,406,1321632,12721
2021-01-13,Arizona,04,643683,4944,10689,152,3166616,16622,641729,5629,2524887,10993
2021-01-13,Arkansas,05,262020,2467,4186,65,2268980,11564,262020,2467,2006960,9097
2021-01-13,California,06,2857587,41654,31653,548,36842651,334267,2781039,33751,34061612,300516
2021-01-13,Colorado,08,368775,2390,5354,28,2279001,9673,366774,2438,1912227,7235
2021-01-13,Connecticut,09,220576,3529,6536,87,4828069,56894,220576,3529,4607493,53365
2021-01-13,Delaware,10,67173,727,994,3,543353,3620,67173,727,476180,2893
2021-01-13,District of Columbia,11,32600,177,831,6,973570,3522,32600,177,940970,3345
2021-01-13,Florida,12,1517464,13990,23395,169,9340336,52697,1490148,13664,7850188,39033
2021-01-13,Georgia,13,757993,8576,11435,138,5763974,26112,654356,5662,5109618,20450
2021-01-13,Guam,66,8413,15,125,0,99819,316,7444,21,92375,295
2021-01-13,Hawaii,15,23663,93,309,3,24259,106,24259,106,,0
2021-01-13,Idaho,16,152560,1086,1576,13,593250,1813,151273,1034,441977,779
2021-01-13,Illinois,17,1048784,5743,19619,122,14339584,76107,1046030,5862,13293554,70245
2021-01-13,Indiana,18,577153,3648,9163,59,2779991,9834,574119,3642,2205872,6192
2021-01-13,Iowa,19,301161,1907,4232,10,1205222,3751,253307,1441,951915,2310
2021-01-13,Kansas,20,255200,4554,3355,100,1083932,17416,252041,4539,831891,12877
2021-01-13,Kentucky,21,316673,4357,3324,40,3430451,24753,313282,4553,3117169,20200
2021-01-13,Louisiana,22,355835,2896,8022,51,4527858,19070,355835,2896,4172023,16174
2021-01-13,Maine,23,31150,824,453,4,1214698,11004,31150,824,1183548,10180
2021-01-13,Maryland,24,315055,2521,6404,37,2982429,11336,314867,2516,2667562,8820
2021-01-13,Massachusetts,25,448447,5918,13359,86,4286064,21435,448447,5918,3837617,15517
2021-01-13,Michigan,26,571638,3115,14325,39,8665671,41628,573278,3128,8092393,38500
2021-01-13,Minnesota,27,440422,1487,5842,50,3121633,7638,440354,1487,2681279,6151
2021-01-13,Mississippi,28,243899,1942,5315,31,1466825,1942,243899,1942,1222926,0
2021-01-13,Missouri,29,459428,2450,6538,43,2131006,5867,429177,2060,1701829,3807
2021-01-13,Montana,30,87759,580,1069,2,855069,3475,87653,576,767416,2899
2021-01-13,Nebraska,31,179333,1450,1858,11,874109,2271,177670,1000,696439,1271
2021-01-13,Nevada,32,254056,956,3596,45,1255166,4836,253985,1143,1001181,3693
2021-01-13,New Hampshire,33,54125,977,885,7,565850,3002,54125,977,511725,2025
2021-01-13,New Jersey,34,602629,7878,20166,127,8477286,7880,602629,7880,7874657,0
2021-01-13,New Mexico,35,159119,1145,2809,13,2124990,11205,159119,1145,1965871,10060
2021-01-13,New York,36,1179523,14704,39760,172,27918445,196868,1169947,14577,26748498,182291
2021-01-13,North Carolina,37,643520,5190,7796,109,7766179,38530,641073,5098,7125106,33432
2021-01-13,North Dakota,38,95142,166,1364,1,385019,740,95135,167,289884,573
2021-01-13,Northern Mariana Islands,69,128,0,2,0,17557,0,128,0,17429,0
2021-01-13,Ohio,39,799639,6701,9881,79,8342734,27007,799639,6701,7543095,20306
2021-01-13,Oklahoma,40,341364,3907,2848,44,2889390,25310,341364,3907,2548026,21403
2021-01-13,Oregon,41,129109,1318,1716,47,2856686,16847,127780,1173,2728906,15674
2021-01-13,Pennsylvania,42,747245,8033,18458,367,4157761,21172,741389,7960,3416372,13212
2021-01-13,Puerto Rico,72,118254,212,1659,14,390611,212,84639,212,305972,0
2021-01-13,Rhode Island,44,102485,1092,1987,17,684208,4318,102485,1092,581723,3226
2021-01-13,South Carolina,45,365378,6021,5911,51,3535436,37248,365378,6021,3170058,31227
2021-01-13,South Dakota,46,104195,452,1604,19,387299,1917,104195,452,283104,1465
2021-01-13,Tennessee,47,653568,4341,8072,131,6008119,22103,665499,4625,5342620,17478
2021-01-13,Texas,48,2042009,23324,31396,379,15426104,152340,2022635,27343,13403469,124997
2021-01-13,Utah,49,314817,5188,1449,27,1676322,9892,314817,5188,1361505,4704
2021-01-13,Vermont,50,9368,121,158,0,281278,867,9368,121,271910,746
2021-01-13,Virgin Islands,78,2166,0,24,0,37925,0,2166,0,35759,0
2021-01-13,Virginia,51,412545,4598,5552,75,4747707,34996,412545,4598,4335162,30398
2021-01-13,Washington,53,285690,2327,3909,40,4122490,23585,278544,1858,3843946,21727
2021-01-13,West Virginia,54,104392,1189,1671,37,1697113,12581,104392,1189,1592721,11392
2021-01-13,Wisconsin,55,558020,2771,5679,44,2972893,8064,558020,2771,2414873,5293
2021-01-13,Wyoming,56,48289,217,522,0,210697,438,48289,217,162408,221
2021-01-14,Alabama,01,414583,3588,5945,185,2084545,10954,414583,3588,1669962,7366
2021-01-14,Alaska,02,50861,335,219,2,1382276,11441,49535,332,1332741,11109
2021-01-14,Arizona,04,653546,9863,10876,187,3188785,22169,649040,7311,2539745,14858
2021-01-14,Arkansas,05,264511,2491,4228,42,2284156,15176,264511,2491,2019645,12685
2021-01-14,California,06,2898271,40684,32246,593,37130366,287715,2816969,35930,34313397,251785
2021-01-14,Colorado,08,371362,2587,5385,31,2287631,8630,369177,2403,1918454,6227
2021-01-14,Connecticut,09,221544,968,6553,17,4850459,22390,221544,968,4628915,21422
2021-01-14,Delaware,10,68065,892,995,1,546399,3046,68065,892,478334,2154
2021-01-14,District of Columbia,11,32820,220,842,11,978833,5263,32820,220,946013,5043
2021-01-14,Florida,12,1531184,13720,23612,217,9391152,50816,1503529,13381,7887623,37435
2021-01-14,Georgia,13,766917,8924,11599,164,5801007,37033,660720,6364,5140287,30669
2021-01-14,Guam,66,8426,13,125,0,100223,404,7457,13,92766,391
2021-01-14,Hawaii,15,23827,164,315,6,24434,175,24434,175,,0
2021-01-14,Idaho,16,153506,946,1593,17,596527,3277,152364,1091,444163,2186
2021-01-14,Illinois,17,1055550,6766,19728,109,14457620,118036,1052682,6652,13404938,111384
2021-01-14,Indiana,18,581534,4381,9202,39,2792291,12300,578494,4375,2213797,7925
2021-01-14,Iowa,19,302559,1398,4251,19,1208878,3656,254453,1146,954425,2510
2021-01-14,Kansas,20,255393,193,3355,0,1083932,0,252041,0,831891,0
2021-01-14,Kentucky,21,320466,3793,3373,49,3443213,12762,317345,4063,3125868,8699
2021-01-14,Louisiana,22,361148,5313,8080,58,4563949,36091,361148,5313,4202801,30778
2021-01-14,Maine,23,31958,808,461,8,1223968,9270,31958,808,1192010,8462
2021-01-14,Maryland,24,318002,2947,6449,45,2997160,14731,317815,2948,2679345,11783
2021-01-14,Massachusetts,25,454402,5955,13433,74,4308517,22453,454402,5955,3854115,16498
2021-01-14,Michigan,26,575306,3668,14500,175,8714839,49168,576573,3295,8138266,45873
2021-01-14,Minnesota,27,442003,1581,5885,43,3130235,8602,441935,1581,2688300,7021
2021-01-14,Mississippi,28,245847,1948,5356,41,1468773,1948,245847,1948,1222926,0
2021-01-14,Missouri,29,462318,2890,6590,52,2138524,7518,431957,2780,1706567,4738
2021-01-14,Montana,30,88190,431,1079,10,862427,7358,88110,457,774317,6901
2021-01-14,Nebraska,31,180285,952,1873,15,878807,4698,179199,1529,699608,3169
2021-01-14,Nevada,32,256476,2420,3664,68,1261591,6425,256172,2187,1005419,4238
2021-01-14,New Hampshire,33,54778,653,897,12,569601,3751,54778,653,514823,3098
2021-01-14,New Jersey,34,609721,7092,20253,87,8534237,56951,609721,7092,7924516,49859
2021-01-14,New Mexico,35,160543,1424,2838,29,2140562,15572,160543,1424,1980019,14148
2021-01-14,New York,36,1193710,14187,39997,237,28131034,212589,1183608,13661,26947426,198928
2021-01-14,North Carolina,37,651533,8013,7888,92,7850168,83989,650926,9853,7199242,74136
2021-01-14,North Dakota,38,95385,243,1372,8,386131,1112,95378,243,290753,869
2021-01-14,Northern Mariana Islands,69,128,0,2,0,17557,0,128,0,17429,0
2021-01-14,Ohio,39,807293,7654,9990,109,8398106,55372,807293,7654,7590813,47718
2021-01-14,Oklahoma,40,344506,3142,2882,34,2908367,18977,344506,3142,2563861,15835
2021-01-14,Oregon,41,130246,1137,1737,21,2874572,17886,129109,1329,2745463,16557
2021-01-14,Pennsylvania,42,754441,7196,18752,294,4176539,18778,748564,7175,3427975,11603
2021-01-14,Puerto Rico,72,118431,177,1679,20,390788,177,84816,177,305972,0
2021-01-14,Rhode Island,44,103386,901,1996,9,688576,4368,103386,901,585190,3467
2021-01-14,South Carolina,45,371180,5802,5934,23,3576120,40684,371180,5802,3204940,34882
2021-01-14,South Dakota,46,104512,317,1614,10,388172,873,104512,317,283660,556
2021-01-14,Tennessee,47,658431,4863,8155,83,6033531,25412,670482,4983,5363049,20429
2021-01-14,Texas,48,2071932,29923,31819,423,15555613,129509,2045699,23064,13509914,106445
2021-01-14,Utah,49,317559,2742,1461,12,1684338,8016,317559,2742,1366779,5274
2021-01-14,Vermont,50,9573,205,162,4,282765,1487,9573,205,273192,1282
2021-01-14,Virgin Islands,78,2166,0,24,0,37925,0,2166,0,35759,0
2021-01-14,Virginia,51,417839,5294,5626,74,4781249,33542,417839,5294,4363410,28248
2021-01-14,Washington,53,288127,2437,3949,40,4140418,17928,281202,2658,3859216,15270
2021-01-14,West Virginia,54,105219,827,1702,31,1711057,13944,105219,827,1605838,13117
2021-01-14,Wisconsin,55,561160,3140,5729,50,2983020,10127,561160,3140,2421860,6987
2021-01-14,Wyoming,56,48701,412,522,0,211329,632,48701,412,162628,220
2021-01-15,Alabama,01,417528,2945,6030,85,2097656,13111,417528,2945,1680128,10166
2021-01-15,Alaska,02,51163,302,220,1,1389226,6950,49835,300,1339391,6650
2021-01-15,Arizona,04,662597,9051,11060,184,3210314,21529,658186,9146,2552128,12383
2021-01-15,Arkansas,05,267635,3124,4263,35,2299908,15752,267635,3124,2032273,12628
2021-01-15,California,06,2937376,39105,32947,701,37449536,319170,2859624,42655,34589912,276515
2021-01-15,Colorado,08,373647,2285,5417,32,2296682,9051,371458,2281,1925224,6770
2021-01-15,Connecticut,09,223422,1878,6594,41,4880936,30477,223422,1878,4657514,28599
2021-01-15,Delaware,10,68727,662,1002,7,548993,2594,68727,662,480266,1932
2021-01-15,District of Columbia,11,33140,320,842,0,986795,7962,33140,320,953655,7642
2021-01-15,Florida,12,1548059,16875,23798,186,9447366,56214,1519944,16415,7927422,39799
2021-01-15,Georgia,13,776485,9568,11757,158,5844021,43014,668068,7348,5175953,35666
2021-01-15,Guam,66,8443,17,126,1,100467,244,7474,17,92993,227
2021-01-15,Hawaii,15,24032,205,315,0,24584,150,24584,150,,0
2021-01-15,Idaho,16,154785,1279,1606,13,599420,2893,153358,994,446062,1899
2021-01-15,Illinois,17,1062121,6571,19876,148,14564776,107156,1059324,6642,13505452,100514
2021-01-15,Indiana,18,586206,4672,9246,44,2806743,14452,583160,4666,2223583,9786
2021-01-15,Iowa,19,303927,1368,4257,6,1212121,3243,255488,1035,956633,2208
2021-01-15,Kansas,20,259196,3803,3514,159,1100365,16433,256134,4093,844231,12340
2021-01-15,Kentucky,21,324505,4039,3395,22,3457710,14497,321270,3925,3136440,10572
2021-01-15,Louisiana,22,364853,3705,8080,0,4593428,29479,364853,3705,4228575,25774
2021-01-15,Maine,23,32781,823,477,16,1238547,14579,32781,823,1205766,13756
2021-01-15,Maryland,24,320923,2921,6494,45,3012412,15252,320739,2924,2691673,12328
2021-01-15,Massachusetts,25,459927,5525,13509,76,4330578,22061,459927,5525,3870651,16536
2021-01-15,Michigan,26,578294,2988,14539,39,8757257,42418,579574,3001,8177683,39417
2021-01-15,Minnesota,27,443630,1627,5918,33,3142480,12245,443562,1627,2698918,10618
2021-01-15,Mississippi,28,248189,2342,5411,55,1471115,2342,248189,2342,1222926,0
2021-01-15,Missouri,29,464931,2613,6619,29,2145298,6774,434188,2231,1711110,4543
2021-01-15,Montana,30,88725,535,1086,7,869564,7137,88635,525,780929,6612
2021-01-15,Nebraska,31,181101,816,1892,19,880638,1831,180131,932,700507,899
2021-01-15,Nevada,32,258451,1975,3704,40,1267400,5809,258050,1878,1009350,3931
2021-01-15,New Hampshire,33,55500,722,908,11,573686,4085,55500,722,518186,3363
2021-01-15,New Jersey,34,616086,6365,20320,67,8676802,142565,616090,6369,8060712,136196
2021-01-15,New Mexico,35,161805,1262,2876,38,2127494,-13068,161805,1262,1965689,-14330
2021-01-15,New York,36,1213179,19469,40203,206,28455705,324671,1203550,19942,27252155,304729
2021-01-15,North Carolina,37,661506,9973,7996,108,7937712,87544,659840,8914,7277872,78630
2021-01-15,North Dakota,38,95621,236,1395,23,386819,688,95599,221,291220,467
2021-01-15,Northern Mariana Islands,69,128,0,2,0,17557,0,128,0,17429,0
2021-01-15,Ohio,39,814442,7149,10057,67,8463321,65215,814442,7149,7648879,58066
2021-01-15,Oklahoma,40,348044,3538,2925,43,2937452,29085,348044,3538,2589408,25547
2021-01-15,Oregon,41,131296,1050,1763,26,2895680,21108,130246,1137,2765434,19971
2021-01-15,Pennsylvania,42,760552,6111,18978,226,4195105,18566,754611,6047,3440494,12519
2021-01-15,Puerto Rico,72,119569,1138,1692,13,391926,1138,85954,1138,305972,0
2021-01-15,Rhode Island,44,104443,1057,2005,9,693152,4576,104443,1057,588709,3519
2021-01-15,South Carolina,45,375967,4787,6037,103,3609752,33632,375967,4787,3233785,28845
2021-01-15,South Dakota,46,104937,425,1629,15,389508,1336,104937,425,284571,911
2021-01-15,Tennessee,47,663486,5055,8233,78,6067669,34138,676039,5557,5391630,28581
2021-01-15,Texas,48,2096526,24594,32212,393,15700267,144654,2072903,27204,13627364,117450
2021-01-15,Utah,49,320175,2616,1475,14,1692258,7920,320102,2543,1372156,5377
2021-01-15,Vermont,50,9734,161,163,1,284468,1703,9734,161,274734,1542
2021-01-15,Virgin Islands,78,2166,0,24,0,37925,0,2166,0,35759,0
2021-01-15,Virginia,51,422634,4795,5656,30,4806397,25148,422634,4795,4383763,20353
2021-01-15,Washington,53,290288,2161,3972,23,4165348,24930,283777,2575,3881571,22355
2021-01-15,West Virginia,54,106649,1430,1733,31,1732732,21675,106649,1430,1626083,20245
2021-01-15,Wisconsin,55,563866,2706,5771,42,2991497,8477,563866,2706,2427631,5771
2021-01-15,Wyoming,56,48909,208,522,0,213710,2381,48909,208,164801,2173
2021-01-16,Alabama,01,420681,3153,6119,89,2107361,9705,420681,3153,1686680,6552
2021-01-16,Alaska,02,51347,184,220,0,1398649,9423,50017,182,1348632,9241
2021-01-16,Arizona,04,670234,7637,11248,188,3230083,19769,666901,8715,2563182,11054
2021-01-16,Arkansas,05,270178,2543,4293,30,2313335,13427,270178,2543,2043157,10884
2021-01-16,California,06,2974966,37590,33393,446,37802255,352719,2900246,40622,34902009,312097
2021-01-16,Colorado,08,375463,1816,5440,23,2305516,8834,373483,2025,1932033,6809
2021-01-16,Connecticut,09,223422,0,6594,0,4880936,0,223422,0,4657514,0
2021-01-16,Delaware,10,69372,645,1016,14,551163,2170,69372,645,481791,1525
2021-01-16,District of Columbia,11,33537,397,847,5,1000492,13697,33537,397,966955,13300
2021-01-16,Florida,12,1560178,12119,24003,205,9495482,48116,1531830,11886,7963652,36230
2021-01-16,Georgia,13,785048,8563,11900,143,5887700,43679,674994,6926,5212706,36753
2021-01-16,Guam,66,8450,7,127,1,100474,7,7481,7,92993,0
2021-01-16,Hawaii,15,24188,156,317,2,24813,229,24813,229,,0
2021-01-16,Idaho,16,155357,572,1607,1,602336,2916,154470,1112,447866,1804
2021-01-16,Illinois,17,1067230,5109,20021,145,14667148,102372,1064667,5343,13602481,97029
2021-01-16,Indiana,18,590093,3887,9287,41,2819864,13121,587049,3889,2232815,9232
2021-01-16,Iowa,19,304748,821,4321,64,1214729,2608,256403,915,958326,1693
2021-01-16,Kansas,20,259226,30,3502,-12,1100365,0,256134,0,844231,0
2021-01-16,Kentucky,21,327538,3033,3420,25,3467072,9362,324325,3055,3142747,6307
2021-01-16,Louisiana,22,364853,0,8080,0,4593428,0,364853,0,4228575,0
2021-01-16,Maine,23,33219,438,507,30,1238985,438,33219,438,1205766,0
2021-01-16,Maryland,24,324203,3280,6541,47,3029238,16826,324031,3292,2705207,13534
2021-01-16,Massachusetts,25,465726,5799,13583,74,4355774,25196,465726,5799,3890048,19397
2021-01-16,Michigan,26,580296,2002,14658,119,8807614,50357,581785,2211,8225829,48146
2021-01-16,Minnesota,27,445115,1485,5955,37,3152286,9806,445047,1485,2707239,8321
2021-01-16,Mississippi,28,250869,2680,5481,70,1473795,2680,250869,2680,1222926,0
2021-01-16,Missouri,29,466829,1898,6644,25,2151922,6624,436199,2011,1715723,4613
2021-01-16,Montana,30,89056,331,1088,2,874943,5379,89056,421,785887,4958
2021-01-16,Nebraska,31,181101,0,1892,0,882872,2234,180910,779,701962,1455
2021-01-16,Nevada,32,260222,1771,3764,60,1272672,5272,260090,2040,1012582,3232
2021-01-16,New Hampshire,33,55945,445,927,19,576327,2641,55945,445,520382,2196
2021-01-16,New Jersey,34,622085,5999,20414,94,8682801,5999,622089,5999,8060712,0
2021-01-16,New Mexico,35,162893,1088,2912,36,2140605,13111,162893,1088,1977712,12023
2021-01-16,New York,36,1229124,15945,40376,173,28732991,277286,1219548,15998,27513443,261288
2021-01-16,North Carolina,37,669284,7778,8060,64,8014058,76346,667826,7986,7346232,68360
2021-01-16,North Dakota,38,95736,115,1403,8,387295,476,95714,115,291581,361
2021-01-16,Northern Mariana Islands,69,128,0,2,0,17557,0,128,0,17429,0
2021-01-16,Ohio,39,821507,7065,10135,78,8527636,64315,821507,7065,7706129,57250
2021-01-16,Oklahoma,40,351665,3621,2952,27,2952665,15213,351665,3621,2601000,11592
2021-01-16,Oregon,41,132412,1116,1800,37,2919566,23886,131258,1012,2788308,22874
2021-01-16,Pennsylvania,42,767074,6522,19188,210,4217008,21903,761777,7166,3455231,14737
2021-01-16,Puerto Rico,72,120138,569,1703,11,392495,569,86523,569,305972,0
2021-01-16,Rhode Island,44,104443,0,2005,0,696535,3383,105472,1029,591063,2354
2021-01-16,South Carolina,45,382422,6455,6108,71,3663312,53560,382422,6455,3280890,47105
2021-01-16,South Dakota,46,105278,341,1633,4,390520,1012,105278,341,285242,671
2021-01-16,Tennessee,47,668142,4656,8276,43,6097151,29482,680847,4808,5416304,24674
2021-01-16,Texas,48,2114858,18332,32581,369,15844262,143995,2097560,24657,13746702,119338
2021-01-16,Utah,49,322252,2077,1486,11,1698697,6439,322252,2150,1376445,4289
2021-01-16,Vermont,50,9915,181,163,0,286256,1788,9915,181,276341,1607
2021-01-16,Virgin Islands,78,2166,0,24,0,37925,0,2166,0,35759,0
2021-01-16,Virginia,51,429391,6757,5706,50,4842234,35837,429391,6757,4412843,29080
2021-01-16,Washington,53,290896,608,3971,-1,4192100,26752,285970,2193,3906130,24559
2021-01-16,West Virginia,54,108124,1475,1761,28,1759981,27249,108124,1475,1651857,25774
2021-01-16,Wisconsin,55,566275,2409,5906,135,2999001,7504,566275,2409,2432726,5095
2021-01-16,Wyoming,56,49068,159,522,0,213869,159,49068,159,164801,0
2021-01-17,Alabama,01,422598,1917,6120,1,2116033,8672,422598,1917,1693435,6755
2021-01-17,Alaska,02,51630,283,220,0,1404756,6107,50296,279,1354460,5828
2021-01-17,Arizona,04,673882,3648,11266,18,3248239,18156,673882,6981,2574357,11175
2021-01-17,Arkansas,05,271154,976,4311,18,2324884,11549,271154,976,2053730,10573
2021-01-17,California,06,3006583,31617,33593,200,38228615,426360,2942475,42229,35286140,384131
2021-01-17,Colorado,08,376921,1458,5454,14,2313487,7971,374981,1498,1938506,6473
2021-01-17,Connecticut,09,223422,0,6594,0,4880936,0,223422,0,4657514,0
2021-01-17,Delaware,10,70294,922,1016,0,554755,3592,70294,922,484461,2670
2021-01-17,District of Columbia,11,33851,314,850,3,1009392,8900,33851,314,975541,8586
2021-01-17,Florida,12,1571271,11093,24136,133,9572867,77385,1542567,10737,8030300,66648
2021-01-17,Georgia,13,791322,6274,11906,6,5925441,37741,680378,5384,5245063,32357
2021-01-17,Guam,66,8453,3,128,1,100477,3,7484,3,92993,0
2021-01-17,Hawaii,15,24309,121,319,2,24943,130,24943,130,,0
2021-01-17,Idaho,16,155617,260,1609,2,604339,2003,155276,806,449063,1197
2021-01-17,Illinois,17,1071307,4077,20052,31,14763993,96845,1068829,4162,13695164,92683
2021-01-17,Indiana,18,593262,3169,9310,23,2831352,11488,590211,3162,2241141,8326
2021-01-17,Iowa,19,305151,403,4323,2,1216693,1964,256951,548,959742,1416
2021-01-17,Kansas,20,259226,0,3502,0,1100365,0,256134,0,844231,0
2021-01-17,Kentucky,21,329816,2278,3428,8,3469422,2350,326675,2350,3142747,0
2021-01-17,Louisiana,22,368980,4127,8203,123,4638346,44918,368980,4127,4269366,40791
2021-01-17,Maine,23,33559,340,511,4,1239325,340,33559,340,1205766,0
2021-01-17,Maryland,24,326648,2445,6567,26,3042909,13671,326445,2414,2716464,11257
2021-01-17,Massachusetts,25,470140,4414,13652,69,4375665,19891,470140,4414,3905525,15477
2021-01-17,Michigan,26,580394,98,14658,0,8807614,0,581785,0,8225829,0
2021-01-17,Minnesota,27,446448,1333,5995,40,3163131,10845,446380,1333,2716751,9512
2021-01-17,Mississippi,28,252475,1606,5521,40,1475401,1606,252475,1606,1222926,0
2021-01-17,Missouri,29,468106,1277,6647,3,2156547,4625,437549,1350,1718998,3275
2021-01-17,Montana,30,89393,337,1092,4,879728,4785,89393,337,790335,4448
2021-01-17,Nebraska,31,182139,1038,1893,1,882872,0,180910,0,701962,0
2021-01-17,Nevada,32,261847,1625,3784,20,1276967,4295,261573,1483,1015394,2812
2021-01-17,New Hampshire,33,56864,919,933,6,580287,3960,56864,919,523423,3041
2021-01-17,New Jersey,34,627221,5136,20439,25,8687933,5132,627221,5132,8060712,0
2021-01-17,New Mexico,35,163637,744,2934,22,2157518,16913,163637,744,1993881,16169
2021-01-17,New York,36,1242818,13694,40570,194,28979498,246507,1233390,13842,27746108,232665
2021-01-17,North Carolina,37,675272,5988,8125,65,8087429,73371,674637,6811,7412792,66560
2021-01-17,North Dakota,38,95886,150,1406,3,387840,545,95864,150,291976,395
2021-01-17,Northern Mariana Islands,69,128,0,2,0,17557,0,128,0,17429,0
2021-01-17,Ohio,39,826754,5247,10200,65,8575213,47577,826754,5247,7748459,42330
2021-01-17,Oklahoma,40,354979,3314,2987,35,2955979,3314,354979,3314,2601000,0
2021-01-17,Oregon,41,133205,793,1801,1,2920720,1154,132412,1154,2788308,0
2021-01-17,Pennsylvania,42,772747,5673,19310,122,4238806,21798,767800,6023,3471006,15775
2021-01-17,Puerto Rico,72,120996,858,1703,0,393353,858,87381,858,305972,0
2021-01-17,Rhode Island,44,104443,0,2005,0,700133,3598,106224,752,593909,2846
2021-01-17,South Carolina,45,388184,5762,6237,129,3713908,50596,388184,5762,3325724,44834
2021-01-17,South Dakota,46,105544,266,1656,23,391422,902,105544,266,285878,636
2021-01-17,Tennessee,47,672292,4150,8312,36,6128058,30907,685321,4474,5442737,26433
2021-01-17,Texas,48,2127334,12476,32747,166,15978462,134200,2113962,16402,13864500,117798
2021-01-17,Utah,49,323837,1585,1493,7,1704118,5421,323837,1585,1380281,3836
2021-01-17,Vermont,50,10057,142,163,0,288092,1836,10057,142,278035,1694
2021-01-17,Virgin Islands,78,2260,94,24,0,39379,1454,2260,94,37119,1360
2021-01-17,Virginia,51,439305,9914,5729,23,4889356,47122,439305,9914,4450051,37208
2021-01-17,Washington,53,293296,2400,3971,0,4192100,0,285970,0,3906130,0
2021-01-17,West Virginia,54,108821,697,1776,15,1767500,7519,108821,697,1658679,6822
2021-01-17,Wisconsin,55,568166,1891,5907,1,3005960,6959,568166,1891,2437794,5068
2021-01-17,Wyoming,56,49363,295,522,0,214164,295,49363,295,164801,0
2021-01-18,Alabama,01,424028,1430,6121,1,2121043,5010,424028,1430,1697015,3580
2021-01-18,Alaska,02,51785,155,220,0,1410760,6004,50447,151,1360313,5853
2021-01-18,Arizona,04,679282,5400,11265,-1,3263168,14929,679282,5400,2583886,9529
2021-01-18,Arkansas,05,272263,1109,4343,32,2334518,9634,272263,1109,2062255,8525
2021-01-18,California,06,3032007,25424,33742,149,38655756,427141,2973174,30699,35682582,396442
2021-01-18,Colorado,08,378311,1390,5462,8,2319249,5762,376171,1190,1943078,4572
2021-01-18,Connecticut,09,230125,6703,6670,76,5305328,424392,230125,6703,5075203,417689
2021-01-18,Delaware,10,70910,616,1016,0,556910,2155,70910,616,486000,1539
2021-01-18,District of Columbia,11,34033,182,857,7,1013952,4560,34033,182,979919,4378
2021-01-18,Florida,12,1579273,8002,24273,137,9602792,29925,1550444,7877,8052348,22048
2021-01-18,Georgia,13,796307,4985,11967,61,5957306,31865,684763,4385,5272543,27480
2021-01-18,Guam,66,8454,1,129,1,100478,1,7485,1,92993,0
2021-01-18,Hawaii,15,24424,115,319,0,25072,129,25072,129,,0
2021-01-18,Idaho,16,155641,24,1609,0,606400,2061,155554,278,450846,1783
2021-01-18,Illinois,17,1074719,3412,20119,67,14826995,63002,1072214,3385,13754781,59617
2021-01-18,Indiana,18,595760,2498,9340,30,2839505,8153,592709,2498,2246796,5655
2021-01-18,Iowa,19,306082,931,4324,1,1218425,1732,257431,480,960994,1252
2021-01-18,Kansas,20,262519,3293,3525,23,1113766,13401,259822,3688,853944,9713
2021-01-18,Kentucky,21,331982,2166,3462,34,3502651,33229,328668,1993,3173983,31236
2021-01-18,Louisiana,22,369951,971,8253,50,4648497,10151,369951,971,4278546,9180
2021-01-18,Maine,23,33876,317,514,3,1239642,317,33876,317,1205766,0
2021-01-18,Maryland,24,328417,1769,6596,29,3052705,9796,328214,1769,2724491,8027
2021-01-18,Massachusetts,25,473441,3301,13705,53,4389770,14105,473441,3301,3916329,10804
2021-01-18,Michigan,26,583846,3452,14677,19,8872768,65154,585128,3343,8287640,61811
2021-01-18,Minnesota,27,447417,969,6007,12,3170081,6950,447349,969,2722732,5981
2021-01-18,Mississippi,28,253932,1457,5524,3,1510047,34646,253932,1457,1256115,33189
2021-01-18,Missouri,29,469352,1246,6655,8,2161707,5160,438840,1291,1722867,3869
2021-01-18,Montana,30,89584,191,1093,1,881412,1684,89576,183,791836,1501
2021-01-18,Nebraska,31,182393,254,1896,3,885756,2884,181978,1068,703778,1816
2021-01-18,Nevada,32,262880,1033,3784,0,1280512,3545,262794,1221,1017718,2324
2021-01-18,New Hampshire,33,57864,1000,933,0,581287,1000,57864,1000,523423,0
2021-01-18,New Jersey,34,631074,3853,20458,19,8691786,3853,631074,3853,8060712,0
2021-01-18,New Mexico,35,164263,626,2960,26,2163964,6446,164263,626,1999701,5820
2021-01-18,New York,36,1256228,13410,40753,183,29165703,186205,1245575,12185,27920128,174020
2021-01-18,North Carolina,37,676315,1043,8131,6,8087429,0,674637,0,7412792,0
2021-01-18,North Dakota,38,95956,70,1406,0,388099,259,95934,70,292165,189
2021-01-18,Northern Mariana Islands,69,128,0,2,0,17557,0,128,0,17429,0
2021-01-18,Ohio,39,831066,4312,10281,81,8613949,38736,831066,4312,7782883,34424
2021-01-18,Oklahoma,40,356816,1837,2994,7,2957816,1837,356816,1837,2601000,0
2021-01-18,Oregon,41,133851,646,1811,10,2921513,793,133205,793,2788308,0
2021-01-18,Pennsylvania,42,776490,3743,19390,80,4253561,14755,771845,4045,3481716,10710
2021-01-18,Puerto Rico,72,121554,558,1703,0,393911,558,87939,558,305972,0
2021-01-18,Rhode Island,44,104443,0,2005,0,702327,2194,106705,481,595622,1713
2021-01-18,South Carolina,45,391464,3280,6248,11,3745465,31557,391464,3280,3354001,28277
2021-01-18,South Dakota,46,105659,115,1667,11,391864,442,105659,115,286205,327
2021-01-18,Tennessee,47,674915,2623,8350,38,6142748,14690,687751,2430,5454997,12260
2021-01-18,Texas,48,2138574,11240,32858,111,16138982,160520,2125552,11590,14013430,148930
2021-01-18,Utah,49,324919,1082,1500,7,1708055,3937,324919,1082,1383136,2855
2021-01-18,Vermont,50,10220,163,163,0,289574,1482,10220,163,279354,1319
2021-01-18,Virgin Islands,78,2260,0,24,0,39379,0,2260,0,37119,0
2021-01-18,Virginia,51,446550,7245,5739,10,4936547,47191,446550,7245,4489997,39946
2021-01-18,Washington,53,293739,443,3974,3,4246293,54193,289939,3969,3956354,50224
2021-01-18,West Virginia,54,109809,988,1784,8,1783280,15780,109809,988,1673471,14792
2021-01-18,Wisconsin,55,569335,1169,5930,23,3011178,5218,569335,1169,2441843,4049
2021-01-18,Wyoming,56,49708,345,522,0,214509,345,49708,345,164801,0
2021-01-19,Alabama,01,426543,2515,6126,5,2128667,7624,426543,2515,1702124,5109
2021-01-19,Alaska,02,51914,129,221,1,1414531,3771,50572,125,1363959,3646
2021-01-19,Arizona,04,686028,6746,11266,1,3275572,12404,685699,6417,2589873,5987
2021-01-19,Arkansas,05,273594,1331,4386,43,2341391,6873,273594,1331,2067797,5542
2021-01-19,California,06,3071119,39112,34390,648,39024543,368787,2996968,23794,36027575,344993
2021-01-19,Colorado,08,379999,1688,5473,11,2327453,8204,377856,1685,1949597,6519
2021-01-19,Connecticut,09,232219,2094,6682,12,5342387,37059,232219,2094,5110168,34965
2021-01-19,Delaware,10,71311,401,1021,5,558299,1389,71311,401,486988,988
2021-01-19,District of Columbia,11,34259,226,861,4,1020262,6310,34259,226,986003,6084
2021-01-19,Florida,12,1589089,9816,24435,162,9639357,36565,1560015,9571,8079342,26994
2021-01-19,Georgia,13,804508,8201,12179,212,5988737,31431,689676,4913,5299061,26518
2021-01-19,Guam,66,8484,30,129,0,101782,1304,7515,30,94267,1274
2021-01-19,Hawaii,15,24483,59,321,2,25136,64,25136,64,,0
2021-01-19,Idaho,16,157069,1428,1639,30,606400,0,155554,0,450846,0
2021-01-19,Illinois,17,1079307,4588,20154,35,14898528,71533,1076532,4318,13821996,67215
2021-01-19,Indiana,18,598494,2734,9466,126,2847632,8127,595436,2727,2252196,5400
2021-01-19,Iowa,19,307302,1220,4332,8,1220451,2026,258148,717,962303,1309
2021-01-19,Kansas,20,262727,208,3526,1,1113766,0,259822,0,853944,0
2021-01-19,Kentucky,21,334347,2365,3489,27,3508435,5784,330907,2239,3177528,3545
2021-01-19,Louisiana,22,372089,2138,8324,71,4673947,25450,372089,2138,4301858,23312
2021-01-19,Maine,23,34262,386,519,5,1270873,31231,34262,386,1236611,30845
2021-01-19,Maryland,24,330390,1973,6650,54,3062107,9402,330186,1972,2731921,7430
2021-01-19,Massachusetts,25,476526,3085,13749,44,4403763,13993,476526,3085,3927237,10908
2021-01-19,Michigan,26,586204,2358,14724,47,8893037,20269,587448,2320,8305589,17949
2021-01-19,Minnesota,27,448336,919,6013,6,3174887,4806,448268,919,2726619,3887
2021-01-19,Mississippi,28,255125,1193,5574,50,1511240,1193,255125,1193,1256115,0
2021-01-19,Missouri,29,471743,2391,6672,17,2165954,4247,440197,1357,1725757,2890
2021-01-19,Montana,30,89952,368,1093,0,883672,2260,89864,288,793808,1972
2021-01-19,Nebraska,31,182852,459,1902,6,886531,775,182418,440,704113,335
2021-01-19,Nevada,32,264236,1356,3794,10,1283169,2657,263972,1178,1019197,1479
2021-01-19,New Hampshire,33,58709,845,938,5,585777,4490,58709,845,527068,3645
2021-01-19,New Jersey,34,635701,4627,20512,54,8865291,173505,635702,4628,8229589,168877
2021-01-19,New Mexico,35,164954,691,2977,17,2175023,11059,164954,691,2010069,10368
2021-01-19,New York,36,1268949,12721,40933,180,29342972,177269,1258087,12512,28084885,164757
2021-01-19,North Carolina,37,684497,8182,8196,65,8186392,98963,684497,9860,7501895,89103
2021-01-19,North Dakota,38,96093,137,1408,2,388505,406,96071,137,292434,269
2021-01-19,Northern Mariana Islands,69,129,1,2,0,17558,1,129,1,17429,0
2021-01-19,Ohio,39,836055,4989,10336,55,8653877,39928,836055,4989,7817822,34939
2021-01-19,Oklahoma,40,358374,1558,3037,43,3000449,42633,358374,1558,2642075,41075
2021-01-19,Oregon,41,134468,617,1816,5,2922159,646,133851,646,2788308,0
2021-01-19,Pennsylvania,42,783355,6865,19467,77,4271465,17904,777186,5341,3494279,12563
2021-01-19,Puerto Rico,72,121988,434,1703,0,394345,434,88373,434,305972,0
2021-01-19,Rhode Island,44,107066,2623,2045,40,703884,1557,107066,361,596818,1196
2021-01-19,South Carolina,45,394318,2854,6259,11,3772941,27476,394318,2854,3378623,24622
2021-01-19,South Dakota,46,105786,127,1667,0,392325,461,105786,127,286539,334
2021-01-19,Tennessee,47,677425,2510,8391,41,6155742,12994,689808,2057,5465934,10937
2021-01-19,Texas,48,2160456,21882,33176,318,16197450,58468,2135028,9476,14062422,48992
2021-01-19,Utah,49,326221,1302,1507,7,1712117,4062,326221,1302,1385896,2760
2021-01-19,Vermont,50,10321,101,163,0,290655,1081,10321,101,280334,980
2021-01-19,Virgin Islands,78,2283,23,24,0,39379,0,2260,0,37119,0
2021-01-19,Virginia,51,451076,4526,5798,59,4963074,26527,451076,4526,4511998,22001
2021-01-19,Washington,53,296519,2780,4020,46,4246293,0,289939,0,3956354,0
2021-01-19,West Virginia,54,110820,1011,1815,31,1796329,13049,110820,1011,1685509,12038
2021-01-19,Wisconsin,55,571268,1933,5974,44,3016667,5489,571268,1933,2445399,3556
2021-01-19,Wyoming,56,49922,214,550,28,216405,1896,49922,214,166483,1682
2021-01-20,Alabama,01,429655,3112,6283,157,2139405,10738,429655,3112,1709750,7626
2021-01-20,Alaska,02,52081,167,244,23,1420122,5591,50732,160,1369390,5431
2021-01-20,Arizona,04,693706,7678,11564,298,3293628,18056,690544,4845,2603084,13211
2021-01-20,Arkansas,05,276114,2520,4441,55,2356321,14930,276114,2520,2080207,12410
2021-01-20,California,06,3090339,19220,35001,611,39288363,263820,3019371,22403,36268992,241417
2021-01-20,Colorado,08,381414,1415,5509,36,2333828,6375,379227,1371,1954601,5004
2021-01-20,Connecticut,09,234134,1915,6726,44,5373402,31015,234134,1915,5139268,29100
2021-01-20,Delaware,10,71775,464,1026,5,560500,2201,71775,464,488725,1737
2021-01-20,District of Columbia,11,34403,144,863,2,1024531,4269,34403,144,990128,4125
2021-01-20,Florida,12,1601003,11914,24577,142,9678139,38782,1571840,11825,8106299,26957
2021-01-20,Georgia,13,812454,7946,12373,194,6033197,44460,695400,5724,5337797,38736
2021-01-20,Guam,66,8484,0,129,0,102312,530,7521,6,94791,524
2021-01-20,Hawaii,15,24551,68,322,1,25210,74,25210,74,,0
2021-01-20,Idaho,16,157745,676,1637,-2,610010,3610,156778,1224,453232,2386
2021-01-20,Illinois,17,1083982,4675,20285,131,14984649,86121,1081354,4822,13903295,81299
2021-01-20,Indiana,18,601380,2886,9529,63,2855991,8359,598313,2877,2257678,5482
2021-01-20,Iowa,19,308787,1485,4394,62,1222463,2012,258865,717,963598,1295
2021-01-20,Kansas,20,266106,3379,3575,49,1125705,11939,263412,3590,862293,8349
2021-01-20,Kentucky,21,337788,3441,3540,51,3520188,11753,334321,3414,3185867,8339
2021-01-20,Louisiana,22,374582,2493,8383,59,4705481,31534,374582,2493,4330899,29041
2021-01-20,Maine,23,34963,701,530,11,1280282,9409,34963,701,1245319,8708
2021-01-20,Maryland,24,332558,2168,6689,39,3072514,10407,332353,2167,2740161,8240
2021-01-20,Massachusetts,25,481040,4514,13829,80,4421203,17440,481040,4514,3940163,12926
2021-01-20,Michigan,26,588616,2412,14759,35,8933096,40059,589869,2421,8343227,37638
2021-01-20,Minnesota,27,449560,1224,6047,34,3180512,5625,449492,1224,2731020,4401
2021-01-20,Mississippi,28,256827,1702,5638,64,1512942,1702,256827,1702,1256115,0
2021-01-20,Missouri,29,473912,2169,6868,196,2170783,4829,441789,1592,1728994,3237
2021-01-20,Montana,30,90349,397,1094,1,887884,4212,90255,391,797629,3821
2021-01-20,Nebraska,31,184805,1953,1924,22,887431,900,183318,900,704113,0
2021-01-20,Nevada,32,265241,1005,3869,75,1287155,3986,265143,1171,1022012,2815
2021-01-20,New Hampshire,33,59437,728,950,12,589215,3438,59437,728,529778,2710
2021-01-20,New Jersey,34,641140,5439,20667,155,8951817,86526,641140,5438,8310677,81088
2021-01-20,New Mexico,35,165835,881,3011,34,2185009,9986,165835,881,2019174,9105
2021-01-20,New York,36,1280068,11119,41148,215,29538381,195409,1271451,13364,28266930,182045
2021-01-20,North Carolina,37,693695,9198,8267,71,8239713,53321,690912,6415,7548801,46906
2021-01-20,North Dakota,38,96244,151,1409,1,388866,361,96222,151,292644,210
2021-01-20,Northern Mariana Islands,69,129,0,2,0,17558,0,129,0,17429,0
2021-01-20,Ohio,39,842433,6378,10409,73,8677967,24090,842433,6378,7835534,17712
2021-01-20,Oklahoma,40,360360,1986,3085,48,3013962,13513,360360,1986,2653602,11527
2021-01-20,Oregon,41,135143,675,1841,25,2987263,65104,134468,617,2852795,64487
2021-01-20,Pennsylvania,42,789029,5674,19868,401,4290262,18797,783170,5984,3507092,12813
2021-01-20,Puerto Rico,72,122128,140,1717,14,394485,140,88513,140,305972,0
2021-01-20,Rhode Island,44,107876,810,2058,13,707198,3314,107876,810,599322,2504
2021-01-20,South Carolina,45,399843,5525,6328,69,3823586,50645,399843,5525,3423743,45120
2021-01-20,South Dakota,46,106063,277,1667,0,393343,1018,106063,277,287280,741
2021-01-20,Tennessee,47,681451,4026,8477,86,6179461,23719,694291,4483,5485170,19236
2021-01-20,Texas,48,2188117,27661,33631,455,16343762,146312,2166283,31255,14177479,115057
2021-01-20,Utah,49,328380,2159,1518,11,1719096,6979,328380,2159,1390716,4820
2021-01-20,Vermont,50,10471,150,165,2,290855,200,10471,150,280384,50
2021-01-20,Virgin Islands,78,2305,22,24,0,39581,202,2283,23,37298,179
2021-01-20,Virginia,51,455591,4515,5861,63,4985616,22542,455591,4515,4530025,18027
2021-01-20,Washington,53,298487,1968,4021,1,4278116,31823,291989,2050,3986127,29773
2021-01-20,West Virginia,54,111677,857,1836,21,1806753,10424,111677,857,1695076,9567
2021-01-20,Wisconsin,55,573119,1851,6036,62,3023641,6974,573119,1851,2450522,5123
2021-01-20,Wyoming,56,50124,202,550,0,216983,578,50124,202,166859,376
2021-01-21,Alabama,01,432536,2881,6379,96,2147778,8373,432536,2881,1715242,5492
2021-01-21,Alaska,02,52282,201,245,1,1430967,10845,50941,209,1380026,10636
2021-01-21,Arizona,04,703249,9543,11813,249,3328288,34660,699942,9398,2628346,25262
2021-01-21,Arkansas,05,279220,3106,4496,55,2370512,14191,279220,3106,2091292,11085
2021-01-21,California,06,3115704,25365,35701,700,39512756,224393,3039044,19673,36473712,204720
2021-01-21,Colorado,08,382918,1504,5523,14,2343642,9814,381210,1983,1962432,7831
2021-01-21,Connecticut,09,235796,1662,6774,48,5412500,39098,235796,1662,5176704,37436
2021-01-21,Delaware,10,72523,748,1027,1,562989,2489,72523,748,490466,1741
2021-01-21,District of Columbia,11,34612,209,864,1,1031692,7161,34612,209,997080,6952
2021-01-21,Florida,12,1613876,12873,24738,161,9728645,50506,1584442,12602,8144203,37904
2021-01-21,Georgia,13,820513,8059,12484,111,6072614,39417,701308,5908,5371306,33509
2021-01-21,Guam,66,8497,13,129,0,102933,621,7528,7,95405,614
2021-01-21,Hawaii,15,24663,112,325,3,25329,119,25329,119,,0
2021-01-21,Idaho,16,158400,655,1658,21,612396,2386,157588,810,454808,1576
2021-01-21,Illinois,17,1089010,5028,20423,138,15083685,99036,1086333,4979,13997352,94057
2021-01-21,Indiana,18,605004,3624,9593,64,2867990,11999,601937,3624,2266053,8375
2021-01-21,Iowa,19,310440,1653,4445,51,1226351,3888,260227,1362,966124,2526
2021-01-21,Kansas,20,266562,456,3575,0,1125705,0,263412,0,862293,0
2021-01-21,Kentucky,21,341343,3555,3584,44,3531508,11320,338034,3713,3193474,7607
2021-01-21,Louisiana,22,378318,3736,8442,59,4748890,43409,378318,3736,4370572,39673
2021-01-21,Maine,23,35638,675,536,6,1298390,18108,35638,675,1262752,17433
2021-01-21,Maryland,24,334725,2167,6735,46,3084146,11632,334519,2166,2749627,9466
2021-01-21,Massachusetts,25,486180,5140,13906,77,4442407,21204,486180,5140,3956227,16064
2021-01-21,Michigan,26,591203,2587,14922,163,8988528,55432,592382,2513,8396146,52919
2021-01-21,Minnesota,27,450830,1270,6079,32,3189397,8885,450762,1270,2738635,7615
2021-01-21,Mississippi,28,259117,2290,5668,30,1515232,2290,259117,2290,1256115,0
2021-01-21,Missouri,29,476262,2350,6909,41,2177231,6448,443838,2049,1733393,4399
2021-01-21,Montana,30,90742,393,1102,8,892770,4886,90649,394,802121,4492
2021-01-21,Nebraska,31,185659,854,1937,13,892762,5331,184482,1164,708280,4167
2021-01-21,Nevada,32,266656,1415,3915,46,1293667,6512,266343,1200,1027324,5312
2021-01-21,New Hampshire,33,60294,857,962,12,592902,3687,60294,857,532608,2830
2021-01-21,New Jersey,34,646188,5048,20760,93,8956866,5049,646189,5049,8310677,0
2021-01-21,New Mexico,35,166823,988,3046,35,2198850,13841,166823,988,2032027,12853
2021-01-21,New York,36,1293976,13908,41348,200,29762950,224569,1285337,13886,28477613,210683
2021-01-21,North Carolina,37,699334,5639,8397,130,8310231,70518,698099,7187,7612132,63331
2021-01-21,North Dakota,38,96392,148,1422,13,389294,428,96370,148,292924,280
2021-01-21,Northern Mariana Islands,69,129,0,2,0,17558,0,129,0,17429,0
2021-01-21,Ohio,39,849704,7271,10518,109,8726178,48211,849704,7271,7876474,40940
2021-01-21,Oklahoma,40,363046,2686,3140,55,3016648,2686,363046,2686,2653602,0
2021-01-21,Oregon,41,135973,830,1850,9,3003213,15950,135142,674,2868071,15276
2021-01-21,Pennsylvania,42,794632,5603,20128,260,4309670,19408,788834,5664,3520836,13744
2021-01-21,Puerto Rico,72,122343,215,1732,15,394700,215,88728,215,305972,0
2021-01-21,Rhode Island,44,108786,910,2076,18,711223,4025,108786,910,602437,3115
2021-01-21,South Carolina,45,404492,4649,6373,45,3862267,38681,404492,4649,3457775,34032
2021-01-21,South Dakota,46,106400,337,1673,6,394515,1172,106400,337,288115,835
2021-01-21,Tennessee,47,685037,3586,8606,129,6203166,23705,697783,3492,5505383,20213
2021-01-21,Texas,48,2209995,21878,34075,444,16473500,129738,2188643,22360,14284857,107378
2021-01-21,Utah,49,330469,2089,1548,30,1725628,6532,330469,2089,1395159,4443
2021-01-21,Vermont,50,10580,109,168,3,291562,707,10580,109,280982,598
2021-01-21,Virgin Islands,78,2305,0,24,0,39770,189,2305,22,37465,167
2021-01-21,Virginia,51,459604,4013,5940,79,5010998,25382,459604,4013,4551394,21369
2021-01-21,Washington,53,300420,1933,4131,110,4310065,31949,294017,2028,4016048,29921
2021-01-21,West Virginia,54,112617,940,1849,13,1823504,16751,112617,940,1710887,15811
2021-01-21,Wisconsin,55,575688,2569,6091,55,3032720,9079,575688,2569,2457032,6510
2021-01-21,Wyoming,56,50424,300,550,0,217795,812,50424,300,167371,512
2021-01-22,Alabama,01,436087,3551,6486,107,2156761,8983,436087,3551,1720674,5432
2021-01-22,Alaska,02,52572,290,245,0,1438958,7991,51204,263,1387754,7728
2021-01-22,Arizona,04,710273,7024,12014,201,3351226,22938,708041,8099,2643185,14839
2021-01-22,Arkansas,05,281382,2162,4549,53,2383073,12561,281382,2162,2101691,10399
2021-01-22,California,06,3140928,25224,36326,625,39725839,213083,3062068,23024,36663771,190059
2021-01-22,Colorado,08,385153,2235,5548,25,2352403,8761,383008,1798,1969395,6963
2021-01-22,Connecticut,09,237815,2019,6819,45,5453614,41114,237815,2019,5215799,39095
2021-01-22,Delaware,10,73233,710,1027,0,565705,2716,73233,710,492472,2006
2021-01-22,District of Columbia,11,34905,293,867,3,1038480,6788,34905,293,1003575,6495
2021-01-22,Florida,12,1627595,13719,25010,272,9764241,35596,1597849,13407,8166392,22189
2021-01-22,Georgia,13,829023,8510,12653,169,6122066,49452,707750,6442,5414316,43010
2021-01-22,Guam,66,8516,19,129,0,103274,341,7547,19,95727,322
2021-01-22,Hawaii,15,24823,160,329,4,25498,169,25498,169,,0
2021-01-22,Idaho,16,159000,600,1669,11,614496,2100,158200,612,456296,1488
2021-01-22,Illinois,17,1095917,6907,20535,112,15209516,125831,1093375,7042,14116141,118789
2021-01-22,Indiana,18,608498,3494,9642,49,2879896,11906,605426,3489,2274470,8417
2021-01-22,Iowa,19,311695,1255,4478,33,1229114,2763,261193,966,967921,1797
2021-01-22,Kansas,20,269611,3049,3598,23,1137411,11706,266653,3241,870758,8465
2021-01-22,Kentucky,21,344565,3222,3626,42,3556144,24636,340779,2745,3215365,21891
2021-01-22,Louisiana,22,380255,1937,8483,41,4775952,27062,380255,1937,4395697,25125
2021-01-22,Maine,23,36274,636,540,4,1308690,10300,36274,636,1272416,9664
2021-01-22,Maryland,24,337129,2404,6792,57,3097633,13487,336915,2396,2760718,11091
2021-01-22,Massachusetts,25,491452,5272,13987,81,4464525,22118,491452,5272,3973073,16846
2021-01-22,Michigan,26,593726,2523,14940,18,9033372,44844,594920,2538,8438452,42306
2021-01-22,Minnesota,27,452336,1506,6100,21,3199693,10296,452268,1506,2747425,8790
2021-01-22,Mississippi,28,261167,2050,5713,45,1517282,2050,261167,2050,1256115,0
2021-01-22,Missouri,29,478517,2255,6932,23,2183304,6073,445621,1783,1737683,4290
2021-01-22,Montana,30,91145,403,1106,4,899769,6999,91049,400,808720,6599
2021-01-22,Nebraska,31,186646,987,1948,11,895491,2729,185346,864,710145,1865
2021-01-22,Nevada,32,268357,1701,3967,52,1298336,4669,268212,1869,1030124,2800
2021-01-22,New Hampshire,33,60951,657,971,9,595715,2813,60951,657,534764,2156
2021-01-22,New Jersey,34,650388,4200,20875,115,9006944,50078,650389,4200,8356555,45878
2021-01-22,New Mexico,35,167731,908,3079,33,2214495,15645,167731,908,2046764,14737
2021-01-22,New York,36,1309660,15684,41530,182,30030951,268001,1300481,15144,28730470,252857
2021-01-22,North Carolina,37,708931,9597,8511,114,8387652,77421,705535,7436,7682117,69985
2021-01-22,North Dakota,38,96592,200,1428,6,389697,403,96567,197,293130,206
2021-01-22,Northern Mariana Islands,69,129,0,2,0,17558,0,129,0,17429,0
2021-01-22,Ohio,39,853982,4278,10599,81,8787021,60843,853982,4278,7933039,56565
2021-01-22,Oklahoma,40,365992,2946,3187,47,3040353,23705,365992,2946,2674361,20759
2021-01-22,Oregon,41,136839,866,1874,24,3023332,20119,135973,831,2887359,19288
2021-01-22,Pennsylvania,42,799948,5316,20322,194,4327933,18263,794172,5338,3533761,12925
2021-01-22,Puerto Rico,72,122897,554,1761,29,395254,554,89282,554,305972,0
2021-01-22,Rhode Island,44,109735,949,2083,7,715438,4215,109735,949,605703,3266
2021-01-22,South Carolina,45,409188,4696,6404,31,3900531,38264,409188,4696,3491343,33568
2021-01-22,South Dakota,46,106716,316,1684,11,395477,962,106716,316,288761,646
2021-01-22,Tennessee,47,688782,3745,8695,89,6231478,28312,701847,4064,5529631,24248
2021-01-22,Texas,48,2228301,18306,34496,421,16596622,123122,2211289,22646,14385333,100476
2021-01-22,Utah,49,333118,2649,1571,23,1732226,6598,333118,2649,1399108,3949
2021-01-22,Vermont,50,10759,179,169,1,293081,1519,10759,179,282322,1340
2021-01-22,Virgin Islands,78,2321,16,24,0,40049,279,2321,16,37728,263
2021-01-22,Virginia,51,463751,4147,6002,62,5037328,26330,463751,4147,4573577,22183
2021-01-22,Washington,53,302546,2126,4178,47,4338697,28632,296087,2070,4042610,26562
2021-01-22,West Virginia,54,113615,998,1856,7,1842666,19162,113615,998,1729051,18164
2021-01-22,Wisconsin,55,577991,2303,6140,49,3041335,8615,577991,2303,2463344,6312
2021-01-22,Wyoming,56,50583,159,571,21,217954,159,50583,159,167371,0
2021-01-23,Alabama,01,439442,3355,6657,171,2169913,13152,439442,3355,1730471,9797
2021-01-23,Alaska,02,52820,248,250,5,1446514,7556,51445,241,1395069,7315
2021-01-23,Arizona,04,717593,7320,12170,156,3372523,21297,715357,7316,2657166,13981
2021-01-23,Arkansas,05,282995,1613,4563,14,2394629,11556,282995,1613,2111634,9943
2021-01-23,California,06,3163932,23004,36818,492,39970119,244280,3085040,22972,36885079,221308
2021-01-23,Colorado,08,386432,1279,5561,13,2361543,9140,384966,1958,1976577,7182
2021-01-23,Connecticut,09,237815,0,6819,0,5453614,0,237815,0,5215799,0
2021-01-23,Delaware,10,73915,682,1036,9,568625,2920,73915,682,494710,2238
2021-01-23,District of Columbia,11,35077,172,870,3,1043112,4632,35077,172,1008035,4460
2021-01-23,Florida,12,1639906,12311,25163,153,9825339,61098,1609953,12104,8215386,48994
2021-01-23,Georgia,13,838057,9034,12834,181,6174470,52404,714322,6572,5460148,45832
2021-01-23,Guam,66,8516,0,129,0,103274,0,7547,0,95727,0
2021-01-23,Hawaii,15,24950,127,333,4,25631,133,25631,133,,0
2021-01-23,Idaho,16,159406,406,1670,1,617113,2617,158798,598,458315,2019
2021-01-23,Illinois,17,1101037,5120,20645,110,15319694,110178,1098527,5152,14221167,105026
2021-01-23,Indiana,18,611600,3102,9693,51,2890956,11060,608519,3093,2282437,7967
2021-01-23,Iowa,19,312625,930,4486,8,1232463,3349,262149,956,970314,2393
2021-01-23,Kansas,20,269611,0,3598,0,1137411,0,266653,0,870758,0
2021-01-23,Kentucky,21,348040,3475,3657,31,3575441,19297,344568,3789,3230873,15508
2021-01-23,Louisiana,22,380255,0,8483,0,4775952,0,380255,0,4395697,0
2021-01-23,Maine,23,36598,324,544,4,1309014,324,36598,324,1272416,0
2021-01-23,Maryland,24,339482,2353,6837,45,3111033,13400,339307,2392,2771726,11008
2021-01-23,Massachusetts,25,496093,4641,14064,77,4484202,19677,496093,4641,3988109,15036
2021-01-23,Michigan,26,595320,1594,15170,230,9086109,52737,596746,1826,8489363,50911
2021-01-23,Minnesota,27,453876,1540,6131,31,3212567,12874,453808,1540,2758759,11334
2021-01-23,Mississippi,28,263023,1856,5752,39,1519138,1856,263023,1856,1256115,0
2021-01-23,Missouri,29,480183,1666,6949,17,2189197,5893,447398,1777,1741799,4116
2021-01-23,Montana,30,91448,303,1142,36,906753,6984,91410,361,815343,6623
2021-01-23,Nebraska,31,187135,489,1954,6,898008,2517,186255,909,711753,1608
2021-01-23,Nevada,32,269928,1571,4017,50,1302827,4491,269713,1501,1033114,2990
2021-01-23,New Hampshire,33,61576,625,981,10,599302,3587,61576,625,537726,2962
2021-01-23,New Jersey,34,657536,7148,20934,59,9053215,46271,657536,7147,8395679,39124
2021-01-23,New Mexico,35,168579,848,3117,38,2232240,17745,168579,848,2063661,16897
2021-01-23,New York,36,1323569,13909,41694,164,30293057,262106,1314267,13786,28978790,248320
2021-01-23,North Carolina,37,715283,6352,8623,112,8462562,74910,712716,7181,7749846,67729
2021-01-23,North Dakota,38,96745,153,1436,8,390188,491,96720,153,293468,338
2021-01-23,Northern Mariana Islands,69,129,0,2,0,17558,0,129,0,17429,0
2021-01-23,Ohio,39,859841,5859,10680,81,8844083,57062,859841,5859,7984242,51203
2021-01-23,Oklahoma,40,370149,4157,3231,44,3060863,20510,370149,4157,2690714,16353
2021-01-23,Oregon,41,137600,761,1882,8,3043792,20460,136839,866,2906953,19594
2021-01-23,Pennsylvania,42,805272,5324,20526,204,4346867,18934,799957,5785,3546910,13149
2021-01-23,Puerto Rico,72,123688,791,1771,10,396045,791,90073,791,305972,0
2021-01-23,Rhode Island,44,109735,0,2083,0,715438,0,109735,0,605703,0
2021-01-23,South Carolina,45,413789,4601,6479,75,3944118,43587,413789,4601,3530329,38986
2021-01-23,South Dakota,46,106963,247,1696,12,396420,943,106963,247,289457,696
2021-01-23,Tennessee,47,692048,3266,8736,41,6262941,31463,705876,4029,5557065,27434
2021-01-23,Texas,48,2242145,13844,34859,363,16684703,88081,2228961,17672,14455742,70409
2021-01-23,Utah,49,334889,1771,1582,11,1736523,4297,334889,1771,1401634,2526
2021-01-23,Vermont,50,10908,149,170,1,294547,1466,10908,149,283639,1317
2021-01-23,Virgin Islands,78,2341,20,24,0,40136,87,2335,14,37801,73
2021-01-23,Virginia,51,468655,4904,6079,77,5067937,30609,468655,4904,4599282,25705
2021-01-23,Washington,53,304107,1561,4182,4,4362841,24144,298249,2162,4064592,21982
2021-01-23,West Virginia,54,114752,1137,1872,16,1853803,11137,114752,1137,1739051,10000
2021-01-23,Wisconsin,55,580003,2012,6187,47,3049126,7791,580003,2012,2469123,5779
2021-01-23,Wyoming,56,50583,0,571,0,217954,0,50583,0,167371,0
2021-01-24,Alabama,01,441170,1728,6660,3,2178264,8351,441170,1728,1737094,6623
2021-01-24,Alaska,02,52982,162,250,0,1453470,6956,51610,165,1401860,6791
2021-01-24,Arizona,04,722574,4981,12238,68,3394345,21822,722574,7217,2671771,14605
2021-01-24,Arkansas,05,284066,1071,4606,43,2403626,8997,284066,1071,2119560,7926
2021-01-24,California,06,3185612,21680,37118,300,40285715,315596,3109151,24111,37176564,291485
2021-01-24,Colorado,08,387960,1528,5588,27,2368689,7146,386285,1319,1982404,5827
2021-01-24,Connecticut,09,237815,0,6819,0,5453614,0,237815,0,5215799,0
2021-01-24,Delaware,10,74575,660,1041,5,570717,2092,74575,660,496142,1432
2021-01-24,District of Columbia,11,35301,224,872,2,1048951,5839,35301,224,1013650,5615
2021-01-24,Florida,12,1649441,9535,25292,129,9862348,37009,1619288,9335,8243060,27674
2021-01-24,Georgia,13,842798,4741,12838,4,6208860,34390,718532,4210,5490328,30180
2021-01-24,Guam,66,8516,0,129,0,103274,0,7547,0,95727,0
2021-01-24,Hawaii,15,25093,143,339,6,25782,151,25782,151,,0
2021-01-24,Idaho,16,159581,175,1671,1,618999,1886,159325,527,459674,1359
2021-01-24,Illinois,17,1104206,3169,20680,35,15409832,90138,1101819,3292,14308013,86846
2021-01-24,Indiana,18,614120,2520,9716,23,2900051,9095,611039,2520,2289012,6575
2021-01-24,Iowa,19,313140,515,4487,1,1235059,2596,262860,711,972199,1885
2021-01-24,Kansas,20,269611,0,3598,0,1137411,0,266653,0,870758,0
2021-01-24,Kentucky,21,349194,1154,3687,30,3577459,2018,346586,2018,3230873,0
2021-01-24,Louisiana,22,383862,3607,8565,82,4815570,39618,383862,3607,4431708,36011
2021-01-24,Maine,23,36598,0,544,0,1309014,0,36598,0,1272416,0
2021-01-24,Maryland,24,341666,2184,6865,28,3120857,9824,341452,2145,2779405,7679
2021-01-24,Massachusetts,25,500037,3944,14133,69,4502197,17995,500037,3944,4002160,14051
2021-01-24,Michigan,26,595354,34,15170,0,9086109,0,596746,0,8489363,0
2021-01-24,Minnesota,27,455057,1181,6163,32,3225476,12909,454989,1181,2770487,11728
2021-01-24,Mississippi,28,264219,1196,5772,20,1520334,1196,264219,1196,1256115,0
2021-01-24,Missouri,29,481970,1787,6956,7,2197069,7872,449535,2137,1747534,5735
2021-01-24,Montana,30,91662,214,1152,10,911686,4933,91652,242,820034,4691
2021-01-24,Nebraska,31,187407,272,1954,0,905788,7780,186854,599,718934,7181
2021-01-24,Nevada,32,271029,1101,4027,10,1306236,3409,270907,1194,1035329,2215
2021-01-24,New Hampshire,33,62337,761,987,6,601566,2264,62337,761,539229,1503
2021-01-24,New Jersey,34,662808,5272,20951,17,9058487,5272,662808,5272,8395679,0
2021-01-24,New Mexico,35,169205,626,3147,30,2245108,12868,169205,626,2075903,12242
2021-01-24,New York,36,1335952,12383,41889,195,30543012,249955,1326987,12720,29216025,237235
2021-01-24,North Carolina,37,720580,5297,8739,116,8524547,61985,718812,6096,7805735,55889
2021-01-24,North Dakota,38,96842,97,1436,0,390625,437,96817,97,293808,340
2021-01-24,Northern Mariana Islands,69,129,0,2,0,17558,0,129,0,17429,0
2021-01-24,Ohio,39,864322,4481,10711,31,8884571,40488,864322,4481,8020249,36007
2021-01-24,Oklahoma,40,373090,2941,3279,48,3063804,2941,373090,2941,2690714,0
2021-01-24,Oregon,41,138168,568,1885,3,3044553,761,137600,761,2906953,0
2021-01-24,Pennsylvania,42,808951,3679,20609,83,4362597,15730,803933,3976,3558664,11754
2021-01-24,Puerto Rico,72,124643,955,1773,2,397000,955,91028,955,305972,0
2021-01-24,Rhode Island,44,109735,0,2083,0,715438,0,109735,0,605703,0
2021-01-24,South Carolina,45,418325,4536,6547,68,3985112,40994,418325,4536,3566787,36458
2021-01-24,South Dakota,46,107148,185,1705,9,397239,819,107148,185,290091,634
2021-01-24,Tennessee,47,694381,2333,8776,40,6289451,26510,708717,2841,5580734,23669
2021-01-24,Texas,48,2249959,7814,35050,191,16841605,156902,2240526,11565,14601079,145337
2021-01-24,Utah,49,336405,1516,1595,13,1742593,6070,336405,1516,1406188,4554
2021-01-24,Vermont,50,11033,125,170,0,295895,1348,11033,125,284862,1223
2021-01-24,Virgin Islands,78,2341,0,24,0,40297,161,2341,6,37956,155
2021-01-24,Virginia,51,472447,3792,6078,-1,5098056,30119,472447,3792,4625609,26327
2021-01-24,Washington,53,304523,416,4182,0,4386813,23972,300198,1949,4086615,22023
2021-01-24,West Virginia,54,115307,555,1895,23,1860337,6534,115307,555,1745030,5979
2021-01-24,Wisconsin,55,581377,1374,6193,6,3055712,6586,581377,1374,2474335,5212
2021-01-24,Wyoming,56,50898,315,571,0,218269,315,50898,315,167371,0
